PokerStars Game #59950625982:  Hold'em No Limit ($5/$10) - 2009/07/01 6:56:43 ET
Table 'ZemUU8uyOTYQAgqnaWQDUA' 6-max Seat #3 is the button
Seat 2: NczJqEIUdrpEc5Nbd7h1Ig ($601 in chips)
Seat 3: M6ck0CntRJiM0JZjUketMw ($449 in chips)
Seat 4: M5+Fo1NDPI9ulpVSsqNsNw ($364.10 in chips)
Seat 5: 33XJu1CVnl9YOngoPIhi0A ($804.45 in chips)
Seat 6: 3mTlg4g0FJN2bo939h/0Wg ($275 in chips)
M5+Fo1NDPI9ulpVSsqNsNw: posts small blind $5
33XJu1CVnl9YOngoPIhi0A: posts big blind $10
*** HOLE CARDS ***
3mTlg4g0FJN2bo939h/0Wg has timed out
3mTlg4g0FJN2bo939h/0Wg: folds
3mTlg4g0FJN2bo939h/0Wg is sitting out
NczJqEIUdrpEc5Nbd7h1Ig: calls $10
3mTlg4g0FJN2bo939h/0Wg has returned
M6ck0CntRJiM0JZjUketMw: calls $10
M5+Fo1NDPI9ulpVSsqNsNw: calls $5
33XJu1CVnl9YOngoPIhi0A: raises $700 to $710
NczJqEIUdrpEc5Nbd7h1Ig: folds
M6ck0CntRJiM0JZjUketMw: folds
M5+Fo1NDPI9ulpVSsqNsNw: folds
33XJu1CVnl9YOngoPIhi0A collected $40 from pot
*** SUMMARY ***
Total pot $40 | Rake $0
Seat 2: NczJqEIUdrpEc5Nbd7h1Ig folded before Flop
Seat 3: M6ck0CntRJiM0JZjUketMw (button) folded before Flop
Seat 4: M5+Fo1NDPI9ulpVSsqNsNw (small blind) folded before Flop
Seat 5: 33XJu1CVnl9YOngoPIhi0A (big blind) collected ($40)
Seat 6: 3mTlg4g0FJN2bo939h/0Wg folded before Flop (didn't bet)



PokerStars Game #59950630662:  Hold'em No Limit ($5/$10) - 2009/07/01 6:56:51 ET
Table 'i93c3z9RLowvuJTKA2F4Jg' 6-max Seat #4 is the button
Seat 1: 4PqZA4LBAl9vQHtZEXba8A ($833.60 in chips)
Seat 2: Eg/lVWW82x/d4qDjaZ+NEw ($705.30 in chips)
Seat 3: y2ASmcO4UW2SjtgwgDba1Q ($2529 in chips)
Seat 4: aKvdmdJxoWBhMNgCGixGvA ($265.85 in chips)
Seat 5: qo/pEPLw1ud1Ab0Q/dMfBQ ($1000 in chips)
Seat 6: BbirlZJeYiPjSFVvLtEDVw ($1187 in chips)
qo/pEPLw1ud1Ab0Q/dMfBQ: posts small blind $5
BbirlZJeYiPjSFVvLtEDVw: posts big blind $10
*** HOLE CARDS ***
4PqZA4LBAl9vQHtZEXba8A has timed out
4PqZA4LBAl9vQHtZEXba8A: folds
4PqZA4LBAl9vQHtZEXba8A is sitting out
Eg/lVWW82x/d4qDjaZ+NEw: raises $20 to $30
y2ASmcO4UW2SjtgwgDba1Q: folds
aKvdmdJxoWBhMNgCGixGvA: raises $40 to $70
4PqZA4LBAl9vQHtZEXba8A has returned
qo/pEPLw1ud1Ab0Q/dMfBQ: folds
BbirlZJeYiPjSFVvLtEDVw: folds
Eg/lVWW82x/d4qDjaZ+NEw: raises $635.30 to $705.30 and is all-in
aKvdmdJxoWBhMNgCGixGvA: calls $195.85 and is all-in
*** FLOP *** [7d 4d Jc]
*** TURN *** [7d 4d Jc] [3c]
*** RIVER *** [7d 4d Jc 3c] [Qs]
*** SHOW DOWN ***
Eg/lVWW82x/d4qDjaZ+NEw: shows [Qh Qd] (three of a kind, Queens)
aKvdmdJxoWBhMNgCGixGvA: mucks hand
Eg/lVWW82x/d4qDjaZ+NEw collected $543.70 from pot
*** SUMMARY ***
Total pot $546.70 | Rake $3
Board [7d 4d Jc 3c Qs]
Seat 1: 4PqZA4LBAl9vQHtZEXba8A folded before Flop (didn't bet)
Seat 2: Eg/lVWW82x/d4qDjaZ+NEw showed [Qh Qd] and won ($543.70) with three of a kind, Queens
Seat 3: y2ASmcO4UW2SjtgwgDba1Q folded before Flop (didn't bet)
Seat 4: aKvdmdJxoWBhMNgCGixGvA (button) mucked
Seat 5: qo/pEPLw1ud1Ab0Q/dMfBQ (small blind) folded before Flop
Seat 6: BbirlZJeYiPjSFVvLtEDVw (big blind) folded before Flop



PokerStars Game #59950631122:  Hold'em No Limit ($5/$10) - 2009/07/01 6:56:52 ET
Table 'S53kfSbNcK1y2IhnKFrs4g' 6-max Seat #2 is the button
Seat 1: OFn0bkUWc4Uwkd8WCRgD+w ($1266 in chips)
Seat 2: jkH6qYMpn8JA/IyBOhQPMw ($1243 in chips)
Seat 3: BbirlZJeYiPjSFVvLtEDVw ($1100.75 in chips)
Seat 4: gU+uWicJt/6n+MQtSID0Zg ($293.50 in chips)
BbirlZJeYiPjSFVvLtEDVw: posts small blind $5
gU+uWicJt/6n+MQtSID0Zg: posts big blind $10
*** HOLE CARDS ***
OFn0bkUWc4Uwkd8WCRgD+w: folds
jkH6qYMpn8JA/IyBOhQPMw: folds
BbirlZJeYiPjSFVvLtEDVw: raises $20 to $30
gU+uWicJt/6n+MQtSID0Zg: raises $263.50 to $293.50 and is all-in
BbirlZJeYiPjSFVvLtEDVw: folds
gU+uWicJt/6n+MQtSID0Zg collected $60 from pot
*** SUMMARY ***
Total pot $60 | Rake $0
Seat 1: OFn0bkUWc4Uwkd8WCRgD+w folded before Flop (didn't bet)
Seat 2: jkH6qYMpn8JA/IyBOhQPMw (button) folded before Flop (didn't bet)
Seat 3: BbirlZJeYiPjSFVvLtEDVw (small blind) folded before Flop
Seat 4: gU+uWicJt/6n+MQtSID0Zg (big blind) collected ($60)



PokerStars Game #59950631902:  Hold'em No Limit ($5/$10) - 2009/07/01 6:56:53 ET
Table 't/kPJqOCKfHg56cSPeLt+g' 2-max Seat #1 is the button
Seat 1: ZX/GGiaYlXYG8RuKIPpO+g ($1003.25 in chips)
Seat 2: CUZXo12vZtpPjXlHjnWQmA ($1487 in chips)
ZX/GGiaYlXYG8RuKIPpO+g: posts small blind $5
CUZXo12vZtpPjXlHjnWQmA: posts big blind $10
*** HOLE CARDS ***
ZX/GGiaYlXYG8RuKIPpO+g: raises $20 to $30
CUZXo12vZtpPjXlHjnWQmA: folds
ZX/GGiaYlXYG8RuKIPpO+g collected $20 from pot
ZX/GGiaYlXYG8RuKIPpO+g: doesn't show hand
*** SUMMARY ***
Total pot $20 | Rake $0
Seat 1: ZX/GGiaYlXYG8RuKIPpO+g (button) (small blind) collected ($20)
Seat 2: CUZXo12vZtpPjXlHjnWQmA (big blind) folded before Flop



PokerStars Game #59950637994:  Hold'em No Limit ($5/$10) - 2009/07/01 6:57:04 ET
Table 't/kPJqOCKfHg56cSPeLt+g' 2-max Seat #2 is the button
Seat 1: ZX/GGiaYlXYG8RuKIPpO+g ($1013.25 in chips)
Seat 2: CUZXo12vZtpPjXlHjnWQmA ($1477 in chips)
CUZXo12vZtpPjXlHjnWQmA: posts small blind $5
ZX/GGiaYlXYG8RuKIPpO+g: posts big blind $10
*** HOLE CARDS ***
CUZXo12vZtpPjXlHjnWQmA: raises $20 to $30
ZX/GGiaYlXYG8RuKIPpO+g: folds
CUZXo12vZtpPjXlHjnWQmA collected $20 from pot
CUZXo12vZtpPjXlHjnWQmA: doesn't show hand
*** SUMMARY ***
Total pot $20 | Rake $0
Seat 1: ZX/GGiaYlXYG8RuKIPpO+g (big blind) folded before Flop
Seat 2: CUZXo12vZtpPjXlHjnWQmA (button) (small blind) collected ($20)



PokerStars Game #59950644006:  Hold'em No Limit ($5/$10) - 2009/07/01 6:57:14 ET
Table 'B7gQa8IrNZTRZX43XhFKUA' 6-max Seat #3 is the button
Seat 1: jkH6qYMpn8JA/IyBOhQPMw ($1208 in chips)
Seat 3: 1ScqYmNf7/uWx1XSBgPTBw ($200 in chips)
Seat 4: BbirlZJeYiPjSFVvLtEDVw ($2181.10 in chips)
Seat 5: BESARbstyvj3tWmTi4s3eg ($898 in chips)
BbirlZJeYiPjSFVvLtEDVw: posts small blind $5
BESARbstyvj3tWmTi4s3eg: posts big blind $10
*** HOLE CARDS ***
jkH6qYMpn8JA/IyBOhQPMw: folds
1ScqYmNf7/uWx1XSBgPTBw: folds
BbirlZJeYiPjSFVvLtEDVw: raises $20 to $30
BESARbstyvj3tWmTi4s3eg: folds
BbirlZJeYiPjSFVvLtEDVw collected $20 from pot
*** SUMMARY ***
Total pot $20 | Rake $0
Seat 1: jkH6qYMpn8JA/IyBOhQPMw folded before Flop (didn't bet)
Seat 3: 1ScqYmNf7/uWx1XSBgPTBw (button) folded before Flop (didn't bet)
Seat 4: BbirlZJeYiPjSFVvLtEDVw (small blind) collected ($20)
Seat 5: BESARbstyvj3tWmTi4s3eg (big blind) folded before Flop



PokerStars Game #59950643732:  Hold'em No Limit ($5/$10) - 2009/07/01 6:57:14 ET
Table 'ZemUU8uyOTYQAgqnaWQDUA' 6-max Seat #4 is the button
Seat 2: NczJqEIUdrpEc5Nbd7h1Ig ($591 in chips)
Seat 3: M6ck0CntRJiM0JZjUketMw ($439 in chips)
Seat 4: M5+Fo1NDPI9ulpVSsqNsNw ($354.10 in chips)
Seat 5: 33XJu1CVnl9YOngoPIhi0A ($834.45 in chips)
Seat 6: 3mTlg4g0FJN2bo939h/0Wg ($275 in chips)
33XJu1CVnl9YOngoPIhi0A: posts small blind $5
3mTlg4g0FJN2bo939h/0Wg: posts big blind $10
*** HOLE CARDS ***
NczJqEIUdrpEc5Nbd7h1Ig: calls $10
M6ck0CntRJiM0JZjUketMw: folds
M5+Fo1NDPI9ulpVSsqNsNw: folds
33XJu1CVnl9YOngoPIhi0A: folds
3mTlg4g0FJN2bo939h/0Wg: checks
*** FLOP *** [6h 7s 5h]
3mTlg4g0FJN2bo939h/0Wg: bets $20
NczJqEIUdrpEc5Nbd7h1Ig: calls $20
*** TURN *** [6h 7s 5h] [3s]
3mTlg4g0FJN2bo939h/0Wg: checks
NczJqEIUdrpEc5Nbd7h1Ig: checks
*** RIVER *** [6h 7s 5h 3s] [Td]
3mTlg4g0FJN2bo939h/0Wg: bets $40
NczJqEIUdrpEc5Nbd7h1Ig: raises $80 to $120
3mTlg4g0FJN2bo939h/0Wg: calls $80
*** SHOW DOWN ***
NczJqEIUdrpEc5Nbd7h1Ig: shows [Qh 4c] (a straight, Three to Seven)
3mTlg4g0FJN2bo939h/0Wg: shows [7d 4s] (a straight, Three to Seven)
3mTlg4g0FJN2bo939h/0Wg collected $151.50 from pot
NczJqEIUdrpEc5Nbd7h1Ig collected $151.50 from pot
*** SUMMARY ***
Total pot $305 | Rake $2
Board [6h 7s 5h 3s Td]
Seat 2: NczJqEIUdrpEc5Nbd7h1Ig showed [Qh 4c] and won ($151.50) with a straight, Three to Seven
Seat 3: M6ck0CntRJiM0JZjUketMw folded before Flop (didn't bet)
Seat 4: M5+Fo1NDPI9ulpVSsqNsNw (button) folded before Flop (didn't bet)
Seat 5: 33XJu1CVnl9YOngoPIhi0A (small blind) folded before Flop
Seat 6: 3mTlg4g0FJN2bo939h/0Wg (big blind) showed [7d 4s] and won ($151.50) with a straight, Three to Seven



PokerStars Game #59950644368:  Hold'em No Limit ($5/$10) - 2009/07/01 6:57:15 ET
Table 't/kPJqOCKfHg56cSPeLt+g' 2-max Seat #1 is the button
Seat 1: ZX/GGiaYlXYG8RuKIPpO+g ($1003.25 in chips)
Seat 2: CUZXo12vZtpPjXlHjnWQmA ($1487 in chips)
ZX/GGiaYlXYG8RuKIPpO+g: posts small blind $5
CUZXo12vZtpPjXlHjnWQmA: posts big blind $10
*** HOLE CARDS ***
ZX/GGiaYlXYG8RuKIPpO+g: folds
CUZXo12vZtpPjXlHjnWQmA collected $10 from pot
CUZXo12vZtpPjXlHjnWQmA: doesn't show hand
*** SUMMARY ***
Total pot $10 | Rake $0
Seat 1: ZX/GGiaYlXYG8RuKIPpO+g (button) (small blind) folded before Flop
Seat 2: CUZXo12vZtpPjXlHjnWQmA (big blind) collected ($10)



PokerStars Game #59950646018:  Hold'em No Limit ($5/$10) - 2009/07/01 6:57:18 ET
Table 'S53kfSbNcK1y2IhnKFrs4g' 6-max Seat #3 is the button
Seat 1: OFn0bkUWc4Uwkd8WCRgD+w ($1266 in chips)
Seat 2: jkH6qYMpn8JA/IyBOhQPMw ($1243 in chips)
Seat 3: BbirlZJeYiPjSFVvLtEDVw ($1070.75 in chips)
Seat 4: gU+uWicJt/6n+MQtSID0Zg ($323.50 in chips)
gU+uWicJt/6n+MQtSID0Zg: posts small blind $5
OFn0bkUWc4Uwkd8WCRgD+w: posts big blind $10
*** HOLE CARDS ***
jkH6qYMpn8JA/IyBOhQPMw: folds
BbirlZJeYiPjSFVvLtEDVw: raises $20 to $30
gU+uWicJt/6n+MQtSID0Zg: folds
OFn0bkUWc4Uwkd8WCRgD+w: raises $80 to $110
BbirlZJeYiPjSFVvLtEDVw: folds
OFn0bkUWc4Uwkd8WCRgD+w collected $65 from pot
OFn0bkUWc4Uwkd8WCRgD+w: doesn't show hand
*** SUMMARY ***
Total pot $65 | Rake $0
Seat 1: OFn0bkUWc4Uwkd8WCRgD+w (big blind) collected ($65)
Seat 2: jkH6qYMpn8JA/IyBOhQPMw folded before Flop (didn't bet)
Seat 3: BbirlZJeYiPjSFVvLtEDVw (button) folded before Flop
Seat 4: gU+uWicJt/6n+MQtSID0Zg (small blind) folded before Flop



PokerStars Game #59950647444:  Hold'em No Limit ($5/$10) - 2009/07/01 6:57:20 ET
Table 't/kPJqOCKfHg56cSPeLt+g' 2-max Seat #2 is the button
Seat 1: ZX/GGiaYlXYG8RuKIPpO+g ($998.25 in chips)
Seat 2: CUZXo12vZtpPjXlHjnWQmA ($1492 in chips)
CUZXo12vZtpPjXlHjnWQmA: posts small blind $5
ZX/GGiaYlXYG8RuKIPpO+g: posts big blind $10
*** HOLE CARDS ***
CUZXo12vZtpPjXlHjnWQmA: raises $20 to $30
ZX/GGiaYlXYG8RuKIPpO+g: folds
CUZXo12vZtpPjXlHjnWQmA collected $20 from pot
CUZXo12vZtpPjXlHjnWQmA: doesn't show hand
*** SUMMARY ***
Total pot $20 | Rake $0
Seat 1: ZX/GGiaYlXYG8RuKIPpO+g (big blind) folded before Flop
Seat 2: CUZXo12vZtpPjXlHjnWQmA (button) (small blind) collected ($20)



PokerStars Game #59950655028:  Hold'em No Limit ($5/$10) - 2009/07/01 6:57:34 ET
Table 't/kPJqOCKfHg56cSPeLt+g' 2-max Seat #1 is the button
Seat 1: ZX/GGiaYlXYG8RuKIPpO+g ($988.25 in chips)
Seat 2: CUZXo12vZtpPjXlHjnWQmA ($1502 in chips)
ZX/GGiaYlXYG8RuKIPpO+g: posts small blind $5
CUZXo12vZtpPjXlHjnWQmA: posts big blind $10
*** HOLE CARDS ***
ZX/GGiaYlXYG8RuKIPpO+g: raises $20 to $30
CUZXo12vZtpPjXlHjnWQmA: folds
ZX/GGiaYlXYG8RuKIPpO+g collected $20 from pot
ZX/GGiaYlXYG8RuKIPpO+g: doesn't show hand
*** SUMMARY ***
Total pot $20 | Rake $0
Seat 1: ZX/GGiaYlXYG8RuKIPpO+g (button) (small blind) collected ($20)
Seat 2: CUZXo12vZtpPjXlHjnWQmA (big blind) folded before Flop



PokerStars Game #59950656406:  Hold'em No Limit ($5/$10) - 2009/07/01 6:57:36 ET
Table 'S53kfSbNcK1y2IhnKFrs4g' 6-max Seat #4 is the button
Seat 1: OFn0bkUWc4Uwkd8WCRgD+w ($1301 in chips)
Seat 2: jkH6qYMpn8JA/IyBOhQPMw ($1243 in chips)
Seat 3: BbirlZJeYiPjSFVvLtEDVw ($1040.75 in chips)
Seat 4: gU+uWicJt/6n+MQtSID0Zg ($318.50 in chips)
OFn0bkUWc4Uwkd8WCRgD+w: posts small blind $5
jkH6qYMpn8JA/IyBOhQPMw: posts big blind $10
*** HOLE CARDS ***
BbirlZJeYiPjSFVvLtEDVw: raises $20 to $30
gU+uWicJt/6n+MQtSID0Zg: folds
OFn0bkUWc4Uwkd8WCRgD+w: folds
jkH6qYMpn8JA/IyBOhQPMw: folds
BbirlZJeYiPjSFVvLtEDVw collected $25 from pot
BbirlZJeYiPjSFVvLtEDVw: doesn't show hand
*** SUMMARY ***
Total pot $25 | Rake $0
Seat 1: OFn0bkUWc4Uwkd8WCRgD+w (small blind) folded before Flop
Seat 2: jkH6qYMpn8JA/IyBOhQPMw (big blind) folded before Flop
Seat 3: BbirlZJeYiPjSFVvLtEDVw collected ($25)
Seat 4: gU+uWicJt/6n+MQtSID0Zg (button) folded before Flop (didn't bet)



PokerStars Game #59950658912:  Hold'em No Limit ($5/$10) - 2009/07/01 6:57:41 ET
Table 't/kPJqOCKfHg56cSPeLt+g' 2-max Seat #2 is the button
Seat 1: ZX/GGiaYlXYG8RuKIPpO+g ($998.25 in chips)
Seat 2: CUZXo12vZtpPjXlHjnWQmA ($1492 in chips)
CUZXo12vZtpPjXlHjnWQmA: posts small blind $5
ZX/GGiaYlXYG8RuKIPpO+g: posts big blind $10
*** HOLE CARDS ***
CUZXo12vZtpPjXlHjnWQmA: raises $20 to $30
ZX/GGiaYlXYG8RuKIPpO+g: folds
CUZXo12vZtpPjXlHjnWQmA collected $20 from pot
CUZXo12vZtpPjXlHjnWQmA: doesn't show hand
*** SUMMARY ***
Total pot $20 | Rake $0
Seat 1: ZX/GGiaYlXYG8RuKIPpO+g (big blind) folded before Flop
Seat 2: CUZXo12vZtpPjXlHjnWQmA (button) (small blind) collected ($20)



PokerStars Game #59950661220:  Hold'em No Limit ($5/$10) - 2009/07/01 6:57:45 ET
Table 'i93c3z9RLowvuJTKA2F4Jg' 6-max Seat #5 is the button
Seat 1: 4PqZA4LBAl9vQHtZEXba8A ($833.60 in chips)
Seat 2: Eg/lVWW82x/d4qDjaZ+NEw ($983.15 in chips)
Seat 3: y2ASmcO4UW2SjtgwgDba1Q ($2529 in chips)
Seat 5: qo/pEPLw1ud1Ab0Q/dMfBQ ($1000 in chips)
Seat 6: BbirlZJeYiPjSFVvLtEDVw ($1177 in chips)
BbirlZJeYiPjSFVvLtEDVw: posts small blind $5
4PqZA4LBAl9vQHtZEXba8A: posts big blind $10
*** HOLE CARDS ***
Eg/lVWW82x/d4qDjaZ+NEw: folds
y2ASmcO4UW2SjtgwgDba1Q: raises $20 to $30
qo/pEPLw1ud1Ab0Q/dMfBQ: folds
BbirlZJeYiPjSFVvLtEDVw: folds
4PqZA4LBAl9vQHtZEXba8A: folds
y2ASmcO4UW2SjtgwgDba1Q collected $25 from pot
*** SUMMARY ***
Total pot $25 | Rake $0
Seat 1: 4PqZA4LBAl9vQHtZEXba8A (big blind) folded before Flop
Seat 2: Eg/lVWW82x/d4qDjaZ+NEw folded before Flop (didn't bet)
Seat 3: y2ASmcO4UW2SjtgwgDba1Q collected ($25)
Seat 5: qo/pEPLw1ud1Ab0Q/dMfBQ (button) folded before Flop (didn't bet)
Seat 6: BbirlZJeYiPjSFVvLtEDVw (small blind) folded before Flop



PokerStars Game #59950663238:  Hold'em No Limit ($5/$10) - 2009/07/01 6:57:48 ET
Table 't/kPJqOCKfHg56cSPeLt+g' 2-max Seat #1 is the button
Seat 1: ZX/GGiaYlXYG8RuKIPpO+g ($988.25 in chips)
Seat 2: CUZXo12vZtpPjXlHjnWQmA ($1502 in chips)
ZX/GGiaYlXYG8RuKIPpO+g: posts small blind $5
CUZXo12vZtpPjXlHjnWQmA: posts big blind $10
*** HOLE CARDS ***
ZX/GGiaYlXYG8RuKIPpO+g: calls $5
CUZXo12vZtpPjXlHjnWQmA: checks
*** FLOP *** [7s Kh 5s]
CUZXo12vZtpPjXlHjnWQmA: checks
ZX/GGiaYlXYG8RuKIPpO+g: checks
*** TURN *** [7s Kh 5s] [7c]
CUZXo12vZtpPjXlHjnWQmA: checks
ZX/GGiaYlXYG8RuKIPpO+g: bets $20
CUZXo12vZtpPjXlHjnWQmA: folds
ZX/GGiaYlXYG8RuKIPpO+g collected $19.50 from pot
ZX/GGiaYlXYG8RuKIPpO+g: doesn't show hand
*** SUMMARY ***
Total pot $20 | Rake $0.50
Board [7s Kh 5s 7c]
Seat 1: ZX/GGiaYlXYG8RuKIPpO+g (button) (small blind) collected ($19.50)
Seat 2: CUZXo12vZtpPjXlHjnWQmA (big blind) folded on the Turn



PokerStars Game #59950668768:  Hold'em No Limit ($5/$10) - 2009/07/01 6:57:58 ET
Table 'i93c3z9RLowvuJTKA2F4Jg' 6-max Seat #6 is the button
Seat 1: 4PqZA4LBAl9vQHtZEXba8A ($823.60 in chips)
Seat 2: Eg/lVWW82x/d4qDjaZ+NEw ($983.15 in chips)
Seat 3: y2ASmcO4UW2SjtgwgDba1Q ($2544 in chips)
Seat 5: qo/pEPLw1ud1Ab0Q/dMfBQ ($1000 in chips)
Seat 6: BbirlZJeYiPjSFVvLtEDVw ($1172 in chips)
4PqZA4LBAl9vQHtZEXba8A: posts small blind $5
Eg/lVWW82x/d4qDjaZ+NEw: posts big blind $10
*** HOLE CARDS ***
y2ASmcO4UW2SjtgwgDba1Q: folds
qo/pEPLw1ud1Ab0Q/dMfBQ: folds
BbirlZJeYiPjSFVvLtEDVw: raises $20 to $30
4PqZA4LBAl9vQHtZEXba8A: folds
Eg/lVWW82x/d4qDjaZ+NEw: folds
BbirlZJeYiPjSFVvLtEDVw collected $25 from pot
BbirlZJeYiPjSFVvLtEDVw: doesn't show hand
*** SUMMARY ***
Total pot $25 | Rake $0
Seat 1: 4PqZA4LBAl9vQHtZEXba8A (small blind) folded before Flop
Seat 2: Eg/lVWW82x/d4qDjaZ+NEw (big blind) folded before Flop
Seat 3: y2ASmcO4UW2SjtgwgDba1Q folded before Flop (didn't bet)
Seat 5: qo/pEPLw1ud1Ab0Q/dMfBQ folded before Flop (didn't bet)
Seat 6: BbirlZJeYiPjSFVvLtEDVw (button) collected ($25)



PokerStars Game #59950671956:  Hold'em No Limit ($5/$10) - 2009/07/01 6:58:03 ET
Table 't/kPJqOCKfHg56cSPeLt+g' 2-max Seat #2 is the button
Seat 1: ZX/GGiaYlXYG8RuKIPpO+g ($997.75 in chips)
Seat 2: CUZXo12vZtpPjXlHjnWQmA ($1492 in chips)
CUZXo12vZtpPjXlHjnWQmA: posts small blind $5
ZX/GGiaYlXYG8RuKIPpO+g: posts big blind $10
*** HOLE CARDS ***
CUZXo12vZtpPjXlHjnWQmA: raises $20 to $30
ZX/GGiaYlXYG8RuKIPpO+g: folds
CUZXo12vZtpPjXlHjnWQmA collected $20 from pot
CUZXo12vZtpPjXlHjnWQmA: doesn't show hand
*** SUMMARY ***
Total pot $20 | Rake $0
Seat 1: ZX/GGiaYlXYG8RuKIPpO+g (big blind) folded before Flop
Seat 2: CUZXo12vZtpPjXlHjnWQmA (button) (small blind) collected ($20)



PokerStars Game #59950675956:  Hold'em No Limit ($5/$10) - 2009/07/01 6:58:10 ET
Table 't/kPJqOCKfHg56cSPeLt+g' 2-max Seat #1 is the button
Seat 1: ZX/GGiaYlXYG8RuKIPpO+g ($987.75 in chips)
Seat 2: CUZXo12vZtpPjXlHjnWQmA ($1502 in chips)
ZX/GGiaYlXYG8RuKIPpO+g: posts small blind $5
CUZXo12vZtpPjXlHjnWQmA: posts big blind $10
*** HOLE CARDS ***
ZX/GGiaYlXYG8RuKIPpO+g: folds
CUZXo12vZtpPjXlHjnWQmA collected $10 from pot
CUZXo12vZtpPjXlHjnWQmA: doesn't show hand
*** SUMMARY ***
Total pot $10 | Rake $0
Seat 1: ZX/GGiaYlXYG8RuKIPpO+g (button) (small blind) folded before Flop
Seat 2: CUZXo12vZtpPjXlHjnWQmA (big blind) collected ($10)



PokerStars Game #59950675700:  Hold'em No Limit ($5/$10) - 2009/07/01 6:58:10 ET
Table 'S53kfSbNcK1y2IhnKFrs4g' 6-max Seat #1 is the button
Seat 1: OFn0bkUWc4Uwkd8WCRgD+w ($1296 in chips)
Seat 2: jkH6qYMpn8JA/IyBOhQPMw ($1233 in chips)
Seat 3: BbirlZJeYiPjSFVvLtEDVw ($1055.75 in chips)
Seat 4: gU+uWicJt/6n+MQtSID0Zg ($318.50 in chips)
jkH6qYMpn8JA/IyBOhQPMw: posts small blind $5
BbirlZJeYiPjSFVvLtEDVw: posts big blind $10
*** HOLE CARDS ***
gU+uWicJt/6n+MQtSID0Zg: folds
gU+uWicJt/6n+MQtSID0Zg is sitting out
gU+uWicJt/6n+MQtSID0Zg leaves the table
OFn0bkUWc4Uwkd8WCRgD+w: folds
jkH6qYMpn8JA/IyBOhQPMw: raises $20 to $30
BbirlZJeYiPjSFVvLtEDVw: folds
jkH6qYMpn8JA/IyBOhQPMw collected $20 from pot
jkH6qYMpn8JA/IyBOhQPMw: doesn't show hand
*** SUMMARY ***
Total pot $20 | Rake $0
Seat 1: OFn0bkUWc4Uwkd8WCRgD+w (button) folded before Flop (didn't bet)
Seat 2: jkH6qYMpn8JA/IyBOhQPMw (small blind) collected ($20)
Seat 3: BbirlZJeYiPjSFVvLtEDVw (big blind) folded before Flop
Seat 4: gU+uWicJt/6n+MQtSID0Zg folded before Flop (didn't bet)



PokerStars Game #59950679082:  Hold'em No Limit ($5/$10) - 2009/07/01 6:58:16 ET
Table 't/kPJqOCKfHg56cSPeLt+g' 2-max Seat #2 is the button
Seat 1: ZX/GGiaYlXYG8RuKIPpO+g ($982.75 in chips)
Seat 2: CUZXo12vZtpPjXlHjnWQmA ($1507 in chips)
CUZXo12vZtpPjXlHjnWQmA: posts small blind $5
ZX/GGiaYlXYG8RuKIPpO+g: posts big blind $10
*** HOLE CARDS ***
CUZXo12vZtpPjXlHjnWQmA: raises $20 to $30
ZX/GGiaYlXYG8RuKIPpO+g: folds
CUZXo12vZtpPjXlHjnWQmA collected $20 from pot
CUZXo12vZtpPjXlHjnWQmA: doesn't show hand
*** SUMMARY ***
Total pot $20 | Rake $0
Seat 1: ZX/GGiaYlXYG8RuKIPpO+g (big blind) folded before Flop
Seat 2: CUZXo12vZtpPjXlHjnWQmA (button) (small blind) collected ($20)



PokerStars Game #59950680490:  Hold'em No Limit ($5/$10) - 2009/07/01 6:58:18 ET
Table 'ZemUU8uyOTYQAgqnaWQDUA' 6-max Seat #5 is the button
Seat 2: NczJqEIUdrpEc5Nbd7h1Ig ($592.50 in chips)
Seat 3: M6ck0CntRJiM0JZjUketMw ($439 in chips)
Seat 4: M5+Fo1NDPI9ulpVSsqNsNw ($354.10 in chips)
Seat 5: 33XJu1CVnl9YOngoPIhi0A ($829.45 in chips)
Seat 6: 3mTlg4g0FJN2bo939h/0Wg ($276.50 in chips)
3mTlg4g0FJN2bo939h/0Wg: posts small blind $5
NczJqEIUdrpEc5Nbd7h1Ig: posts big blind $10
*** HOLE CARDS ***
M6ck0CntRJiM0JZjUketMw: raises $29 to $39
M5+Fo1NDPI9ulpVSsqNsNw: folds
33XJu1CVnl9YOngoPIhi0A: folds
3mTlg4g0FJN2bo939h/0Wg: calls $34
NczJqEIUdrpEc5Nbd7h1Ig: calls $29
*** FLOP *** [As 8c 4s]
3mTlg4g0FJN2bo939h/0Wg: checks
NczJqEIUdrpEc5Nbd7h1Ig: checks
M6ck0CntRJiM0JZjUketMw: bets $110
3mTlg4g0FJN2bo939h/0Wg: raises $127.50 to $237.50 and is all-in
NczJqEIUdrpEc5Nbd7h1Ig: folds
M6ck0CntRJiM0JZjUketMw: calls $127.50
*** TURN *** [As 8c 4s] [Ah]
*** RIVER *** [As 8c 4s Ah] [5d]
*** SHOW DOWN ***
3mTlg4g0FJN2bo939h/0Wg: shows [Js Ks] (a pair of Aces)
M6ck0CntRJiM0JZjUketMw: shows [9s Ac] (three of a kind, Aces)
M6ck0CntRJiM0JZjUketMw collected $590 from pot
*** SUMMARY ***
Total pot $592 | Rake $2
Board [As 8c 4s Ah 5d]
Seat 2: NczJqEIUdrpEc5Nbd7h1Ig (big blind) folded on the Flop
Seat 3: M6ck0CntRJiM0JZjUketMw showed [9s Ac] and won ($590) with three of a kind, Aces
Seat 4: M5+Fo1NDPI9ulpVSsqNsNw folded before Flop (didn't bet)
Seat 5: 33XJu1CVnl9YOngoPIhi0A (button) folded before Flop (didn't bet)
Seat 6: 3mTlg4g0FJN2bo939h/0Wg (small blind) showed [Js Ks] and lost with a pair of Aces



PokerStars Game #59950683022:  Hold'em No Limit ($5/$10) - 2009/07/01 6:58:23 ET
Table 'i93c3z9RLowvuJTKA2F4Jg' 6-max Seat #1 is the button
Seat 1: 4PqZA4LBAl9vQHtZEXba8A ($818.60 in chips)
Seat 2: Eg/lVWW82x/d4qDjaZ+NEw ($973.15 in chips)
Seat 3: y2ASmcO4UW2SjtgwgDba1Q ($2544 in chips)
Seat 5: qo/pEPLw1ud1Ab0Q/dMfBQ ($1000 in chips)
Seat 6: BbirlZJeYiPjSFVvLtEDVw ($1187 in chips)
Eg/lVWW82x/d4qDjaZ+NEw: posts small blind $5
y2ASmcO4UW2SjtgwgDba1Q: posts big blind $10
*** HOLE CARDS ***
qo/pEPLw1ud1Ab0Q/dMfBQ: folds
BbirlZJeYiPjSFVvLtEDVw: raises $20 to $30
4PqZA4LBAl9vQHtZEXba8A: folds
Eg/lVWW82x/d4qDjaZ+NEw: raises $50 to $80
y2ASmcO4UW2SjtgwgDba1Q: folds
BbirlZJeYiPjSFVvLtEDVw: calls $50
*** FLOP *** [7c Th 8s]
Eg/lVWW82x/d4qDjaZ+NEw: bets $121
BbirlZJeYiPjSFVvLtEDVw: folds
Eg/lVWW82x/d4qDjaZ+NEw collected $168 from pot
Eg/lVWW82x/d4qDjaZ+NEw: doesn't show hand
*** SUMMARY ***
Total pot $170 | Rake $2
Board [7c Th 8s]
Seat 1: 4PqZA4LBAl9vQHtZEXba8A (button) folded before Flop (didn't bet)
Seat 2: Eg/lVWW82x/d4qDjaZ+NEw (small blind) collected ($168)
Seat 3: y2ASmcO4UW2SjtgwgDba1Q (big blind) folded before Flop
Seat 5: qo/pEPLw1ud1Ab0Q/dMfBQ folded before Flop (didn't bet)
Seat 6: BbirlZJeYiPjSFVvLtEDVw folded on the Flop



PokerStars Game #59950683528:  Hold'em No Limit ($5/$10) - 2009/07/01 6:58:24 ET
Table 't/kPJqOCKfHg56cSPeLt+g' 2-max Seat #1 is the button
Seat 1: ZX/GGiaYlXYG8RuKIPpO+g ($972.75 in chips)
Seat 2: CUZXo12vZtpPjXlHjnWQmA ($1517 in chips)
ZX/GGiaYlXYG8RuKIPpO+g: posts small blind $5
CUZXo12vZtpPjXlHjnWQmA: posts big blind $10
*** HOLE CARDS ***
ZX/GGiaYlXYG8RuKIPpO+g: folds
CUZXo12vZtpPjXlHjnWQmA collected $10 from pot
CUZXo12vZtpPjXlHjnWQmA: doesn't show hand
*** SUMMARY ***
Total pot $10 | Rake $0
Seat 1: ZX/GGiaYlXYG8RuKIPpO+g (button) (small blind) folded before Flop
Seat 2: CUZXo12vZtpPjXlHjnWQmA (big blind) collected ($10)



PokerStars Game #59950685588:  Hold'em No Limit ($5/$10) - 2009/07/01 6:58:28 ET
Table 'B7gQa8IrNZTRZX43XhFKUA' 6-max Seat #4 is the button
Seat 1: jkH6qYMpn8JA/IyBOhQPMw ($1208 in chips)
Seat 3: 1ScqYmNf7/uWx1XSBgPTBw ($200 in chips)
Seat 4: BbirlZJeYiPjSFVvLtEDVw ($2191.10 in chips)
Seat 5: BESARbstyvj3tWmTi4s3eg ($888 in chips)
BESARbstyvj3tWmTi4s3eg: posts small blind $5
jkH6qYMpn8JA/IyBOhQPMw: posts big blind $10
*** HOLE CARDS ***
1ScqYmNf7/uWx1XSBgPTBw: folds
BbirlZJeYiPjSFVvLtEDVw: raises $20 to $30
BESARbstyvj3tWmTi4s3eg: folds
jkH6qYMpn8JA/IyBOhQPMw: calls $20
*** FLOP *** [7d Qc Jc]
jkH6qYMpn8JA/IyBOhQPMw: checks
BbirlZJeYiPjSFVvLtEDVw: bets $50
jkH6qYMpn8JA/IyBOhQPMw: folds
BbirlZJeYiPjSFVvLtEDVw collected $63 from pot
*** SUMMARY ***
Total pot $65 | Rake $2
Board [7d Qc Jc]
Seat 1: jkH6qYMpn8JA/IyBOhQPMw (big blind) folded on the Flop
Seat 3: 1ScqYmNf7/uWx1XSBgPTBw folded before Flop (didn't bet)
Seat 4: BbirlZJeYiPjSFVvLtEDVw (button) collected ($63)
Seat 5: BESARbstyvj3tWmTi4s3eg (small blind) folded before Flop



PokerStars Game #59950686446:  Hold'em No Limit ($5/$10) - 2009/07/01 6:58:29 ET
Table 't/kPJqOCKfHg56cSPeLt+g' 2-max Seat #2 is the button
Seat 1: ZX/GGiaYlXYG8RuKIPpO+g ($967.75 in chips)
Seat 2: CUZXo12vZtpPjXlHjnWQmA ($1522 in chips)
CUZXo12vZtpPjXlHjnWQmA: posts small blind $5
ZX/GGiaYlXYG8RuKIPpO+g: posts big blind $10
*** HOLE CARDS ***
CUZXo12vZtpPjXlHjnWQmA: raises $20 to $30
ZX/GGiaYlXYG8RuKIPpO+g: folds
CUZXo12vZtpPjXlHjnWQmA collected $20 from pot
CUZXo12vZtpPjXlHjnWQmA: doesn't show hand
*** SUMMARY ***
Total pot $20 | Rake $0
Seat 1: ZX/GGiaYlXYG8RuKIPpO+g (big blind) folded before Flop
Seat 2: CUZXo12vZtpPjXlHjnWQmA (button) (small blind) collected ($20)



PokerStars Game #59950692900:  Hold'em No Limit ($5/$10) - 2009/07/01 6:58:41 ET
Table 't/kPJqOCKfHg56cSPeLt+g' 2-max Seat #1 is the button
Seat 1: ZX/GGiaYlXYG8RuKIPpO+g ($957.75 in chips)
Seat 2: CUZXo12vZtpPjXlHjnWQmA ($1532 in chips)
ZX/GGiaYlXYG8RuKIPpO+g: posts small blind $5
CUZXo12vZtpPjXlHjnWQmA: posts big blind $10
*** HOLE CARDS ***
ZX/GGiaYlXYG8RuKIPpO+g: calls $5
CUZXo12vZtpPjXlHjnWQmA: raises $30 to $40
ZX/GGiaYlXYG8RuKIPpO+g: folds
CUZXo12vZtpPjXlHjnWQmA collected $20 from pot
CUZXo12vZtpPjXlHjnWQmA: doesn't show hand
*** SUMMARY ***
Total pot $20 | Rake $0
Seat 1: ZX/GGiaYlXYG8RuKIPpO+g (button) (small blind) folded before Flop
Seat 2: CUZXo12vZtpPjXlHjnWQmA (big blind) collected ($20)



PokerStars Game #59950698732:  Hold'em No Limit ($5/$10) - 2009/07/01 6:58:51 ET
Table 't/kPJqOCKfHg56cSPeLt+g' 2-max Seat #2 is the button
Seat 1: ZX/GGiaYlXYG8RuKIPpO+g ($947.75 in chips)
Seat 2: CUZXo12vZtpPjXlHjnWQmA ($1542 in chips)
CUZXo12vZtpPjXlHjnWQmA: posts small blind $5
ZX/GGiaYlXYG8RuKIPpO+g: posts big blind $10
*** HOLE CARDS ***
CUZXo12vZtpPjXlHjnWQmA: raises $20 to $30
ZX/GGiaYlXYG8RuKIPpO+g: raises $70 to $100
CUZXo12vZtpPjXlHjnWQmA: calls $70
*** FLOP *** [6c 7h Th]
ZX/GGiaYlXYG8RuKIPpO+g: checks
CUZXo12vZtpPjXlHjnWQmA: checks
*** TURN *** [6c 7h Th] [Qd]
ZX/GGiaYlXYG8RuKIPpO+g: checks
CUZXo12vZtpPjXlHjnWQmA: checks
*** RIVER *** [6c 7h Th Qd] [Tc]
ZX/GGiaYlXYG8RuKIPpO+g: checks
CUZXo12vZtpPjXlHjnWQmA: bets $50
ZX/GGiaYlXYG8RuKIPpO+g: folds
CUZXo12vZtpPjXlHjnWQmA collected $199.50 from pot
CUZXo12vZtpPjXlHjnWQmA: doesn't show hand
*** SUMMARY ***
Total pot $200 | Rake $0.50
Board [6c 7h Th Qd Tc]
Seat 1: ZX/GGiaYlXYG8RuKIPpO+g (big blind) folded on the River
Seat 2: CUZXo12vZtpPjXlHjnWQmA (button) (small blind) collected ($199.50)



PokerStars Game #59950703182:  Hold'em No Limit ($5/$10) - 2009/07/01 6:58:59 ET
Table 'ZemUU8uyOTYQAgqnaWQDUA' 6-max Seat #2 is the button
Seat 2: NczJqEIUdrpEc5Nbd7h1Ig ($553.50 in chips)
Seat 3: M6ck0CntRJiM0JZjUketMw ($752.50 in chips)
Seat 4: M5+Fo1NDPI9ulpVSsqNsNw ($354.10 in chips)
Seat 5: 33XJu1CVnl9YOngoPIhi0A ($829.45 in chips)
M6ck0CntRJiM0JZjUketMw: posts small blind $5
M5+Fo1NDPI9ulpVSsqNsNw: posts big blind $10
*** HOLE CARDS ***
33XJu1CVnl9YOngoPIhi0A: folds
NczJqEIUdrpEc5Nbd7h1Ig: calls $10
M6ck0CntRJiM0JZjUketMw: raises $10 to $20
ObR8mkxB7pPf0NUAtp9riQ joins the table at seat #1
M5+Fo1NDPI9ulpVSsqNsNw: calls $10
3mTlg4g0FJN2bo939h/0Wg has returned
NczJqEIUdrpEc5Nbd7h1Ig: calls $10
*** FLOP *** [Kd Qc 2s]
M6ck0CntRJiM0JZjUketMw: bets $60
M5+Fo1NDPI9ulpVSsqNsNw: folds
NczJqEIUdrpEc5Nbd7h1Ig: folds
M6ck0CntRJiM0JZjUketMw collected $58 from pot
M6ck0CntRJiM0JZjUketMw: shows [Kc Ah] (a pair of Kings)
*** SUMMARY ***
Total pot $60 | Rake $2
Board [Kd Qc 2s]
Seat 2: NczJqEIUdrpEc5Nbd7h1Ig (button) folded on the Flop
Seat 3: M6ck0CntRJiM0JZjUketMw (small blind) collected ($58)
Seat 4: M5+Fo1NDPI9ulpVSsqNsNw (big blind) folded on the Flop
Seat 5: 33XJu1CVnl9YOngoPIhi0A folded before Flop (didn't bet)



PokerStars Game #59950705010:  Hold'em No Limit ($5/$10) - 2009/07/01 6:59:02 ET
Table 'i93c3z9RLowvuJTKA2F4Jg' 6-max Seat #2 is the button
Seat 1: 4PqZA4LBAl9vQHtZEXba8A ($818.60 in chips)
Seat 2: Eg/lVWW82x/d4qDjaZ+NEw ($1061.15 in chips)
Seat 3: y2ASmcO4UW2SjtgwgDba1Q ($2534 in chips)
Seat 6: BbirlZJeYiPjSFVvLtEDVw ($1107 in chips)
y2ASmcO4UW2SjtgwgDba1Q: posts small blind $5
qo/pEPLw1ud1Ab0Q/dMfBQ: is sitting out
BbirlZJeYiPjSFVvLtEDVw: posts big blind $10
*** HOLE CARDS ***
4PqZA4LBAl9vQHtZEXba8A: folds
Eg/lVWW82x/d4qDjaZ+NEw: folds
qo/pEPLw1ud1Ab0Q/dMfBQ leaves the table
y2ASmcO4UW2SjtgwgDba1Q: folds
BbirlZJeYiPjSFVvLtEDVw collected $10 from pot
BbirlZJeYiPjSFVvLtEDVw: doesn't show hand
*** SUMMARY ***
Total pot $10 | Rake $0
Seat 1: 4PqZA4LBAl9vQHtZEXba8A folded before Flop (didn't bet)
Seat 2: Eg/lVWW82x/d4qDjaZ+NEw (button) folded before Flop (didn't bet)
Seat 3: y2ASmcO4UW2SjtgwgDba1Q (small blind) folded before Flop
Seat 6: BbirlZJeYiPjSFVvLtEDVw (big blind) collected ($10)



PokerStars Game #59950713820:  Hold'em No Limit ($5/$10) - 2009/07/01 6:59:17 ET
Table 'i93c3z9RLowvuJTKA2F4Jg' 6-max Seat #3 is the button
Seat 1: 4PqZA4LBAl9vQHtZEXba8A ($818.60 in chips)
Seat 2: Eg/lVWW82x/d4qDjaZ+NEw ($1061.15 in chips)
Seat 3: y2ASmcO4UW2SjtgwgDba1Q ($2529 in chips)
Seat 6: BbirlZJeYiPjSFVvLtEDVw ($1112 in chips)
BbirlZJeYiPjSFVvLtEDVw: posts small blind $5
4PqZA4LBAl9vQHtZEXba8A: posts big blind $10
*** HOLE CARDS ***
Eg/lVWW82x/d4qDjaZ+NEw: folds
jkH6qYMpn8JA/IyBOhQPMw joins the table at seat #5
y2ASmcO4UW2SjtgwgDba1Q: raises $20 to $30
BbirlZJeYiPjSFVvLtEDVw: folds
4PqZA4LBAl9vQHtZEXba8A: folds
y2ASmcO4UW2SjtgwgDba1Q collected $25 from pot
*** SUMMARY ***
Total pot $25 | Rake $0
Seat 1: 4PqZA4LBAl9vQHtZEXba8A (big blind) folded before Flop
Seat 2: Eg/lVWW82x/d4qDjaZ+NEw folded before Flop (didn't bet)
Seat 3: y2ASmcO4UW2SjtgwgDba1Q (button) collected ($25)
Seat 6: BbirlZJeYiPjSFVvLtEDVw (small blind) folded before Flop



PokerStars Game #59950714918:  Hold'em No Limit ($5/$10) - 2009/07/01 6:59:19 ET
Table 'ZemUU8uyOTYQAgqnaWQDUA' 6-max Seat #3 is the button
Seat 2: NczJqEIUdrpEc5Nbd7h1Ig ($533.50 in chips)
Seat 3: M6ck0CntRJiM0JZjUketMw ($790.50 in chips)
Seat 4: M5+Fo1NDPI9ulpVSsqNsNw ($334.10 in chips)
Seat 5: 33XJu1CVnl9YOngoPIhi0A ($829.45 in chips)
Seat 6: 3mTlg4g0FJN2bo939h/0Wg ($200 in chips)
M5+Fo1NDPI9ulpVSsqNsNw: posts small blind $5
33XJu1CVnl9YOngoPIhi0A: posts big blind $10
ObR8mkxB7pPf0NUAtp9riQ: sits out
*** HOLE CARDS ***
3mTlg4g0FJN2bo939h/0Wg: folds
NczJqEIUdrpEc5Nbd7h1Ig: folds
M6ck0CntRJiM0JZjUketMw: calls $10
M5+Fo1NDPI9ulpVSsqNsNw: calls $5
33XJu1CVnl9YOngoPIhi0A: checks
*** FLOP *** [4h Kd 4s]
M5+Fo1NDPI9ulpVSsqNsNw: bets $14
33XJu1CVnl9YOngoPIhi0A: calls $14
M6ck0CntRJiM0JZjUketMw: folds
*** TURN *** [4h Kd 4s] [Kc]
M5+Fo1NDPI9ulpVSsqNsNw: checks
33XJu1CVnl9YOngoPIhi0A: checks
*** RIVER *** [4h Kd 4s Kc] [3s]
M5+Fo1NDPI9ulpVSsqNsNw: checks
33XJu1CVnl9YOngoPIhi0A: bets $20
M5+Fo1NDPI9ulpVSsqNsNw: folds
33XJu1CVnl9YOngoPIhi0A collected $56 from pot
33XJu1CVnl9YOngoPIhi0A: doesn't show hand
*** SUMMARY ***
Total pot $58 | Rake $2
Board [4h Kd 4s Kc 3s]
Seat 2: NczJqEIUdrpEc5Nbd7h1Ig folded before Flop (didn't bet)
Seat 3: M6ck0CntRJiM0JZjUketMw (button) folded on the Flop
Seat 4: M5+Fo1NDPI9ulpVSsqNsNw (small blind) folded on the River
Seat 5: 33XJu1CVnl9YOngoPIhi0A (big blind) collected ($56)
Seat 6: 3mTlg4g0FJN2bo939h/0Wg folded before Flop (didn't bet)



PokerStars Game #59950715934:  Hold'em No Limit ($5/$10) - 2009/07/01 6:59:21 ET
Table 't/kPJqOCKfHg56cSPeLt+g' 2-max Seat #1 is the button
Seat 1: ZX/GGiaYlXYG8RuKIPpO+g ($847.75 in chips)
Seat 2: CUZXo12vZtpPjXlHjnWQmA ($1641.50 in chips)
ZX/GGiaYlXYG8RuKIPpO+g: posts small blind $5
CUZXo12vZtpPjXlHjnWQmA: posts big blind $10
*** HOLE CARDS ***
ZX/GGiaYlXYG8RuKIPpO+g: folds
CUZXo12vZtpPjXlHjnWQmA collected $10 from pot
CUZXo12vZtpPjXlHjnWQmA: doesn't show hand
*** SUMMARY ***
Total pot $10 | Rake $0
Seat 1: ZX/GGiaYlXYG8RuKIPpO+g (button) (small blind) folded before Flop
Seat 2: CUZXo12vZtpPjXlHjnWQmA (big blind) collected ($10)



PokerStars Game #59950718950:  Hold'em No Limit ($5/$10) - 2009/07/01 6:59:27 ET
Table 't/kPJqOCKfHg56cSPeLt+g' 2-max Seat #2 is the button
Seat 1: ZX/GGiaYlXYG8RuKIPpO+g ($842.75 in chips)
Seat 2: CUZXo12vZtpPjXlHjnWQmA ($1646.50 in chips)
CUZXo12vZtpPjXlHjnWQmA: posts small blind $5
ZX/GGiaYlXYG8RuKIPpO+g: posts big blind $10
*** HOLE CARDS ***
CUZXo12vZtpPjXlHjnWQmA: folds
ZX/GGiaYlXYG8RuKIPpO+g collected $10 from pot
ZX/GGiaYlXYG8RuKIPpO+g: doesn't show hand
*** SUMMARY ***
Total pot $10 | Rake $0
Seat 1: ZX/GGiaYlXYG8RuKIPpO+g (big blind) collected ($10)
Seat 2: CUZXo12vZtpPjXlHjnWQmA (button) (small blind) folded before Flop



PokerStars Game #59950721780:  Hold'em No Limit ($5/$10) - 2009/07/01 6:59:32 ET
Table 't/kPJqOCKfHg56cSPeLt+g' 2-max Seat #1 is the button
Seat 1: ZX/GGiaYlXYG8RuKIPpO+g ($847.75 in chips)
Seat 2: CUZXo12vZtpPjXlHjnWQmA ($1641.50 in chips)
ZX/GGiaYlXYG8RuKIPpO+g: posts small blind $5
CUZXo12vZtpPjXlHjnWQmA: posts big blind $10
*** HOLE CARDS ***
ZX/GGiaYlXYG8RuKIPpO+g: raises $20 to $30
CUZXo12vZtpPjXlHjnWQmA: folds
ZX/GGiaYlXYG8RuKIPpO+g collected $20 from pot
ZX/GGiaYlXYG8RuKIPpO+g: doesn't show hand
*** SUMMARY ***
Total pot $20 | Rake $0
Seat 1: ZX/GGiaYlXYG8RuKIPpO+g (button) (small blind) collected ($20)
Seat 2: CUZXo12vZtpPjXlHjnWQmA (big blind) folded before Flop



PokerStars Game #59950722132:  Hold'em No Limit ($5/$10) - 2009/07/01 6:59:33 ET
Table 'i93c3z9RLowvuJTKA2F4Jg' 6-max Seat #6 is the button
Seat 1: 4PqZA4LBAl9vQHtZEXba8A ($808.60 in chips)
Seat 2: Eg/lVWW82x/d4qDjaZ+NEw ($1061.15 in chips)
Seat 3: y2ASmcO4UW2SjtgwgDba1Q ($2544 in chips)
Seat 6: BbirlZJeYiPjSFVvLtEDVw ($1107 in chips)
4PqZA4LBAl9vQHtZEXba8A: posts small blind $5
Eg/lVWW82x/d4qDjaZ+NEw: posts big blind $10
jkH6qYMpn8JA/IyBOhQPMw: sits out
*** HOLE CARDS ***
y2ASmcO4UW2SjtgwgDba1Q: raises $20 to $30
BbirlZJeYiPjSFVvLtEDVw: folds
4PqZA4LBAl9vQHtZEXba8A: folds
Eg/lVWW82x/d4qDjaZ+NEw: folds
y2ASmcO4UW2SjtgwgDba1Q collected $25 from pot
*** SUMMARY ***
Total pot $25 | Rake $0
Seat 1: 4PqZA4LBAl9vQHtZEXba8A (small blind) folded before Flop
Seat 2: Eg/lVWW82x/d4qDjaZ+NEw (big blind) folded before Flop
Seat 3: y2ASmcO4UW2SjtgwgDba1Q collected ($25)
Seat 6: BbirlZJeYiPjSFVvLtEDVw (button) folded before Flop (didn't bet)



PokerStars Game #59950725746:  Hold'em No Limit ($5/$10) - 2009/07/01 6:59:39 ET
Table 't/kPJqOCKfHg56cSPeLt+g' 2-max Seat #2 is the button
Seat 1: ZX/GGiaYlXYG8RuKIPpO+g ($857.75 in chips)
Seat 2: CUZXo12vZtpPjXlHjnWQmA ($1631.50 in chips)
CUZXo12vZtpPjXlHjnWQmA: posts small blind $5
ZX/GGiaYlXYG8RuKIPpO+g: posts big blind $10
*** HOLE CARDS ***
CUZXo12vZtpPjXlHjnWQmA: raises $20 to $30
ZX/GGiaYlXYG8RuKIPpO+g: folds
CUZXo12vZtpPjXlHjnWQmA collected $20 from pot
CUZXo12vZtpPjXlHjnWQmA: doesn't show hand
*** SUMMARY ***
Total pot $20 | Rake $0
Seat 1: ZX/GGiaYlXYG8RuKIPpO+g (big blind) folded before Flop
Seat 2: CUZXo12vZtpPjXlHjnWQmA (button) (small blind) collected ($20)



PokerStars Game #59950730024:  Hold'em No Limit ($5/$10) - 2009/07/01 6:59:47 ET
Table 't/kPJqOCKfHg56cSPeLt+g' 2-max Seat #1 is the button
Seat 1: ZX/GGiaYlXYG8RuKIPpO+g ($847.75 in chips)
Seat 2: CUZXo12vZtpPjXlHjnWQmA ($1641.50 in chips)
ZX/GGiaYlXYG8RuKIPpO+g: posts small blind $5
CUZXo12vZtpPjXlHjnWQmA: posts big blind $10
*** HOLE CARDS ***
ZX/GGiaYlXYG8RuKIPpO+g: folds
CUZXo12vZtpPjXlHjnWQmA collected $10 from pot
CUZXo12vZtpPjXlHjnWQmA: doesn't show hand
*** SUMMARY ***
Total pot $10 | Rake $0
Seat 1: ZX/GGiaYlXYG8RuKIPpO+g (button) (small blind) folded before Flop
Seat 2: CUZXo12vZtpPjXlHjnWQmA (big blind) collected ($10)



PokerStars Game #59950733250:  Hold'em No Limit ($5/$10) - 2009/07/01 6:59:53 ET
Table 't/kPJqOCKfHg56cSPeLt+g' 2-max Seat #2 is the button
Seat 1: ZX/GGiaYlXYG8RuKIPpO+g ($842.75 in chips)
Seat 2: CUZXo12vZtpPjXlHjnWQmA ($1646.50 in chips)
CUZXo12vZtpPjXlHjnWQmA: posts small blind $5
ZX/GGiaYlXYG8RuKIPpO+g: posts big blind $10
*** HOLE CARDS ***
CUZXo12vZtpPjXlHjnWQmA: raises $20 to $30
ZX/GGiaYlXYG8RuKIPpO+g: folds
CUZXo12vZtpPjXlHjnWQmA collected $20 from pot
CUZXo12vZtpPjXlHjnWQmA: doesn't show hand
*** SUMMARY ***
Total pot $20 | Rake $0
Seat 1: ZX/GGiaYlXYG8RuKIPpO+g (big blind) folded before Flop
Seat 2: CUZXo12vZtpPjXlHjnWQmA (button) (small blind) collected ($20)



PokerStars Game #59950737498:  Hold'em No Limit ($5/$10) - 2009/07/01 7:00:00 ET
Table 't/kPJqOCKfHg56cSPeLt+g' 2-max Seat #1 is the button
Seat 1: ZX/GGiaYlXYG8RuKIPpO+g ($832.75 in chips)
Seat 2: CUZXo12vZtpPjXlHjnWQmA ($1656.50 in chips)
ZX/GGiaYlXYG8RuKIPpO+g: posts small blind $5
CUZXo12vZtpPjXlHjnWQmA: posts big blind $10
*** HOLE CARDS ***
ZX/GGiaYlXYG8RuKIPpO+g: folds
CUZXo12vZtpPjXlHjnWQmA collected $10 from pot
CUZXo12vZtpPjXlHjnWQmA: doesn't show hand
*** SUMMARY ***
Total pot $10 | Rake $0
Seat 1: ZX/GGiaYlXYG8RuKIPpO+g (button) (small blind) folded before Flop
Seat 2: CUZXo12vZtpPjXlHjnWQmA (big blind) collected ($10)



PokerStars Game #59950741074:  Hold'em No Limit ($5/$10) - 2009/07/01 7:00:05 ET
Table 't/kPJqOCKfHg56cSPeLt+g' 2-max Seat #2 is the button
Seat 1: ZX/GGiaYlXYG8RuKIPpO+g ($827.75 in chips)
Seat 2: CUZXo12vZtpPjXlHjnWQmA ($1661.50 in chips)
CUZXo12vZtpPjXlHjnWQmA: posts small blind $5
ZX/GGiaYlXYG8RuKIPpO+g: posts big blind $10
*** HOLE CARDS ***
CUZXo12vZtpPjXlHjnWQmA: folds
ZX/GGiaYlXYG8RuKIPpO+g collected $10 from pot
ZX/GGiaYlXYG8RuKIPpO+g: doesn't show hand
*** SUMMARY ***
Total pot $10 | Rake $0
Seat 1: ZX/GGiaYlXYG8RuKIPpO+g (big blind) collected ($10)
Seat 2: CUZXo12vZtpPjXlHjnWQmA (button) (small blind) folded before Flop



PokerStars Game #59950743982:  Hold'em No Limit ($5/$10) - 2009/07/01 7:00:11 ET
Table 't/kPJqOCKfHg56cSPeLt+g' 2-max Seat #1 is the button
Seat 1: ZX/GGiaYlXYG8RuKIPpO+g ($832.75 in chips)
Seat 2: CUZXo12vZtpPjXlHjnWQmA ($1656.50 in chips)
ZX/GGiaYlXYG8RuKIPpO+g: posts small blind $5
CUZXo12vZtpPjXlHjnWQmA: posts big blind $10
*** HOLE CARDS ***
ZX/GGiaYlXYG8RuKIPpO+g: folds
CUZXo12vZtpPjXlHjnWQmA collected $10 from pot
CUZXo12vZtpPjXlHjnWQmA: doesn't show hand
*** SUMMARY ***
Total pot $10 | Rake $0
Seat 1: ZX/GGiaYlXYG8RuKIPpO+g (button) (small blind) folded before Flop
Seat 2: CUZXo12vZtpPjXlHjnWQmA (big blind) collected ($10)



PokerStars Game #59951059418:  Hold'em No Limit ($5/$10) - 2009/07/01 7:09:34 ET
Table 'NFJh+AzKdasb2Y7/Ui01MQ' 2-max Seat #2 is the button
Seat 1: mwvDbWZMnp9+VWlolJrlQA ($877 in chips)
Seat 2: rvkDAHjDOHaE52xJfnHyvg ($1000 in chips)
rvkDAHjDOHaE52xJfnHyvg: posts small blind $5
mwvDbWZMnp9+VWlolJrlQA: posts big blind $10
*** HOLE CARDS ***
rvkDAHjDOHaE52xJfnHyvg: raises $20 to $30
mwvDbWZMnp9+VWlolJrlQA: calls $20
*** FLOP *** [5c Ts Jh]
mwvDbWZMnp9+VWlolJrlQA: checks
rvkDAHjDOHaE52xJfnHyvg: bets $40
mwvDbWZMnp9+VWlolJrlQA: calls $40
*** TURN *** [5c Ts Jh] [Tc]
mwvDbWZMnp9+VWlolJrlQA: checks
rvkDAHjDOHaE52xJfnHyvg: checks
*** RIVER *** [5c Ts Jh Tc] [4s]
mwvDbWZMnp9+VWlolJrlQA: checks
rvkDAHjDOHaE52xJfnHyvg: checks
*** SHOW DOWN ***
mwvDbWZMnp9+VWlolJrlQA: shows [Qs Jc] (two pair, Jacks and Tens)
rvkDAHjDOHaE52xJfnHyvg: mucks hand
mwvDbWZMnp9+VWlolJrlQA collected $139.50 from pot
mwvDbWZMnp9+VWlolJrlQA is sitting out
*** SUMMARY ***
Total pot $140 | Rake $0.50
Board [5c Ts Jh Tc 4s]
Seat 1: mwvDbWZMnp9+VWlolJrlQA (big blind) showed [Qs Jc] and won ($139.50) with two pair, Jacks and Tens
Seat 2: rvkDAHjDOHaE52xJfnHyvg (button) (small blind) mucked



PokerStars Game #59951101956:  Hold'em No Limit ($5/$10) - 2009/07/01 7:10:49 ET
Table 'mAacPTyMuJ4IQhEFOonFPg' 2-max Seat #2 is the button
Seat 1: XFruyoQqeueL4N+qXEkusw ($1000 in chips)
Seat 2: /PJtv6f9a3oYpITt+tSTLQ ($999 in chips)
/PJtv6f9a3oYpITt+tSTLQ: posts small blind $5
XFruyoQqeueL4N+qXEkusw: posts big blind $10
*** HOLE CARDS ***
/PJtv6f9a3oYpITt+tSTLQ: raises $15 to $25
XFruyoQqeueL4N+qXEkusw has timed out
XFruyoQqeueL4N+qXEkusw: folds
XFruyoQqeueL4N+qXEkusw is sitting out
/PJtv6f9a3oYpITt+tSTLQ collected $20 from pot
*** SUMMARY ***
Total pot $20 | Rake $0
Seat 1: XFruyoQqeueL4N+qXEkusw (big blind) folded before Flop
Seat 2: /PJtv6f9a3oYpITt+tSTLQ (button) (small blind) collected ($20)



PokerStars Game #59951529120:  Hold'em No Limit ($5/$10) - 2009/07/01 7:23:18 ET
Table 'vjzKoIBF5FqU9W3OSXU85g' 6-max Seat #6 is the button
Seat 1: 83N3uOHZXXb6QNQOaBGOww ($1000 in chips)
Seat 2: 1ScqYmNf7/uWx1XSBgPTBw ($200 in chips)
Seat 3: e7PupvaIASKltHFJTx+bcQ ($453 in chips)
Seat 4: jkH6qYMpn8JA/IyBOhQPMw ($1030 in chips)
Seat 5: BbirlZJeYiPjSFVvLtEDVw ($1487 in chips)
Seat 6: 3mTlg4g0FJN2bo939h/0Wg ($245 in chips)
83N3uOHZXXb6QNQOaBGOww: posts small blind $5
1ScqYmNf7/uWx1XSBgPTBw: posts big blind $10
*** HOLE CARDS ***
e7PupvaIASKltHFJTx+bcQ: folds
jkH6qYMpn8JA/IyBOhQPMw: folds
BbirlZJeYiPjSFVvLtEDVw: raises $20 to $30
3mTlg4g0FJN2bo939h/0Wg: folds
83N3uOHZXXb6QNQOaBGOww: folds
1ScqYmNf7/uWx1XSBgPTBw: raises $170 to $200 and is all-in
BbirlZJeYiPjSFVvLtEDVw: calls $170
*** FLOP *** [Qd Ks 9h]
*** TURN *** [Qd Ks 9h] [Js]
*** RIVER *** [Qd Ks 9h Js] [3s]
*** SHOW DOWN ***
1ScqYmNf7/uWx1XSBgPTBw: shows [Ac Kd] (a pair of Kings)
BbirlZJeYiPjSFVvLtEDVw: shows [Tc Ah] (a straight, Ten to Ace)
BbirlZJeYiPjSFVvLtEDVw collected $402 from pot
*** SUMMARY ***
Total pot $405 | Rake $3
Board [Qd Ks 9h Js 3s]
Seat 1: 83N3uOHZXXb6QNQOaBGOww (small blind) folded before Flop
Seat 2: 1ScqYmNf7/uWx1XSBgPTBw (big blind) showed [Ac Kd] and lost with a pair of Kings
Seat 3: e7PupvaIASKltHFJTx+bcQ folded before Flop (didn't bet)
Seat 4: jkH6qYMpn8JA/IyBOhQPMw folded before Flop (didn't bet)
Seat 5: BbirlZJeYiPjSFVvLtEDVw showed [Tc Ah] and won ($402) with a straight, Ten to Ace
Seat 6: 3mTlg4g0FJN2bo939h/0Wg (button) folded before Flop (didn't bet)



PokerStars Game #59951531634:  Hold'em No Limit ($5/$10) - 2009/07/01 7:23:22 ET
Table 'ZemUU8uyOTYQAgqnaWQDUA' 6-max Seat #6 is the button
Seat 1: ObR8mkxB7pPf0NUAtp9riQ ($1169 in chips)
Seat 2: 83N3uOHZXXb6QNQOaBGOww ($1000 in chips)
Seat 3: jkH6qYMpn8JA/IyBOhQPMw ($1199.50 in chips)
Seat 4: M5+Fo1NDPI9ulpVSsqNsNw ($1002.95 in chips)
Seat 5: 33XJu1CVnl9YOngoPIhi0A ($766.45 in chips)
Seat 6: 3mTlg4g0FJN2bo939h/0Wg ($170 in chips)
ObR8mkxB7pPf0NUAtp9riQ: posts small blind $5
83N3uOHZXXb6QNQOaBGOww: posts big blind $10
*** HOLE CARDS ***
jkH6qYMpn8JA/IyBOhQPMw: folds
M5+Fo1NDPI9ulpVSsqNsNw: raises $12 to $22
33XJu1CVnl9YOngoPIhi0A: folds
3mTlg4g0FJN2bo939h/0Wg: calls $22
ObR8mkxB7pPf0NUAtp9riQ: folds
83N3uOHZXXb6QNQOaBGOww: folds
*** FLOP *** [Jd 6c Jh]
M5+Fo1NDPI9ulpVSsqNsNw: bets $40
3mTlg4g0FJN2bo939h/0Wg: folds
M5+Fo1NDPI9ulpVSsqNsNw collected $56.05 from pot
M5+Fo1NDPI9ulpVSsqNsNw: doesn't show hand
*** SUMMARY ***
Total pot $59 | Rake $2.95
Board [Jd 6c Jh]
Seat 1: ObR8mkxB7pPf0NUAtp9riQ (small blind) folded before Flop
Seat 2: 83N3uOHZXXb6QNQOaBGOww (big blind) folded before Flop
Seat 3: jkH6qYMpn8JA/IyBOhQPMw folded before Flop (didn't bet)
Seat 4: M5+Fo1NDPI9ulpVSsqNsNw collected ($56.05)
Seat 5: 33XJu1CVnl9YOngoPIhi0A folded before Flop (didn't bet)
Seat 6: 3mTlg4g0FJN2bo939h/0Wg (button) folded on the Flop



PokerStars Game #59951555674:  Hold'em No Limit ($5/$10) - 2009/07/01 7:24:04 ET
Table 'vjzKoIBF5FqU9W3OSXU85g' 6-max Seat #1 is the button
Seat 1: 83N3uOHZXXb6QNQOaBGOww ($1000 in chips)
Seat 2: 1ScqYmNf7/uWx1XSBgPTBw ($200 in chips)
Seat 3: e7PupvaIASKltHFJTx+bcQ ($453 in chips)
Seat 4: jkH6qYMpn8JA/IyBOhQPMw ($1030 in chips)
Seat 5: BbirlZJeYiPjSFVvLtEDVw ($1689 in chips)
Seat 6: 3mTlg4g0FJN2bo939h/0Wg ($245 in chips)
1ScqYmNf7/uWx1XSBgPTBw: posts small blind $5
e7PupvaIASKltHFJTx+bcQ: posts big blind $10
*** HOLE CARDS ***
jkH6qYMpn8JA/IyBOhQPMw: raises $20 to $30
BbirlZJeYiPjSFVvLtEDVw: folds
3mTlg4g0FJN2bo939h/0Wg: folds
83N3uOHZXXb6QNQOaBGOww: calls $30
1ScqYmNf7/uWx1XSBgPTBw: folds
e7PupvaIASKltHFJTx+bcQ: calls $20
*** FLOP *** [6d 6h 3c]
e7PupvaIASKltHFJTx+bcQ: checks
jkH6qYMpn8JA/IyBOhQPMw: checks
83N3uOHZXXb6QNQOaBGOww: checks
*** TURN *** [6d 6h 3c] [Jd]
e7PupvaIASKltHFJTx+bcQ: bets $20
jkH6qYMpn8JA/IyBOhQPMw: folds
83N3uOHZXXb6QNQOaBGOww: calls $20
*** RIVER *** [6d 6h 3c Jd] [6s]
e7PupvaIASKltHFJTx+bcQ: bets $120
83N3uOHZXXb6QNQOaBGOww: folds
e7PupvaIASKltHFJTx+bcQ collected $132 from pot
*** SUMMARY ***
Total pot $135 | Rake $3
Board [6d 6h 3c Jd 6s]
Seat 1: 83N3uOHZXXb6QNQOaBGOww (button) folded on the River
Seat 2: 1ScqYmNf7/uWx1XSBgPTBw (small blind) folded before Flop
Seat 3: e7PupvaIASKltHFJTx+bcQ (big blind) collected ($132)
Seat 4: jkH6qYMpn8JA/IyBOhQPMw folded on the Turn
Seat 5: BbirlZJeYiPjSFVvLtEDVw folded before Flop (didn't bet)
Seat 6: 3mTlg4g0FJN2bo939h/0Wg folded before Flop (didn't bet)



PokerStars Game #59951561384:  Hold'em No Limit ($5/$10) - 2009/07/01 7:24:13 ET
Table 'S53kfSbNcK1y2IhnKFrs4g' 6-max Seat #6 is the button
Seat 1: OFn0bkUWc4Uwkd8WCRgD+w ($1226 in chips)
Seat 2: 3mTlg4g0FJN2bo939h/0Wg ($263 in chips)
Seat 3: BbirlZJeYiPjSFVvLtEDVw ($1345.20 in chips)
Seat 4: jkH6qYMpn8JA/IyBOhQPMw ($1787 in chips)
Seat 5: n3h6CD5lzlIEFAqnZ5vkzg ($1206.50 in chips)
Seat 6: 83N3uOHZXXb6QNQOaBGOww ($1468 in chips)
OFn0bkUWc4Uwkd8WCRgD+w: posts small blind $5
3mTlg4g0FJN2bo939h/0Wg: posts big blind $10
*** HOLE CARDS ***
BbirlZJeYiPjSFVvLtEDVw: folds
jkH6qYMpn8JA/IyBOhQPMw: folds
n3h6CD5lzlIEFAqnZ5vkzg: raises $20 to $30
83N3uOHZXXb6QNQOaBGOww: folds
OFn0bkUWc4Uwkd8WCRgD+w: folds
3mTlg4g0FJN2bo939h/0Wg: calls $20
*** FLOP *** [2s 7s 9h]
3mTlg4g0FJN2bo939h/0Wg: bets $30
n3h6CD5lzlIEFAqnZ5vkzg: calls $30
*** TURN *** [2s 7s 9h] [Qs]
3mTlg4g0FJN2bo939h/0Wg: checks
n3h6CD5lzlIEFAqnZ5vkzg: bets $60
3mTlg4g0FJN2bo939h/0Wg: folds
n3h6CD5lzlIEFAqnZ5vkzg collected $122 from pot
*** SUMMARY ***
Total pot $125 | Rake $3
Board [2s 7s 9h Qs]
Seat 1: OFn0bkUWc4Uwkd8WCRgD+w (small blind) folded before Flop
Seat 2: 3mTlg4g0FJN2bo939h/0Wg (big blind) folded on the Turn
Seat 3: BbirlZJeYiPjSFVvLtEDVw folded before Flop (didn't bet)
Seat 4: jkH6qYMpn8JA/IyBOhQPMw folded before Flop (didn't bet)
Seat 5: n3h6CD5lzlIEFAqnZ5vkzg collected ($122)
Seat 6: 83N3uOHZXXb6QNQOaBGOww (button) folded before Flop (didn't bet)



PokerStars Game #59951562978:  Hold'em No Limit ($5/$10) - 2009/07/01 7:24:16 ET
Table 'B7gQa8IrNZTRZX43XhFKUA' 6-max Seat #4 is the button
Seat 1: jkH6qYMpn8JA/IyBOhQPMw ($1000 in chips)
Seat 2: ObR8mkxB7pPf0NUAtp9riQ ($1015 in chips)
Seat 3: 1ScqYmNf7/uWx1XSBgPTBw ($215 in chips)
Seat 4: I1u3BrIcnPwCmkxtD03Q9A ($485 in chips)
Seat 5: BESARbstyvj3tWmTi4s3eg ($966 in chips)
Seat 6: 83N3uOHZXXb6QNQOaBGOww ($1038 in chips)
BESARbstyvj3tWmTi4s3eg: posts small blind $5
83N3uOHZXXb6QNQOaBGOww: posts big blind $10
*** HOLE CARDS ***
jkH6qYMpn8JA/IyBOhQPMw: raises $20 to $30
ObR8mkxB7pPf0NUAtp9riQ: folds
1ScqYmNf7/uWx1XSBgPTBw: folds
I1u3BrIcnPwCmkxtD03Q9A: folds
BESARbstyvj3tWmTi4s3eg: folds
83N3uOHZXXb6QNQOaBGOww: folds
jkH6qYMpn8JA/IyBOhQPMw collected $25 from pot
jkH6qYMpn8JA/IyBOhQPMw: doesn't show hand
*** SUMMARY ***
Total pot $25 | Rake $0
Seat 1: jkH6qYMpn8JA/IyBOhQPMw collected ($25)
Seat 2: ObR8mkxB7pPf0NUAtp9riQ folded before Flop (didn't bet)
Seat 3: 1ScqYmNf7/uWx1XSBgPTBw folded before Flop (didn't bet)
Seat 4: I1u3BrIcnPwCmkxtD03Q9A (button) folded before Flop (didn't bet)
Seat 5: BESARbstyvj3tWmTi4s3eg (small blind) folded before Flop
Seat 6: 83N3uOHZXXb6QNQOaBGOww (big blind) folded before Flop



PokerStars Game #59951566476:  Hold'em No Limit ($5/$10) - 2009/07/01 7:24:22 ET
Table 'ZemUU8uyOTYQAgqnaWQDUA' 6-max Seat #1 is the button
Seat 1: ObR8mkxB7pPf0NUAtp9riQ ($1164 in chips)
Seat 2: 83N3uOHZXXb6QNQOaBGOww ($1000 in chips)
Seat 3: jkH6qYMpn8JA/IyBOhQPMw ($1199.50 in chips)
Seat 4: M5+Fo1NDPI9ulpVSsqNsNw ($1037 in chips)
Seat 5: 33XJu1CVnl9YOngoPIhi0A ($766.45 in chips)
Seat 6: 3mTlg4g0FJN2bo939h/0Wg ($148 in chips)
83N3uOHZXXb6QNQOaBGOww: posts small blind $5
jkH6qYMpn8JA/IyBOhQPMw: posts big blind $10
*** HOLE CARDS ***
M5+Fo1NDPI9ulpVSsqNsNw: folds
33XJu1CVnl9YOngoPIhi0A: folds
3mTlg4g0FJN2bo939h/0Wg: raises $10 to $20
ObR8mkxB7pPf0NUAtp9riQ: raises $40 to $60
83N3uOHZXXb6QNQOaBGOww: folds
jkH6qYMpn8JA/IyBOhQPMw: folds
3mTlg4g0FJN2bo939h/0Wg: calls $40
*** FLOP *** [4h 5s 3s]
3mTlg4g0FJN2bo939h/0Wg: bets $30
ObR8mkxB7pPf0NUAtp9riQ: raises $530 to $560
3mTlg4g0FJN2bo939h/0Wg: calls $58 and is all-in
*** TURN *** [4h 5s 3s] [Ah]
*** RIVER *** [4h 5s 3s Ah] [2h]
*** SHOW DOWN ***
3mTlg4g0FJN2bo939h/0Wg: shows [6d Jd] (a straight, Deuce to Six)
ObR8mkxB7pPf0NUAtp9riQ: mucks hand
3mTlg4g0FJN2bo939h/0Wg collected $308 from pot
*** SUMMARY ***
Total pot $311 | Rake $3
Board [4h 5s 3s Ah 2h]
Seat 1: ObR8mkxB7pPf0NUAtp9riQ (button) mucked
Seat 2: 83N3uOHZXXb6QNQOaBGOww (small blind) folded before Flop
Seat 3: jkH6qYMpn8JA/IyBOhQPMw (big blind) folded before Flop
Seat 4: M5+Fo1NDPI9ulpVSsqNsNw folded before Flop (didn't bet)
Seat 5: 33XJu1CVnl9YOngoPIhi0A folded before Flop (didn't bet)
Seat 6: 3mTlg4g0FJN2bo939h/0Wg showed [6d Jd] and won ($308) with a straight, Deuce to Six



PokerStars Game #59951588810:  Hold'em No Limit ($5/$10) - 2009/07/01 7:25:00 ET
Table 'B7gQa8IrNZTRZX43XhFKUA' 6-max Seat #5 is the button
Seat 1: jkH6qYMpn8JA/IyBOhQPMw ($1015 in chips)
Seat 2: ObR8mkxB7pPf0NUAtp9riQ ($1015 in chips)
Seat 3: 1ScqYmNf7/uWx1XSBgPTBw ($215 in chips)
Seat 4: I1u3BrIcnPwCmkxtD03Q9A ($485 in chips)
Seat 5: BESARbstyvj3tWmTi4s3eg ($961 in chips)
Seat 6: 83N3uOHZXXb6QNQOaBGOww ($1028 in chips)
83N3uOHZXXb6QNQOaBGOww: posts small blind $5
jkH6qYMpn8JA/IyBOhQPMw: posts big blind $10
*** HOLE CARDS ***
ObR8mkxB7pPf0NUAtp9riQ: raises $20 to $30
1ScqYmNf7/uWx1XSBgPTBw: folds
I1u3BrIcnPwCmkxtD03Q9A: folds
BESARbstyvj3tWmTi4s3eg: calls $30
83N3uOHZXXb6QNQOaBGOww: folds
jkH6qYMpn8JA/IyBOhQPMw: folds
*** FLOP *** [Qh 5s 9c]
ObR8mkxB7pPf0NUAtp9riQ: bets $50
BESARbstyvj3tWmTi4s3eg: raises $80 to $130
ObR8mkxB7pPf0NUAtp9riQ: calls $80
*** TURN *** [Qh 5s 9c] [8c]
ObR8mkxB7pPf0NUAtp9riQ: checks
BESARbstyvj3tWmTi4s3eg: checks
*** RIVER *** [Qh 5s 9c 8c] [3c]
ObR8mkxB7pPf0NUAtp9riQ: bets $180
BESARbstyvj3tWmTi4s3eg: folds
ObR8mkxB7pPf0NUAtp9riQ collected $332 from pot
ObR8mkxB7pPf0NUAtp9riQ: doesn't show hand
*** SUMMARY ***
Total pot $335 | Rake $3
Board [Qh 5s 9c 8c 3c]
Seat 1: jkH6qYMpn8JA/IyBOhQPMw (big blind) folded before Flop
Seat 2: ObR8mkxB7pPf0NUAtp9riQ collected ($332)
Seat 3: 1ScqYmNf7/uWx1XSBgPTBw folded before Flop (didn't bet)
Seat 4: I1u3BrIcnPwCmkxtD03Q9A folded before Flop (didn't bet)
Seat 5: BESARbstyvj3tWmTi4s3eg (button) folded on the River
Seat 6: 83N3uOHZXXb6QNQOaBGOww (small blind) folded before Flop



PokerStars Game #59951593548:  Hold'em No Limit ($5/$10) - 2009/07/01 7:25:08 ET
Table 'vjzKoIBF5FqU9W3OSXU85g' 6-max Seat #2 is the button
Seat 1: 83N3uOHZXXb6QNQOaBGOww ($1000 in chips)
Seat 2: 1ScqYmNf7/uWx1XSBgPTBw ($195 in chips)
Seat 3: e7PupvaIASKltHFJTx+bcQ ($535 in chips)
Seat 4: jkH6qYMpn8JA/IyBOhQPMw ($1000 in chips)
Seat 5: BbirlZJeYiPjSFVvLtEDVw ($1689 in chips)
Seat 6: 3mTlg4g0FJN2bo939h/0Wg ($245 in chips)
e7PupvaIASKltHFJTx+bcQ: posts small blind $5
jkH6qYMpn8JA/IyBOhQPMw: posts big blind $10
*** HOLE CARDS ***
BbirlZJeYiPjSFVvLtEDVw: folds
3mTlg4g0FJN2bo939h/0Wg: folds
83N3uOHZXXb6QNQOaBGOww: folds
1ScqYmNf7/uWx1XSBgPTBw: folds
e7PupvaIASKltHFJTx+bcQ: raises $20 to $30
jkH6qYMpn8JA/IyBOhQPMw: folds
e7PupvaIASKltHFJTx+bcQ collected $20 from pot
*** SUMMARY ***
Total pot $20 | Rake $0
Seat 1: 83N3uOHZXXb6QNQOaBGOww folded before Flop (didn't bet)
Seat 2: 1ScqYmNf7/uWx1XSBgPTBw (button) folded before Flop (didn't bet)
Seat 3: e7PupvaIASKltHFJTx+bcQ (small blind) collected ($20)
Seat 4: jkH6qYMpn8JA/IyBOhQPMw (big blind) folded before Flop
Seat 5: BbirlZJeYiPjSFVvLtEDVw folded before Flop (didn't bet)
Seat 6: 3mTlg4g0FJN2bo939h/0Wg folded before Flop (didn't bet)



PokerStars Game #59951594636:  Hold'em No Limit ($5/$10) - 2009/07/01 7:25:10 ET
Table 'ZemUU8uyOTYQAgqnaWQDUA' 6-max Seat #2 is the button
Seat 1: ObR8mkxB7pPf0NUAtp9riQ ($1016 in chips)
Seat 2: 83N3uOHZXXb6QNQOaBGOww ($1000 in chips)
Seat 3: jkH6qYMpn8JA/IyBOhQPMw ($1189.50 in chips)
Seat 5: 33XJu1CVnl9YOngoPIhi0A ($766.45 in chips)
Seat 6: 3mTlg4g0FJN2bo939h/0Wg ($308 in chips)
jkH6qYMpn8JA/IyBOhQPMw: posts small blind $5
M5+Fo1NDPI9ulpVSsqNsNw: is sitting out
33XJu1CVnl9YOngoPIhi0A: posts big blind $10
*** HOLE CARDS ***
M5+Fo1NDPI9ulpVSsqNsNw has returned
3mTlg4g0FJN2bo939h/0Wg: raises $20 to $30
M5+Fo1NDPI9ulpVSsqNsNw leaves the table
n3h6CD5lzlIEFAqnZ5vkzg joins the table at seat #4
ObR8mkxB7pPf0NUAtp9riQ has timed out
ObR8mkxB7pPf0NUAtp9riQ: folds
ObR8mkxB7pPf0NUAtp9riQ is sitting out
83N3uOHZXXb6QNQOaBGOww: folds
ObR8mkxB7pPf0NUAtp9riQ has returned
jkH6qYMpn8JA/IyBOhQPMw: calls $25
33XJu1CVnl9YOngoPIhi0A: folds
*** FLOP *** [Qs Jd Js]
ObR8mkxB7pPf0NUAtp9riQ leaves the table
jkH6qYMpn8JA/IyBOhQPMw: checks
3mTlg4g0FJN2bo939h/0Wg: checks
*** TURN *** [Qs Jd Js] [5h]
jkH6qYMpn8JA/IyBOhQPMw: checks
3mTlg4g0FJN2bo939h/0Wg: checks
*** RIVER *** [Qs Jd Js 5h] [2h]
jkH6qYMpn8JA/IyBOhQPMw: checks
3mTlg4g0FJN2bo939h/0Wg: checks
*** SHOW DOWN ***
jkH6qYMpn8JA/IyBOhQPMw: shows [4d 4c] (two pair, Jacks and Fours)
3mTlg4g0FJN2bo939h/0Wg: mucks hand
jkH6qYMpn8JA/IyBOhQPMw collected $68 from pot
*** SUMMARY ***
Total pot $70 | Rake $2
Board [Qs Jd Js 5h 2h]
Seat 1: ObR8mkxB7pPf0NUAtp9riQ folded before Flop (didn't bet)
Seat 2: 83N3uOHZXXb6QNQOaBGOww (button) folded before Flop (didn't bet)
Seat 3: jkH6qYMpn8JA/IyBOhQPMw (small blind) showed [4d 4c] and won ($68) with two pair, Jacks and Fours
Seat 5: 33XJu1CVnl9YOngoPIhi0A (big blind) folded before Flop
Seat 6: 3mTlg4g0FJN2bo939h/0Wg mucked



PokerStars Game #59951596644:  Hold'em No Limit ($5/$10) - 2009/07/01 7:25:14 ET
Table 'S53kfSbNcK1y2IhnKFrs4g' 6-max Seat #1 is the button
Seat 1: OFn0bkUWc4Uwkd8WCRgD+w ($1221 in chips)
Seat 2: 3mTlg4g0FJN2bo939h/0Wg ($203 in chips)
Seat 4: jkH6qYMpn8JA/IyBOhQPMw ($1787 in chips)
Seat 5: n3h6CD5lzlIEFAqnZ5vkzg ($1268.50 in chips)
Seat 6: 83N3uOHZXXb6QNQOaBGOww ($1468 in chips)
3mTlg4g0FJN2bo939h/0Wg: posts small blind $5
BbirlZJeYiPjSFVvLtEDVw: is sitting out
jkH6qYMpn8JA/IyBOhQPMw: posts big blind $10
*** HOLE CARDS ***
BbirlZJeYiPjSFVvLtEDVw leaves the table
1ScqYmNf7/uWx1XSBgPTBw joins the table at seat #3
n3h6CD5lzlIEFAqnZ5vkzg: raises $20 to $30
83N3uOHZXXb6QNQOaBGOww: folds
OFn0bkUWc4Uwkd8WCRgD+w: folds
3mTlg4g0FJN2bo939h/0Wg: calls $25
jkH6qYMpn8JA/IyBOhQPMw: folds
*** FLOP *** [8c 9d Jc]
3mTlg4g0FJN2bo939h/0Wg: bets $30
n3h6CD5lzlIEFAqnZ5vkzg: folds
3mTlg4g0FJN2bo939h/0Wg collected $68 from pot
*** SUMMARY ***
Total pot $70 | Rake $2
Board [8c 9d Jc]
Seat 1: OFn0bkUWc4Uwkd8WCRgD+w (button) folded before Flop (didn't bet)
Seat 2: 3mTlg4g0FJN2bo939h/0Wg (small blind) collected ($68)
Seat 4: jkH6qYMpn8JA/IyBOhQPMw (big blind) folded before Flop
Seat 5: n3h6CD5lzlIEFAqnZ5vkzg folded on the Flop
Seat 6: 83N3uOHZXXb6QNQOaBGOww folded before Flop (didn't bet)



PokerStars Game #59951604760:  Hold'em No Limit ($5/$10) - 2009/07/01 7:25:28 ET
Table 'vjzKoIBF5FqU9W3OSXU85g' 6-max Seat #3 is the button
Seat 1: 83N3uOHZXXb6QNQOaBGOww ($1000 in chips)
Seat 2: 1ScqYmNf7/uWx1XSBgPTBw ($195 in chips)
Seat 3: e7PupvaIASKltHFJTx+bcQ ($545 in chips)
Seat 4: jkH6qYMpn8JA/IyBOhQPMw ($1000 in chips)
Seat 5: BbirlZJeYiPjSFVvLtEDVw ($1689 in chips)
Seat 6: 3mTlg4g0FJN2bo939h/0Wg ($245 in chips)
jkH6qYMpn8JA/IyBOhQPMw: posts small blind $5
BbirlZJeYiPjSFVvLtEDVw: posts big blind $10
*** HOLE CARDS ***
3mTlg4g0FJN2bo939h/0Wg: folds
83N3uOHZXXb6QNQOaBGOww: folds
1ScqYmNf7/uWx1XSBgPTBw: folds
e7PupvaIASKltHFJTx+bcQ: folds
jkH6qYMpn8JA/IyBOhQPMw: folds
BbirlZJeYiPjSFVvLtEDVw collected $10 from pot
*** SUMMARY ***
Total pot $10 | Rake $0
Seat 1: 83N3uOHZXXb6QNQOaBGOww folded before Flop (didn't bet)
Seat 2: 1ScqYmNf7/uWx1XSBgPTBw folded before Flop (didn't bet)
Seat 3: e7PupvaIASKltHFJTx+bcQ (button) folded before Flop (didn't bet)
Seat 4: jkH6qYMpn8JA/IyBOhQPMw (small blind) folded before Flop
Seat 5: BbirlZJeYiPjSFVvLtEDVw (big blind) collected ($10)
Seat 6: 3mTlg4g0FJN2bo939h/0Wg folded before Flop (didn't bet)



PokerStars Game #59951619734:  Hold'em No Limit ($5/$10) - 2009/07/01 7:25:53 ET
Table 'vjzKoIBF5FqU9W3OSXU85g' 6-max Seat #4 is the button
Seat 1: 83N3uOHZXXb6QNQOaBGOww ($1000 in chips)
Seat 2: 1ScqYmNf7/uWx1XSBgPTBw ($195 in chips)
Seat 3: e7PupvaIASKltHFJTx+bcQ ($545 in chips)
Seat 4: jkH6qYMpn8JA/IyBOhQPMw ($1000 in chips)
Seat 5: BbirlZJeYiPjSFVvLtEDVw ($1694 in chips)
Seat 6: 3mTlg4g0FJN2bo939h/0Wg ($245 in chips)
BbirlZJeYiPjSFVvLtEDVw: posts small blind $5
3mTlg4g0FJN2bo939h/0Wg: posts big blind $10
*** HOLE CARDS ***
83N3uOHZXXb6QNQOaBGOww: folds
1ScqYmNf7/uWx1XSBgPTBw: folds
e7PupvaIASKltHFJTx+bcQ: folds
jkH6qYMpn8JA/IyBOhQPMw: raises $20 to $30
BbirlZJeYiPjSFVvLtEDVw: folds
3mTlg4g0FJN2bo939h/0Wg: calls $20
*** FLOP *** [2h Th Js]
3mTlg4g0FJN2bo939h/0Wg: bets $30
jkH6qYMpn8JA/IyBOhQPMw: calls $30
*** TURN *** [2h Th Js] [4s]
3mTlg4g0FJN2bo939h/0Wg: bets $50
jkH6qYMpn8JA/IyBOhQPMw: raises $350 to $400
3mTlg4g0FJN2bo939h/0Wg: calls $135 and is all-in
*** RIVER *** [2h Th Js 4s] [2c]
*** SHOW DOWN ***
3mTlg4g0FJN2bo939h/0Wg: shows [9c Qs] (a pair of Deuces)
jkH6qYMpn8JA/IyBOhQPMw: shows [Td 8s] (two pair, Tens and Deuces)
jkH6qYMpn8JA/IyBOhQPMw collected $492 from pot
*** SUMMARY ***
Total pot $495 | Rake $3
Board [2h Th Js 4s 2c]
Seat 1: 83N3uOHZXXb6QNQOaBGOww folded before Flop (didn't bet)
Seat 2: 1ScqYmNf7/uWx1XSBgPTBw folded before Flop (didn't bet)
Seat 3: e7PupvaIASKltHFJTx+bcQ folded before Flop (didn't bet)
Seat 4: jkH6qYMpn8JA/IyBOhQPMw (button) showed [Td 8s] and won ($492) with two pair, Tens and Deuces
Seat 5: BbirlZJeYiPjSFVvLtEDVw (small blind) folded before Flop
Seat 6: 3mTlg4g0FJN2bo939h/0Wg (big blind) showed [9c Qs] and lost with a pair of Deuces



PokerStars Game #59951619880:  Hold'em No Limit ($5/$10) - 2009/07/01 7:25:53 ET
Table 'S53kfSbNcK1y2IhnKFrs4g' 6-max Seat #2 is the button
Seat 1: OFn0bkUWc4Uwkd8WCRgD+w ($1221 in chips)
Seat 2: 3mTlg4g0FJN2bo939h/0Wg ($241 in chips)
Seat 4: jkH6qYMpn8JA/IyBOhQPMw ($1777 in chips)
Seat 5: n3h6CD5lzlIEFAqnZ5vkzg ($1238.50 in chips)
Seat 6: 83N3uOHZXXb6QNQOaBGOww ($1468 in chips)
1ScqYmNf7/uWx1XSBgPTBw will be allowed to play after the button
jkH6qYMpn8JA/IyBOhQPMw: posts small blind $5
n3h6CD5lzlIEFAqnZ5vkzg: posts big blind $10
*** HOLE CARDS ***
83N3uOHZXXb6QNQOaBGOww: folds
OFn0bkUWc4Uwkd8WCRgD+w: raises $20 to $30
3mTlg4g0FJN2bo939h/0Wg: folds
jkH6qYMpn8JA/IyBOhQPMw: folds
n3h6CD5lzlIEFAqnZ5vkzg: calls $20
*** FLOP *** [4d 8s 4s]
n3h6CD5lzlIEFAqnZ5vkzg: bets $50
OFn0bkUWc4Uwkd8WCRgD+w: folds
OFn0bkUWc4Uwkd8WCRgD+w leaves the table
n3h6CD5lzlIEFAqnZ5vkzg collected $63 from pot
*** SUMMARY ***
Total pot $65 | Rake $2
Board [4d 8s 4s]
Seat 1: OFn0bkUWc4Uwkd8WCRgD+w folded on the Flop
Seat 2: 3mTlg4g0FJN2bo939h/0Wg (button) folded before Flop (didn't bet)
Seat 4: jkH6qYMpn8JA/IyBOhQPMw (small blind) folded before Flop
Seat 5: n3h6CD5lzlIEFAqnZ5vkzg (big blind) collected ($63)
Seat 6: 83N3uOHZXXb6QNQOaBGOww folded before Flop (didn't bet)



PokerStars Game #59951623866:  Hold'em No Limit ($5/$10) - 2009/07/01 7:26:00 ET
Table 'ZemUU8uyOTYQAgqnaWQDUA' 6-max Seat #3 is the button
Seat 2: 83N3uOHZXXb6QNQOaBGOww ($1000 in chips)
Seat 3: jkH6qYMpn8JA/IyBOhQPMw ($1227.50 in chips)
Seat 5: 33XJu1CVnl9YOngoPIhi0A ($756.45 in chips)
Seat 6: 3mTlg4g0FJN2bo939h/0Wg ($278 in chips)
n3h6CD5lzlIEFAqnZ5vkzg will be allowed to play after the button
33XJu1CVnl9YOngoPIhi0A: posts small blind $5
3mTlg4g0FJN2bo939h/0Wg: posts big blind $10
*** HOLE CARDS ***
83N3uOHZXXb6QNQOaBGOww: folds
jkH6qYMpn8JA/IyBOhQPMw: raises $20 to $30
33XJu1CVnl9YOngoPIhi0A: raises $70 to $100
3mTlg4g0FJN2bo939h/0Wg: folds
1ScqYmNf7/uWx1XSBgPTBw joins the table at seat #1
jkH6qYMpn8JA/IyBOhQPMw: folds
33XJu1CVnl9YOngoPIhi0A collected $70 from pot
33XJu1CVnl9YOngoPIhi0A: doesn't show hand
*** SUMMARY ***
Total pot $70 | Rake $0
Seat 2: 83N3uOHZXXb6QNQOaBGOww folded before Flop (didn't bet)
Seat 3: jkH6qYMpn8JA/IyBOhQPMw (button) folded before Flop
Seat 5: 33XJu1CVnl9YOngoPIhi0A (small blind) collected ($70)
Seat 6: 3mTlg4g0FJN2bo939h/0Wg (big blind) folded before Flop



PokerStars Game #59951635688:  Hold'em No Limit ($5/$10) - 2009/07/01 7:26:20 ET
Table 'ZemUU8uyOTYQAgqnaWQDUA' 6-max Seat #5 is the button
Seat 1: 1ScqYmNf7/uWx1XSBgPTBw ($200 in chips)
Seat 2: 83N3uOHZXXb6QNQOaBGOww ($1000 in chips)
Seat 3: jkH6qYMpn8JA/IyBOhQPMw ($1197.50 in chips)
Seat 5: 33XJu1CVnl9YOngoPIhi0A ($796.45 in chips)
Seat 6: 3mTlg4g0FJN2bo939h/0Wg ($268 in chips)
3mTlg4g0FJN2bo939h/0Wg: posts small blind $5
1ScqYmNf7/uWx1XSBgPTBw: posts big blind $10
n3h6CD5lzlIEFAqnZ5vkzg: sits out
*** HOLE CARDS ***
83N3uOHZXXb6QNQOaBGOww: folds
jkH6qYMpn8JA/IyBOhQPMw: raises $20 to $30
33XJu1CVnl9YOngoPIhi0A: folds
3mTlg4g0FJN2bo939h/0Wg: calls $25
1ScqYmNf7/uWx1XSBgPTBw: folds
*** FLOP *** [Qh Tc Ts]
3mTlg4g0FJN2bo939h/0Wg: bets $30
jkH6qYMpn8JA/IyBOhQPMw: calls $30
*** TURN *** [Qh Tc Ts] [5c]
3mTlg4g0FJN2bo939h/0Wg: checks
jkH6qYMpn8JA/IyBOhQPMw: checks
*** RIVER *** [Qh Tc Ts 5c] [6h]
3mTlg4g0FJN2bo939h/0Wg: bets $50
jkH6qYMpn8JA/IyBOhQPMw: calls $50
*** SHOW DOWN ***
3mTlg4g0FJN2bo939h/0Wg: shows [2c 2s] (two pair, Tens and Deuces)
jkH6qYMpn8JA/IyBOhQPMw: mucks hand
3mTlg4g0FJN2bo939h/0Wg collected $228 from pot
*** SUMMARY ***
Total pot $230 | Rake $2
Board [Qh Tc Ts 5c 6h]
Seat 1: 1ScqYmNf7/uWx1XSBgPTBw (big blind) folded before Flop
Seat 2: 83N3uOHZXXb6QNQOaBGOww folded before Flop (didn't bet)
Seat 3: jkH6qYMpn8JA/IyBOhQPMw mucked
Seat 5: 33XJu1CVnl9YOngoPIhi0A (button) folded before Flop (didn't bet)
Seat 6: 3mTlg4g0FJN2bo939h/0Wg (small blind) showed [2c 2s] and won ($228) with two pair, Tens and Deuces



PokerStars Game #59951640544:  Hold'em No Limit ($5/$10) - 2009/07/01 7:26:29 ET
Table 'S53kfSbNcK1y2IhnKFrs4g' 6-max Seat #4 is the button
Seat 2: 3mTlg4g0FJN2bo939h/0Wg ($241 in chips)
Seat 4: jkH6qYMpn8JA/IyBOhQPMw ($1772 in chips)
Seat 5: n3h6CD5lzlIEFAqnZ5vkzg ($1271.50 in chips)
Seat 6: 83N3uOHZXXb6QNQOaBGOww ($1468 in chips)
n3h6CD5lzlIEFAqnZ5vkzg: posts small blind $5
83N3uOHZXXb6QNQOaBGOww: posts big blind $10
1ScqYmNf7/uWx1XSBgPTBw: sits out
*** HOLE CARDS ***
3mTlg4g0FJN2bo939h/0Wg: folds
UC0/YZSO2sBe2bJGZ3gn+Q joins the table at seat #1
jkH6qYMpn8JA/IyBOhQPMw: raises $20 to $30
n3h6CD5lzlIEFAqnZ5vkzg: folds
83N3uOHZXXb6QNQOaBGOww: folds
jkH6qYMpn8JA/IyBOhQPMw collected $25 from pot
jkH6qYMpn8JA/IyBOhQPMw: doesn't show hand
*** SUMMARY ***
Total pot $25 | Rake $0
Seat 2: 3mTlg4g0FJN2bo939h/0Wg folded before Flop (didn't bet)
Seat 4: jkH6qYMpn8JA/IyBOhQPMw (button) collected ($25)
Seat 5: n3h6CD5lzlIEFAqnZ5vkzg (small blind) folded before Flop
Seat 6: 83N3uOHZXXb6QNQOaBGOww (big blind) folded before Flop



PokerStars Game #59951650826:  Hold'em No Limit ($5/$10) - 2009/07/01 7:26:46 ET
Table 'vjzKoIBF5FqU9W3OSXU85g' 6-max Seat #5 is the button
Seat 1: 83N3uOHZXXb6QNQOaBGOww ($1000 in chips)
Seat 2: 1ScqYmNf7/uWx1XSBgPTBw ($195 in chips)
Seat 3: e7PupvaIASKltHFJTx+bcQ ($545 in chips)
Seat 4: jkH6qYMpn8JA/IyBOhQPMw ($1247 in chips)
Seat 5: BbirlZJeYiPjSFVvLtEDVw ($1689 in chips)
83N3uOHZXXb6QNQOaBGOww: posts small blind $5
1ScqYmNf7/uWx1XSBgPTBw: posts big blind $10
*** HOLE CARDS ***
e7PupvaIASKltHFJTx+bcQ: raises $20 to $30
3mTlg4g0FJN2bo939h/0Wg has returned
jkH6qYMpn8JA/IyBOhQPMw: calls $30
BbirlZJeYiPjSFVvLtEDVw: folds
83N3uOHZXXb6QNQOaBGOww: calls $25
1ScqYmNf7/uWx1XSBgPTBw: calls $20
*** FLOP *** [3s Jd 6c]
83N3uOHZXXb6QNQOaBGOww: checks
1ScqYmNf7/uWx1XSBgPTBw: checks
e7PupvaIASKltHFJTx+bcQ: checks
jkH6qYMpn8JA/IyBOhQPMw: checks
*** TURN *** [3s Jd 6c] [Td]
83N3uOHZXXb6QNQOaBGOww: checks
1ScqYmNf7/uWx1XSBgPTBw: checks
e7PupvaIASKltHFJTx+bcQ: checks
jkH6qYMpn8JA/IyBOhQPMw: checks
*** RIVER *** [3s Jd 6c Td] [3h]
83N3uOHZXXb6QNQOaBGOww: checks
1ScqYmNf7/uWx1XSBgPTBw: checks
e7PupvaIASKltHFJTx+bcQ: checks
jkH6qYMpn8JA/IyBOhQPMw: checks
*** SHOW DOWN ***
83N3uOHZXXb6QNQOaBGOww: shows [As Qh] (a pair of Threes)
1ScqYmNf7/uWx1XSBgPTBw: shows [9c Th] (two pair, Tens and Threes)
e7PupvaIASKltHFJTx+bcQ: shows [Kc Tc] (two pair, Tens and Threes - King kicker)
jkH6qYMpn8JA/IyBOhQPMw: mucks hand
e7PupvaIASKltHFJTx+bcQ collected $118 from pot
*** SUMMARY ***
Total pot $120 | Rake $2
Board [3s Jd 6c Td 3h]
Seat 1: 83N3uOHZXXb6QNQOaBGOww (small blind) showed [As Qh] and lost with a pair of Threes
Seat 2: 1ScqYmNf7/uWx1XSBgPTBw (big blind) showed [9c Th] and lost with two pair, Tens and Threes
Seat 3: e7PupvaIASKltHFJTx+bcQ showed [Kc Tc] and won ($118) with two pair, Tens and Threes
Seat 4: jkH6qYMpn8JA/IyBOhQPMw mucked
Seat 5: BbirlZJeYiPjSFVvLtEDVw (button) folded before Flop (didn't bet)



PokerStars Game #59951651620:  Hold'em No Limit ($5/$10) - 2009/07/01 7:26:48 ET
Table 'S53kfSbNcK1y2IhnKFrs4g' 6-max Seat #5 is the button
Seat 1: UC0/YZSO2sBe2bJGZ3gn+Q ($1000 in chips)
Seat 2: 3mTlg4g0FJN2bo939h/0Wg ($241 in chips)
Seat 4: jkH6qYMpn8JA/IyBOhQPMw ($1787 in chips)
Seat 5: n3h6CD5lzlIEFAqnZ5vkzg ($1266.50 in chips)
Seat 6: 83N3uOHZXXb6QNQOaBGOww ($1458 in chips)
83N3uOHZXXb6QNQOaBGOww: posts small blind $5
UC0/YZSO2sBe2bJGZ3gn+Q: posts big blind $10
1ScqYmNf7/uWx1XSBgPTBw: sits out
*** HOLE CARDS ***
3mTlg4g0FJN2bo939h/0Wg: folds
jkH6qYMpn8JA/IyBOhQPMw: folds
n3h6CD5lzlIEFAqnZ5vkzg: folds
83N3uOHZXXb6QNQOaBGOww: raises $20 to $30
UC0/YZSO2sBe2bJGZ3gn+Q: folds
83N3uOHZXXb6QNQOaBGOww collected $20 from pot
83N3uOHZXXb6QNQOaBGOww: doesn't show hand
*** SUMMARY ***
Total pot $20 | Rake $0
Seat 1: UC0/YZSO2sBe2bJGZ3gn+Q (big blind) folded before Flop
Seat 2: 3mTlg4g0FJN2bo939h/0Wg folded before Flop (didn't bet)
Seat 4: jkH6qYMpn8JA/IyBOhQPMw folded before Flop (didn't bet)
Seat 5: n3h6CD5lzlIEFAqnZ5vkzg (button) folded before Flop (didn't bet)
Seat 6: 83N3uOHZXXb6QNQOaBGOww (small blind) collected ($20)



PokerStars Game #59951653310:  Hold'em No Limit ($5/$10) - 2009/07/01 7:26:51 ET
Table 'B7gQa8IrNZTRZX43XhFKUA' 6-max Seat #6 is the button
Seat 1: jkH6qYMpn8JA/IyBOhQPMw ($1005 in chips)
Seat 2: ObR8mkxB7pPf0NUAtp9riQ ($1187 in chips)
Seat 3: 1ScqYmNf7/uWx1XSBgPTBw ($215 in chips)
Seat 4: I1u3BrIcnPwCmkxtD03Q9A ($485 in chips)
Seat 5: BESARbstyvj3tWmTi4s3eg ($801 in chips)
Seat 6: 83N3uOHZXXb6QNQOaBGOww ($1023 in chips)
jkH6qYMpn8JA/IyBOhQPMw: posts small blind $5
ObR8mkxB7pPf0NUAtp9riQ: posts big blind $10
*** HOLE CARDS ***
1ScqYmNf7/uWx1XSBgPTBw: raises $10 to $20
I1u3BrIcnPwCmkxtD03Q9A: folds
BESARbstyvj3tWmTi4s3eg: folds
83N3uOHZXXb6QNQOaBGOww: folds
jkH6qYMpn8JA/IyBOhQPMw: folds
ObR8mkxB7pPf0NUAtp9riQ: folds
1ScqYmNf7/uWx1XSBgPTBw collected $25 from pot
*** SUMMARY ***
Total pot $25 | Rake $0
Seat 1: jkH6qYMpn8JA/IyBOhQPMw (small blind) folded before Flop
Seat 2: ObR8mkxB7pPf0NUAtp9riQ (big blind) folded before Flop
Seat 3: 1ScqYmNf7/uWx1XSBgPTBw collected ($25)
Seat 4: I1u3BrIcnPwCmkxtD03Q9A folded before Flop (didn't bet)
Seat 5: BESARbstyvj3tWmTi4s3eg folded before Flop (didn't bet)
Seat 6: 83N3uOHZXXb6QNQOaBGOww (button) folded before Flop (didn't bet)



PokerStars Game #59951667640:  Hold'em No Limit ($5/$10) - 2009/07/01 7:27:15 ET
Table 'B7gQa8IrNZTRZX43XhFKUA' 6-max Seat #1 is the button
Seat 1: jkH6qYMpn8JA/IyBOhQPMw ($1000 in chips)
Seat 2: ObR8mkxB7pPf0NUAtp9riQ ($1177 in chips)
Seat 3: 1ScqYmNf7/uWx1XSBgPTBw ($230 in chips)
Seat 4: I1u3BrIcnPwCmkxtD03Q9A ($485 in chips)
Seat 5: BESARbstyvj3tWmTi4s3eg ($801 in chips)
Seat 6: 83N3uOHZXXb6QNQOaBGOww ($1023 in chips)
ObR8mkxB7pPf0NUAtp9riQ is connected
ObR8mkxB7pPf0NUAtp9riQ: posts small blind $5
1ScqYmNf7/uWx1XSBgPTBw: posts big blind $10
*** HOLE CARDS ***
I1u3BrIcnPwCmkxtD03Q9A: folds
BESARbstyvj3tWmTi4s3eg: folds
83N3uOHZXXb6QNQOaBGOww: raises $20 to $30
jkH6qYMpn8JA/IyBOhQPMw: folds
ObR8mkxB7pPf0NUAtp9riQ is connected
ObR8mkxB7pPf0NUAtp9riQ: folds
1ScqYmNf7/uWx1XSBgPTBw: folds
83N3uOHZXXb6QNQOaBGOww collected $25 from pot
*** SUMMARY ***
Total pot $25 | Rake $0
Seat 1: jkH6qYMpn8JA/IyBOhQPMw (button) folded before Flop (didn't bet)
Seat 2: ObR8mkxB7pPf0NUAtp9riQ (small blind) folded before Flop
Seat 3: 1ScqYmNf7/uWx1XSBgPTBw (big blind) folded before Flop
Seat 4: I1u3BrIcnPwCmkxtD03Q9A folded before Flop (didn't bet)
Seat 5: BESARbstyvj3tWmTi4s3eg folded before Flop (didn't bet)
Seat 6: 83N3uOHZXXb6QNQOaBGOww collected ($25)



PokerStars Game #59951670638:  Hold'em No Limit ($5/$10) - 2009/07/01 7:27:20 ET
Table 'S53kfSbNcK1y2IhnKFrs4g' 6-max Seat #6 is the button
Seat 1: UC0/YZSO2sBe2bJGZ3gn+Q ($1000 in chips)
Seat 2: 3mTlg4g0FJN2bo939h/0Wg ($241 in chips)
Seat 4: jkH6qYMpn8JA/IyBOhQPMw ($1787 in chips)
Seat 5: n3h6CD5lzlIEFAqnZ5vkzg ($1266.50 in chips)
Seat 6: 83N3uOHZXXb6QNQOaBGOww ($1468 in chips)
UC0/YZSO2sBe2bJGZ3gn+Q: posts small blind $5
3mTlg4g0FJN2bo939h/0Wg: posts big blind $10
1ScqYmNf7/uWx1XSBgPTBw: sits out
*** HOLE CARDS ***
jkH6qYMpn8JA/IyBOhQPMw: folds
n3h6CD5lzlIEFAqnZ5vkzg: folds
83N3uOHZXXb6QNQOaBGOww: raises $20 to $30
UC0/YZSO2sBe2bJGZ3gn+Q: folds
3mTlg4g0FJN2bo939h/0Wg: calls $20
*** FLOP *** [5d 4s 2c]
3mTlg4g0FJN2bo939h/0Wg: checks
83N3uOHZXXb6QNQOaBGOww: bets $50
3mTlg4g0FJN2bo939h/0Wg: folds
83N3uOHZXXb6QNQOaBGOww collected $63 from pot
83N3uOHZXXb6QNQOaBGOww: doesn't show hand
*** SUMMARY ***
Total pot $65 | Rake $2
Board [5d 4s 2c]
Seat 1: UC0/YZSO2sBe2bJGZ3gn+Q (small blind) folded before Flop
Seat 2: 3mTlg4g0FJN2bo939h/0Wg (big blind) folded on the Flop
Seat 4: jkH6qYMpn8JA/IyBOhQPMw folded before Flop (didn't bet)
Seat 5: n3h6CD5lzlIEFAqnZ5vkzg folded before Flop (didn't bet)
Seat 6: 83N3uOHZXXb6QNQOaBGOww (button) collected ($63)



PokerStars Game #59951671146:  Hold'em No Limit ($5/$10) - 2009/07/01 7:27:21 ET
Table 'ZemUU8uyOTYQAgqnaWQDUA' 6-max Seat #6 is the button
Seat 1: 1ScqYmNf7/uWx1XSBgPTBw ($190 in chips)
Seat 2: 83N3uOHZXXb6QNQOaBGOww ($1000 in chips)
Seat 3: jkH6qYMpn8JA/IyBOhQPMw ($1087.50 in chips)
Seat 5: 33XJu1CVnl9YOngoPIhi0A ($796.45 in chips)
Seat 6: 3mTlg4g0FJN2bo939h/0Wg ($386 in chips)
1ScqYmNf7/uWx1XSBgPTBw: posts small blind $5
83N3uOHZXXb6QNQOaBGOww: posts big blind $10
n3h6CD5lzlIEFAqnZ5vkzg: sits out
*** HOLE CARDS ***
jkH6qYMpn8JA/IyBOhQPMw: folds
33XJu1CVnl9YOngoPIhi0A: folds
3mTlg4g0FJN2bo939h/0Wg: folds
1ScqYmNf7/uWx1XSBgPTBw: folds
83N3uOHZXXb6QNQOaBGOww collected $10 from pot
83N3uOHZXXb6QNQOaBGOww: doesn't show hand
*** SUMMARY ***
Total pot $10 | Rake $0
Seat 1: 1ScqYmNf7/uWx1XSBgPTBw (small blind) folded before Flop
Seat 2: 83N3uOHZXXb6QNQOaBGOww (big blind) collected ($10)
Seat 3: jkH6qYMpn8JA/IyBOhQPMw folded before Flop (didn't bet)
Seat 5: 33XJu1CVnl9YOngoPIhi0A folded before Flop (didn't bet)
Seat 6: 3mTlg4g0FJN2bo939h/0Wg (button) folded before Flop (didn't bet)



PokerStars Game #59951685210:  Hold'em No Limit ($5/$10) - 2009/07/01 7:27:45 ET
Table 'ZemUU8uyOTYQAgqnaWQDUA' 6-max Seat #1 is the button
Seat 1: 1ScqYmNf7/uWx1XSBgPTBw ($185 in chips)
Seat 2: 83N3uOHZXXb6QNQOaBGOww ($1005 in chips)
Seat 3: jkH6qYMpn8JA/IyBOhQPMw ($1087.50 in chips)
Seat 5: 33XJu1CVnl9YOngoPIhi0A ($796.45 in chips)
Seat 6: 3mTlg4g0FJN2bo939h/0Wg ($386 in chips)
83N3uOHZXXb6QNQOaBGOww: posts small blind $5
jkH6qYMpn8JA/IyBOhQPMw: posts big blind $10
n3h6CD5lzlIEFAqnZ5vkzg: sits out
*** HOLE CARDS ***
33XJu1CVnl9YOngoPIhi0A: folds
3mTlg4g0FJN2bo939h/0Wg: raises $10 to $20
1ScqYmNf7/uWx1XSBgPTBw: folds
83N3uOHZXXb6QNQOaBGOww: folds
jkH6qYMpn8JA/IyBOhQPMw: raises $60 to $80
3mTlg4g0FJN2bo939h/0Wg: folds
jkH6qYMpn8JA/IyBOhQPMw collected $45 from pot
jkH6qYMpn8JA/IyBOhQPMw: doesn't show hand
*** SUMMARY ***
Total pot $45 | Rake $0
Seat 1: 1ScqYmNf7/uWx1XSBgPTBw (button) folded before Flop (didn't bet)
Seat 2: 83N3uOHZXXb6QNQOaBGOww (small blind) folded before Flop
Seat 3: jkH6qYMpn8JA/IyBOhQPMw (big blind) collected ($45)
Seat 5: 33XJu1CVnl9YOngoPIhi0A folded before Flop (didn't bet)
Seat 6: 3mTlg4g0FJN2bo939h/0Wg folded before Flop



PokerStars Game #59951692850:  Hold'em No Limit ($5/$10) - 2009/07/01 7:27:58 ET
Table 'S53kfSbNcK1y2IhnKFrs4g' 6-max Seat #1 is the button
Seat 1: UC0/YZSO2sBe2bJGZ3gn+Q ($1000 in chips)
Seat 2: 3mTlg4g0FJN2bo939h/0Wg ($211 in chips)
Seat 3: 1ScqYmNf7/uWx1XSBgPTBw ($200 in chips)
Seat 4: jkH6qYMpn8JA/IyBOhQPMw ($1787 in chips)
Seat 5: n3h6CD5lzlIEFAqnZ5vkzg ($1266.50 in chips)
Seat 6: 83N3uOHZXXb6QNQOaBGOww ($1501 in chips)
3mTlg4g0FJN2bo939h/0Wg: posts small blind $5
1ScqYmNf7/uWx1XSBgPTBw: posts big blind $10
*** HOLE CARDS ***
jkH6qYMpn8JA/IyBOhQPMw: folds
n3h6CD5lzlIEFAqnZ5vkzg: folds
83N3uOHZXXb6QNQOaBGOww: folds
UC0/YZSO2sBe2bJGZ3gn+Q: folds
3mTlg4g0FJN2bo939h/0Wg: raises $20 to $30
1ScqYmNf7/uWx1XSBgPTBw: folds
3mTlg4g0FJN2bo939h/0Wg collected $20 from pot
*** SUMMARY ***
Total pot $20 | Rake $0
Seat 1: UC0/YZSO2sBe2bJGZ3gn+Q (button) folded before Flop (didn't bet)
Seat 2: 3mTlg4g0FJN2bo939h/0Wg (small blind) collected ($20)
Seat 3: 1ScqYmNf7/uWx1XSBgPTBw (big blind) folded before Flop
Seat 4: jkH6qYMpn8JA/IyBOhQPMw folded before Flop (didn't bet)
Seat 5: n3h6CD5lzlIEFAqnZ5vkzg folded before Flop (didn't bet)
Seat 6: 83N3uOHZXXb6QNQOaBGOww folded before Flop (didn't bet)



PokerStars Game #59951697984:  Hold'em No Limit ($5/$10) - 2009/07/01 7:28:07 ET
Table 'ZemUU8uyOTYQAgqnaWQDUA' 6-max Seat #2 is the button
Seat 1: 1ScqYmNf7/uWx1XSBgPTBw ($185 in chips)
Seat 2: 83N3uOHZXXb6QNQOaBGOww ($1000 in chips)
Seat 3: jkH6qYMpn8JA/IyBOhQPMw ($1112.50 in chips)
Seat 4: n3h6CD5lzlIEFAqnZ5vkzg ($950 in chips)
Seat 5: 33XJu1CVnl9YOngoPIhi0A ($796.45 in chips)
Seat 6: 3mTlg4g0FJN2bo939h/0Wg ($366 in chips)
jkH6qYMpn8JA/IyBOhQPMw: posts small blind $5
n3h6CD5lzlIEFAqnZ5vkzg: posts big blind $10
*** HOLE CARDS ***
33XJu1CVnl9YOngoPIhi0A: folds
33XJu1CVnl9YOngoPIhi0A leaves the table
3mTlg4g0FJN2bo939h/0Wg: folds
1ScqYmNf7/uWx1XSBgPTBw: folds
83N3uOHZXXb6QNQOaBGOww: raises $20 to $30
jkH6qYMpn8JA/IyBOhQPMw: raises $70 to $100
83N3uOHZXXb6QNQOaBGOww said, "50 bb"
n3h6CD5lzlIEFAqnZ5vkzg: folds
83N3uOHZXXb6QNQOaBGOww: folds
jkH6qYMpn8JA/IyBOhQPMw collected $70 from pot
jkH6qYMpn8JA/IyBOhQPMw: doesn't show hand
*** SUMMARY ***
Total pot $70 | Rake $0
Seat 1: 1ScqYmNf7/uWx1XSBgPTBw folded before Flop (didn't bet)
Seat 2: 83N3uOHZXXb6QNQOaBGOww (button) folded before Flop
Seat 3: jkH6qYMpn8JA/IyBOhQPMw (small blind) collected ($70)
Seat 4: n3h6CD5lzlIEFAqnZ5vkzg (big blind) folded before Flop
Seat 5: 33XJu1CVnl9YOngoPIhi0A folded before Flop (didn't bet)
Seat 6: 3mTlg4g0FJN2bo939h/0Wg folded before Flop (didn't bet)



PokerStars Game #59951700370:  Hold'em No Limit ($5/$10) - 2009/07/01 7:28:11 ET
Table 'B7gQa8IrNZTRZX43XhFKUA' 6-max Seat #2 is the button
Seat 1: jkH6qYMpn8JA/IyBOhQPMw ($1000 in chips)
Seat 2: ObR8mkxB7pPf0NUAtp9riQ ($1172 in chips)
Seat 3: 1ScqYmNf7/uWx1XSBgPTBw ($220 in chips)
Seat 4: I1u3BrIcnPwCmkxtD03Q9A ($485 in chips)
Seat 5: BESARbstyvj3tWmTi4s3eg ($801 in chips)
Seat 6: 83N3uOHZXXb6QNQOaBGOww ($1038 in chips)
1ScqYmNf7/uWx1XSBgPTBw: posts small blind $5
I1u3BrIcnPwCmkxtD03Q9A: posts big blind $10
*** HOLE CARDS ***
BESARbstyvj3tWmTi4s3eg: folds
83N3uOHZXXb6QNQOaBGOww: folds
jkH6qYMpn8JA/IyBOhQPMw: folds
ObR8mkxB7pPf0NUAtp9riQ: raises $10 to $20
1ScqYmNf7/uWx1XSBgPTBw: raises $30 to $50
I1u3BrIcnPwCmkxtD03Q9A: folds
ObR8mkxB7pPf0NUAtp9riQ: folds
1ScqYmNf7/uWx1XSBgPTBw collected $50 from pot
1ScqYmNf7/uWx1XSBgPTBw: doesn't show hand
*** SUMMARY ***
Total pot $50 | Rake $0
Seat 1: jkH6qYMpn8JA/IyBOhQPMw folded before Flop (didn't bet)
Seat 2: ObR8mkxB7pPf0NUAtp9riQ (button) folded before Flop
Seat 3: 1ScqYmNf7/uWx1XSBgPTBw (small blind) collected ($50)
Seat 4: I1u3BrIcnPwCmkxtD03Q9A (big blind) folded before Flop
Seat 5: BESARbstyvj3tWmTi4s3eg folded before Flop (didn't bet)
Seat 6: 83N3uOHZXXb6QNQOaBGOww folded before Flop (didn't bet)



PokerStars Game #59951701506:  Hold'em No Limit ($5/$10) - 2009/07/01 7:28:13 ET
Table 'vjzKoIBF5FqU9W3OSXU85g' 6-max Seat #1 is the button
Seat 1: 83N3uOHZXXb6QNQOaBGOww ($1000 in chips)
Seat 2: 1ScqYmNf7/uWx1XSBgPTBw ($165 in chips)
Seat 3: e7PupvaIASKltHFJTx+bcQ ($633 in chips)
Seat 4: jkH6qYMpn8JA/IyBOhQPMw ($1217 in chips)
Seat 5: BbirlZJeYiPjSFVvLtEDVw ($1689 in chips)
Seat 6: 3mTlg4g0FJN2bo939h/0Wg ($200 in chips)
1ScqYmNf7/uWx1XSBgPTBw: posts small blind $5
e7PupvaIASKltHFJTx+bcQ: posts big blind $10
3mTlg4g0FJN2bo939h/0Wg: posts small blind $5
*** HOLE CARDS ***
jkH6qYMpn8JA/IyBOhQPMw: folds
BbirlZJeYiPjSFVvLtEDVw: raises $20 to $30
3mTlg4g0FJN2bo939h/0Wg: folds
83N3uOHZXXb6QNQOaBGOww: folds
1ScqYmNf7/uWx1XSBgPTBw: folds
e7PupvaIASKltHFJTx+bcQ: folds
BbirlZJeYiPjSFVvLtEDVw collected $30 from pot
*** SUMMARY ***
Total pot $30 | Rake $0
Seat 1: 83N3uOHZXXb6QNQOaBGOww (button) folded before Flop (didn't bet)
Seat 2: 1ScqYmNf7/uWx1XSBgPTBw (small blind) folded before Flop
Seat 3: e7PupvaIASKltHFJTx+bcQ (big blind) folded before Flop
Seat 4: jkH6qYMpn8JA/IyBOhQPMw folded before Flop (didn't bet)
Seat 5: BbirlZJeYiPjSFVvLtEDVw collected ($30)
Seat 6: 3mTlg4g0FJN2bo939h/0Wg folded before Flop



PokerStars Game #59951701642:  Hold'em No Limit ($5/$10) - 2009/07/01 7:28:13 ET
Table 'S53kfSbNcK1y2IhnKFrs4g' 6-max Seat #2 is the button
Seat 1: UC0/YZSO2sBe2bJGZ3gn+Q ($1000 in chips)
Seat 2: 3mTlg4g0FJN2bo939h/0Wg ($221 in chips)
Seat 3: 1ScqYmNf7/uWx1XSBgPTBw ($190 in chips)
Seat 4: jkH6qYMpn8JA/IyBOhQPMw ($1787 in chips)
Seat 5: n3h6CD5lzlIEFAqnZ5vkzg ($1266.50 in chips)
Seat 6: 83N3uOHZXXb6QNQOaBGOww ($1501 in chips)
1ScqYmNf7/uWx1XSBgPTBw: posts small blind $5
jkH6qYMpn8JA/IyBOhQPMw: posts big blind $10
*** HOLE CARDS ***
n3h6CD5lzlIEFAqnZ5vkzg: folds
83N3uOHZXXb6QNQOaBGOww: folds
UC0/YZSO2sBe2bJGZ3gn+Q: folds
3mTlg4g0FJN2bo939h/0Wg: folds
1ScqYmNf7/uWx1XSBgPTBw: folds
jkH6qYMpn8JA/IyBOhQPMw collected $10 from pot
jkH6qYMpn8JA/IyBOhQPMw: doesn't show hand
*** SUMMARY ***
Total pot $10 | Rake $0
Seat 1: UC0/YZSO2sBe2bJGZ3gn+Q folded before Flop (didn't bet)
Seat 2: 3mTlg4g0FJN2bo939h/0Wg (button) folded before Flop (didn't bet)
Seat 3: 1ScqYmNf7/uWx1XSBgPTBw (small blind) folded before Flop
Seat 4: jkH6qYMpn8JA/IyBOhQPMw (big blind) collected ($10)
Seat 5: n3h6CD5lzlIEFAqnZ5vkzg folded before Flop (didn't bet)
Seat 6: 83N3uOHZXXb6QNQOaBGOww folded before Flop (didn't bet)



PokerStars Game #59951712978:  Hold'em No Limit ($5/$10) - 2009/07/01 7:28:32 ET
Table 'S53kfSbNcK1y2IhnKFrs4g' 6-max Seat #3 is the button
Seat 1: UC0/YZSO2sBe2bJGZ3gn+Q ($1000 in chips)
Seat 2: 3mTlg4g0FJN2bo939h/0Wg ($221 in chips)
Seat 3: 1ScqYmNf7/uWx1XSBgPTBw ($185 in chips)
Seat 4: jkH6qYMpn8JA/IyBOhQPMw ($1792 in chips)
Seat 5: n3h6CD5lzlIEFAqnZ5vkzg ($1266.50 in chips)
Seat 6: 83N3uOHZXXb6QNQOaBGOww ($1501 in chips)
jkH6qYMpn8JA/IyBOhQPMw: posts small blind $5
n3h6CD5lzlIEFAqnZ5vkzg: posts big blind $10
*** HOLE CARDS ***
83N3uOHZXXb6QNQOaBGOww: raises $20 to $30
UC0/YZSO2sBe2bJGZ3gn+Q: folds
3mTlg4g0FJN2bo939h/0Wg: folds
1ScqYmNf7/uWx1XSBgPTBw: folds
jkH6qYMpn8JA/IyBOhQPMw: folds
n3h6CD5lzlIEFAqnZ5vkzg: folds
83N3uOHZXXb6QNQOaBGOww collected $25 from pot
83N3uOHZXXb6QNQOaBGOww: doesn't show hand
*** SUMMARY ***
Total pot $25 | Rake $0
Seat 1: UC0/YZSO2sBe2bJGZ3gn+Q folded before Flop (didn't bet)
Seat 2: 3mTlg4g0FJN2bo939h/0Wg folded before Flop (didn't bet)
Seat 3: 1ScqYmNf7/uWx1XSBgPTBw (button) folded before Flop (didn't bet)
Seat 4: jkH6qYMpn8JA/IyBOhQPMw (small blind) folded before Flop
Seat 5: n3h6CD5lzlIEFAqnZ5vkzg (big blind) folded before Flop
Seat 6: 83N3uOHZXXb6QNQOaBGOww collected ($25)



PokerStars Game #59951717178:  Hold'em No Limit ($5/$10) - 2009/07/01 7:28:40 ET
Table 'vjzKoIBF5FqU9W3OSXU85g' 6-max Seat #2 is the button
Seat 1: 83N3uOHZXXb6QNQOaBGOww ($1000 in chips)
Seat 2: 1ScqYmNf7/uWx1XSBgPTBw ($160 in chips)
Seat 3: e7PupvaIASKltHFJTx+bcQ ($623 in chips)
Seat 4: jkH6qYMpn8JA/IyBOhQPMw ($1217 in chips)
Seat 5: BbirlZJeYiPjSFVvLtEDVw ($1709 in chips)
Seat 6: 3mTlg4g0FJN2bo939h/0Wg ($195 in chips)
e7PupvaIASKltHFJTx+bcQ: posts small blind $5
jkH6qYMpn8JA/IyBOhQPMw: posts big blind $10
*** HOLE CARDS ***
BbirlZJeYiPjSFVvLtEDVw: folds
3mTlg4g0FJN2bo939h/0Wg: folds
83N3uOHZXXb6QNQOaBGOww: folds
1ScqYmNf7/uWx1XSBgPTBw: folds
e7PupvaIASKltHFJTx+bcQ: raises $10 to $20
jkH6qYMpn8JA/IyBOhQPMw: folds
e7PupvaIASKltHFJTx+bcQ collected $20 from pot
*** SUMMARY ***
Total pot $20 | Rake $0
Seat 1: 83N3uOHZXXb6QNQOaBGOww folded before Flop (didn't bet)
Seat 2: 1ScqYmNf7/uWx1XSBgPTBw (button) folded before Flop (didn't bet)
Seat 3: e7PupvaIASKltHFJTx+bcQ (small blind) collected ($20)
Seat 4: jkH6qYMpn8JA/IyBOhQPMw (big blind) folded before Flop
Seat 5: BbirlZJeYiPjSFVvLtEDVw folded before Flop (didn't bet)
Seat 6: 3mTlg4g0FJN2bo939h/0Wg folded before Flop (didn't bet)



PokerStars Game #59951717758:  Hold'em No Limit ($5/$10) - 2009/07/01 7:28:41 ET
Table 'B7gQa8IrNZTRZX43XhFKUA' 6-max Seat #3 is the button
Seat 1: jkH6qYMpn8JA/IyBOhQPMw ($1000 in chips)
Seat 2: ObR8mkxB7pPf0NUAtp9riQ ($1152 in chips)
Seat 3: 1ScqYmNf7/uWx1XSBgPTBw ($250 in chips)
Seat 4: I1u3BrIcnPwCmkxtD03Q9A ($475 in chips)
Seat 5: BESARbstyvj3tWmTi4s3eg ($801 in chips)
Seat 6: 83N3uOHZXXb6QNQOaBGOww ($1038 in chips)
I1u3BrIcnPwCmkxtD03Q9A: posts small blind $5
BESARbstyvj3tWmTi4s3eg: posts big blind $10
*** HOLE CARDS ***
83N3uOHZXXb6QNQOaBGOww: folds
jkH6qYMpn8JA/IyBOhQPMw: raises $20 to $30
ObR8mkxB7pPf0NUAtp9riQ: folds
1ScqYmNf7/uWx1XSBgPTBw: folds
I1u3BrIcnPwCmkxtD03Q9A: folds
BESARbstyvj3tWmTi4s3eg: folds
jkH6qYMpn8JA/IyBOhQPMw collected $25 from pot
*** SUMMARY ***
Total pot $25 | Rake $0
Seat 1: jkH6qYMpn8JA/IyBOhQPMw collected ($25)
Seat 2: ObR8mkxB7pPf0NUAtp9riQ folded before Flop (didn't bet)
Seat 3: 1ScqYmNf7/uWx1XSBgPTBw (button) folded before Flop (didn't bet)
Seat 4: I1u3BrIcnPwCmkxtD03Q9A (small blind) folded before Flop
Seat 5: BESARbstyvj3tWmTi4s3eg (big blind) folded before Flop
Seat 6: 83N3uOHZXXb6QNQOaBGOww folded before Flop (didn't bet)



PokerStars Game #59951718000:  Hold'em No Limit ($5/$10) - 2009/07/01 7:28:41 ET
Table 'ZemUU8uyOTYQAgqnaWQDUA' 6-max Seat #3 is the button
Seat 1: 1ScqYmNf7/uWx1XSBgPTBw ($185 in chips)
Seat 2: 83N3uOHZXXb6QNQOaBGOww ($1000 in chips)
Seat 3: jkH6qYMpn8JA/IyBOhQPMw ($1152.50 in chips)
Seat 4: n3h6CD5lzlIEFAqnZ5vkzg ($940 in chips)
Seat 6: 3mTlg4g0FJN2bo939h/0Wg ($366 in chips)
n3h6CD5lzlIEFAqnZ5vkzg: posts small blind $5
3mTlg4g0FJN2bo939h/0Wg: posts big blind $10
*** HOLE CARDS ***
1ScqYmNf7/uWx1XSBgPTBw: folds
83N3uOHZXXb6QNQOaBGOww: folds
jkH6qYMpn8JA/IyBOhQPMw: raises $20 to $30
jkH6qYMpn8JA/IyBOhQPMw said, "bb?"
n3h6CD5lzlIEFAqnZ5vkzg: folds
3mTlg4g0FJN2bo939h/0Wg: calls $20
*** FLOP *** [Jd 5c Kc]
3mTlg4g0FJN2bo939h/0Wg: checks
jkH6qYMpn8JA/IyBOhQPMw: checks
*** TURN *** [Jd 5c Kc] [3s]
3mTlg4g0FJN2bo939h/0Wg: checks
jkH6qYMpn8JA/IyBOhQPMw: checks
*** RIVER *** [Jd 5c Kc 3s] [3h]
3mTlg4g0FJN2bo939h/0Wg: bets $50
jkH6qYMpn8JA/IyBOhQPMw: calls $50
*** SHOW DOWN ***
3mTlg4g0FJN2bo939h/0Wg: shows [6s Kd] (two pair, Kings and Threes)
jkH6qYMpn8JA/IyBOhQPMw: mucks hand
3mTlg4g0FJN2bo939h/0Wg collected $163 from pot
*** SUMMARY ***
Total pot $165 | Rake $2
Board [Jd 5c Kc 3s 3h]
Seat 1: 1ScqYmNf7/uWx1XSBgPTBw folded before Flop (didn't bet)
Seat 2: 83N3uOHZXXb6QNQOaBGOww folded before Flop (didn't bet)
Seat 3: jkH6qYMpn8JA/IyBOhQPMw (button) mucked
Seat 4: n3h6CD5lzlIEFAqnZ5vkzg (small blind) folded before Flop
Seat 6: 3mTlg4g0FJN2bo939h/0Wg (big blind) showed [6s Kd] and won ($163) with two pair, Kings and Threes



PokerStars Game #59951727210:  Hold'em No Limit ($5/$10) - 2009/07/01 7:28:57 ET
Table 'S53kfSbNcK1y2IhnKFrs4g' 6-max Seat #4 is the button
Seat 1: UC0/YZSO2sBe2bJGZ3gn+Q ($1000 in chips)
Seat 2: 3mTlg4g0FJN2bo939h/0Wg ($221 in chips)
Seat 3: 1ScqYmNf7/uWx1XSBgPTBw ($185 in chips)
Seat 4: jkH6qYMpn8JA/IyBOhQPMw ($1787 in chips)
Seat 5: n3h6CD5lzlIEFAqnZ5vkzg ($1256.50 in chips)
Seat 6: 83N3uOHZXXb6QNQOaBGOww ($1516 in chips)
n3h6CD5lzlIEFAqnZ5vkzg: posts small blind $5
83N3uOHZXXb6QNQOaBGOww: posts big blind $10
*** HOLE CARDS ***
UC0/YZSO2sBe2bJGZ3gn+Q: folds
3mTlg4g0FJN2bo939h/0Wg: raises $20 to $30
1ScqYmNf7/uWx1XSBgPTBw: folds
jkH6qYMpn8JA/IyBOhQPMw: folds
n3h6CD5lzlIEFAqnZ5vkzg: folds
83N3uOHZXXb6QNQOaBGOww: raises $70 to $100
3mTlg4g0FJN2bo939h/0Wg: calls $70
*** FLOP *** [8h 9c Ac]
83N3uOHZXXb6QNQOaBGOww: bets $1416 and is all-in
3mTlg4g0FJN2bo939h/0Wg: folds
83N3uOHZXXb6QNQOaBGOww collected $202 from pot
*** SUMMARY ***
Total pot $205 | Rake $3
Board [8h 9c Ac]
Seat 1: UC0/YZSO2sBe2bJGZ3gn+Q folded before Flop (didn't bet)
Seat 2: 3mTlg4g0FJN2bo939h/0Wg folded on the Flop
Seat 3: 1ScqYmNf7/uWx1XSBgPTBw folded before Flop (didn't bet)
Seat 4: jkH6qYMpn8JA/IyBOhQPMw (button) folded before Flop (didn't bet)
Seat 5: n3h6CD5lzlIEFAqnZ5vkzg (small blind) folded before Flop
Seat 6: 83N3uOHZXXb6QNQOaBGOww (big blind) collected ($202)



PokerStars Game #59951734468:  Hold'em No Limit ($5/$10) - 2009/07/01 7:29:09 ET
Table 'vjzKoIBF5FqU9W3OSXU85g' 6-max Seat #3 is the button
Seat 1: 83N3uOHZXXb6QNQOaBGOww ($1000 in chips)
Seat 2: 1ScqYmNf7/uWx1XSBgPTBw ($160 in chips)
Seat 3: e7PupvaIASKltHFJTx+bcQ ($633 in chips)
Seat 4: jkH6qYMpn8JA/IyBOhQPMw ($1207 in chips)
Seat 5: BbirlZJeYiPjSFVvLtEDVw ($1709 in chips)
Seat 6: 3mTlg4g0FJN2bo939h/0Wg ($195 in chips)
jkH6qYMpn8JA/IyBOhQPMw: posts small blind $5
BbirlZJeYiPjSFVvLtEDVw: posts big blind $10
*** HOLE CARDS ***
3mTlg4g0FJN2bo939h/0Wg: raises $10 to $20
83N3uOHZXXb6QNQOaBGOww: folds
1ScqYmNf7/uWx1XSBgPTBw: folds
e7PupvaIASKltHFJTx+bcQ: folds
jkH6qYMpn8JA/IyBOhQPMw: calls $15
BbirlZJeYiPjSFVvLtEDVw: folds
*** FLOP *** [Ah Kd 5h]
jkH6qYMpn8JA/IyBOhQPMw: checks
3mTlg4g0FJN2bo939h/0Wg: bets $20
jkH6qYMpn8JA/IyBOhQPMw: calls $20
*** TURN *** [Ah Kd 5h] [3c]
jkH6qYMpn8JA/IyBOhQPMw: checks
3mTlg4g0FJN2bo939h/0Wg: checks
*** RIVER *** [Ah Kd 5h 3c] [Ad]
jkH6qYMpn8JA/IyBOhQPMw: checks
3mTlg4g0FJN2bo939h/0Wg: checks
*** SHOW DOWN ***
jkH6qYMpn8JA/IyBOhQPMw: shows [6d 5d] (two pair, Aces and Fives)
3mTlg4g0FJN2bo939h/0Wg: mucks hand
jkH6qYMpn8JA/IyBOhQPMw collected $87 from pot
*** SUMMARY ***
Total pot $90 | Rake $3
Board [Ah Kd 5h 3c Ad]
Seat 1: 83N3uOHZXXb6QNQOaBGOww folded before Flop (didn't bet)
Seat 2: 1ScqYmNf7/uWx1XSBgPTBw folded before Flop (didn't bet)
Seat 3: e7PupvaIASKltHFJTx+bcQ (button) folded before Flop (didn't bet)
Seat 4: jkH6qYMpn8JA/IyBOhQPMw (small blind) showed [6d 5d] and won ($87) with two pair, Aces and Fives
Seat 5: BbirlZJeYiPjSFVvLtEDVw (big blind) folded before Flop
Seat 6: 3mTlg4g0FJN2bo939h/0Wg mucked



PokerStars Game #59951734098:  Hold'em No Limit ($5/$10) - 2009/07/01 7:29:09 ET
Table 'B7gQa8IrNZTRZX43XhFKUA' 6-max Seat #4 is the button
Seat 1: jkH6qYMpn8JA/IyBOhQPMw ($1015 in chips)
Seat 2: ObR8mkxB7pPf0NUAtp9riQ ($1152 in chips)
Seat 3: 1ScqYmNf7/uWx1XSBgPTBw ($250 in chips)
Seat 4: I1u3BrIcnPwCmkxtD03Q9A ($470 in chips)
Seat 5: BESARbstyvj3tWmTi4s3eg ($791 in chips)
Seat 6: 83N3uOHZXXb6QNQOaBGOww ($1038 in chips)
BESARbstyvj3tWmTi4s3eg: posts small blind $5
83N3uOHZXXb6QNQOaBGOww: posts big blind $10
*** HOLE CARDS ***
jkH6qYMpn8JA/IyBOhQPMw: raises $20 to $30
ObR8mkxB7pPf0NUAtp9riQ: folds
1ScqYmNf7/uWx1XSBgPTBw: raises $220 to $250 and is all-in
I1u3BrIcnPwCmkxtD03Q9A: folds
BESARbstyvj3tWmTi4s3eg: folds
83N3uOHZXXb6QNQOaBGOww: raises $788 to $1038 and is all-in
jkH6qYMpn8JA/IyBOhQPMw: folds
*** FLOP *** [6h 5d Ah]
*** TURN *** [6h 5d Ah] [8c]
*** RIVER *** [6h 5d Ah 8c] [Jh]
*** SHOW DOWN ***
83N3uOHZXXb6QNQOaBGOww: shows [Th Td] (a pair of Tens)
1ScqYmNf7/uWx1XSBgPTBw: shows [Jc Jd] (three of a kind, Jacks)
1ScqYmNf7/uWx1XSBgPTBw collected $532 from pot
*** SUMMARY ***
Total pot $535 | Rake $3
Board [6h 5d Ah 8c Jh]
Seat 1: jkH6qYMpn8JA/IyBOhQPMw folded before Flop
Seat 2: ObR8mkxB7pPf0NUAtp9riQ folded before Flop (didn't bet)
Seat 3: 1ScqYmNf7/uWx1XSBgPTBw showed [Jc Jd] and won ($532) with three of a kind, Jacks
Seat 4: I1u3BrIcnPwCmkxtD03Q9A (button) folded before Flop (didn't bet)
Seat 5: BESARbstyvj3tWmTi4s3eg (small blind) folded before Flop
Seat 6: 83N3uOHZXXb6QNQOaBGOww (big blind) showed [Th Td] and lost with a pair of Tens



PokerStars Game #59951746654:  Hold'em No Limit ($5/$10) - 2009/07/01 7:29:30 ET
Table 'ZemUU8uyOTYQAgqnaWQDUA' 6-max Seat #4 is the button
Seat 1: 1ScqYmNf7/uWx1XSBgPTBw ($185 in chips)
Seat 2: 83N3uOHZXXb6QNQOaBGOww ($1000 in chips)
Seat 3: jkH6qYMpn8JA/IyBOhQPMw ($1072.50 in chips)
Seat 4: n3h6CD5lzlIEFAqnZ5vkzg ($935 in chips)
Seat 6: 3mTlg4g0FJN2bo939h/0Wg ($449 in chips)
3mTlg4g0FJN2bo939h/0Wg: posts small blind $5
1ScqYmNf7/uWx1XSBgPTBw: posts big blind $10
*** HOLE CARDS ***
83N3uOHZXXb6QNQOaBGOww: folds
jkH6qYMpn8JA/IyBOhQPMw: folds
n3h6CD5lzlIEFAqnZ5vkzg: raises $20 to $30
3mTlg4g0FJN2bo939h/0Wg: folds
1ScqYmNf7/uWx1XSBgPTBw: raises $155 to $185 and is all-in
n3h6CD5lzlIEFAqnZ5vkzg: calls $155
*** FLOP *** [2s 6c 7d]
*** TURN *** [2s 6c 7d] [Th]
*** RIVER *** [2s 6c 7d Th] [Jc]
*** SHOW DOWN ***
1ScqYmNf7/uWx1XSBgPTBw: shows [Ac Kc] (high card Ace)
n3h6CD5lzlIEFAqnZ5vkzg: mucks hand
1ScqYmNf7/uWx1XSBgPTBw collected $373 from pot
*** SUMMARY ***
Total pot $375 | Rake $2
Board [2s 6c 7d Th Jc]
Seat 1: 1ScqYmNf7/uWx1XSBgPTBw (big blind) showed [Ac Kc] and won ($373) with high card Ace
Seat 2: 83N3uOHZXXb6QNQOaBGOww folded before Flop (didn't bet)
Seat 3: jkH6qYMpn8JA/IyBOhQPMw folded before Flop (didn't bet)
Seat 4: n3h6CD5lzlIEFAqnZ5vkzg (button) mucked
Seat 6: 3mTlg4g0FJN2bo939h/0Wg (small blind) folded before Flop



PokerStars Game #59951748314:  Hold'em No Limit ($5/$10) - 2009/07/01 7:29:33 ET
Table 'S53kfSbNcK1y2IhnKFrs4g' 6-max Seat #5 is the button
Seat 1: UC0/YZSO2sBe2bJGZ3gn+Q ($1000 in chips)
Seat 2: 3mTlg4g0FJN2bo939h/0Wg ($121 in chips)
Seat 3: 1ScqYmNf7/uWx1XSBgPTBw ($185 in chips)
Seat 4: jkH6qYMpn8JA/IyBOhQPMw ($1787 in chips)
Seat 5: n3h6CD5lzlIEFAqnZ5vkzg ($1251.50 in chips)
Seat 6: 83N3uOHZXXb6QNQOaBGOww ($1618 in chips)
83N3uOHZXXb6QNQOaBGOww: posts small blind $5
UC0/YZSO2sBe2bJGZ3gn+Q: posts big blind $10
*** HOLE CARDS ***
3mTlg4g0FJN2bo939h/0Wg: folds
1ScqYmNf7/uWx1XSBgPTBw: raises $10 to $20
jkH6qYMpn8JA/IyBOhQPMw: folds
n3h6CD5lzlIEFAqnZ5vkzg: folds
83N3uOHZXXb6QNQOaBGOww: folds
UC0/YZSO2sBe2bJGZ3gn+Q: raises $50 to $70
1ScqYmNf7/uWx1XSBgPTBw: folds
UC0/YZSO2sBe2bJGZ3gn+Q collected $45 from pot
UC0/YZSO2sBe2bJGZ3gn+Q: doesn't show hand
*** SUMMARY ***
Total pot $45 | Rake $0
Seat 1: UC0/YZSO2sBe2bJGZ3gn+Q (big blind) collected ($45)
Seat 2: 3mTlg4g0FJN2bo939h/0Wg folded before Flop (didn't bet)
Seat 3: 1ScqYmNf7/uWx1XSBgPTBw folded before Flop
Seat 4: jkH6qYMpn8JA/IyBOhQPMw folded before Flop (didn't bet)
Seat 5: n3h6CD5lzlIEFAqnZ5vkzg (button) folded before Flop (didn't bet)
Seat 6: 83N3uOHZXXb6QNQOaBGOww (small blind) folded before Flop



PokerStars Game #59951764594:  Hold'em No Limit ($5/$10) - 2009/07/01 7:30:01 ET
Table 'S53kfSbNcK1y2IhnKFrs4g' 6-max Seat #6 is the button
Seat 1: UC0/YZSO2sBe2bJGZ3gn+Q ($1025 in chips)
Seat 2: 3mTlg4g0FJN2bo939h/0Wg ($121 in chips)
Seat 3: 1ScqYmNf7/uWx1XSBgPTBw ($165 in chips)
Seat 4: jkH6qYMpn8JA/IyBOhQPMw ($1787 in chips)
Seat 5: n3h6CD5lzlIEFAqnZ5vkzg ($1251.50 in chips)
Seat 6: 83N3uOHZXXb6QNQOaBGOww ($1613 in chips)
UC0/YZSO2sBe2bJGZ3gn+Q: posts small blind $5
3mTlg4g0FJN2bo939h/0Wg: posts big blind $10
*** HOLE CARDS ***
1ScqYmNf7/uWx1XSBgPTBw: folds
jkH6qYMpn8JA/IyBOhQPMw: folds
n3h6CD5lzlIEFAqnZ5vkzg: raises $20 to $30
83N3uOHZXXb6QNQOaBGOww: folds
UC0/YZSO2sBe2bJGZ3gn+Q: folds
3mTlg4g0FJN2bo939h/0Wg: calls $20
*** FLOP *** [Ah 5h As]
3mTlg4g0FJN2bo939h/0Wg: bets $91 and is all-in
n3h6CD5lzlIEFAqnZ5vkzg: calls $91
*** TURN *** [Ah 5h As] [6c]
*** RIVER *** [Ah 5h As 6c] [Kd]
*** SHOW DOWN ***
3mTlg4g0FJN2bo939h/0Wg: shows [3c 2c] (a pair of Aces)
n3h6CD5lzlIEFAqnZ5vkzg: shows [9s 9c] (two pair, Aces and Nines)
n3h6CD5lzlIEFAqnZ5vkzg collected $244 from pot
*** SUMMARY ***
Total pot $247 | Rake $3
Board [Ah 5h As 6c Kd]
Seat 1: UC0/YZSO2sBe2bJGZ3gn+Q (small blind) folded before Flop
Seat 2: 3mTlg4g0FJN2bo939h/0Wg (big blind) showed [3c 2c] and lost with a pair of Aces
Seat 3: 1ScqYmNf7/uWx1XSBgPTBw folded before Flop (didn't bet)
Seat 4: jkH6qYMpn8JA/IyBOhQPMw folded before Flop (didn't bet)
Seat 5: n3h6CD5lzlIEFAqnZ5vkzg showed [9s 9c] and won ($244) with two pair, Aces and Nines
Seat 6: 83N3uOHZXXb6QNQOaBGOww (button) folded before Flop (didn't bet)



PokerStars Game #59951767986:  Hold'em No Limit ($5/$10) - 2009/07/01 7:30:07 ET
Table 'vjzKoIBF5FqU9W3OSXU85g' 6-max Seat #4 is the button
Seat 1: 83N3uOHZXXb6QNQOaBGOww ($1000 in chips)
Seat 2: 1ScqYmNf7/uWx1XSBgPTBw ($160 in chips)
Seat 3: e7PupvaIASKltHFJTx+bcQ ($633 in chips)
Seat 4: jkH6qYMpn8JA/IyBOhQPMw ($1254 in chips)
Seat 5: BbirlZJeYiPjSFVvLtEDVw ($1699 in chips)
Seat 6: 3mTlg4g0FJN2bo939h/0Wg ($155 in chips)
BbirlZJeYiPjSFVvLtEDVw: posts small blind $5
3mTlg4g0FJN2bo939h/0Wg: posts big blind $10
*** HOLE CARDS ***
83N3uOHZXXb6QNQOaBGOww: folds
1ScqYmNf7/uWx1XSBgPTBw: folds
e7PupvaIASKltHFJTx+bcQ: folds
jkH6qYMpn8JA/IyBOhQPMw: folds
BbirlZJeYiPjSFVvLtEDVw: folds
3mTlg4g0FJN2bo939h/0Wg collected $10 from pot
*** SUMMARY ***
Total pot $10 | Rake $0
Seat 1: 83N3uOHZXXb6QNQOaBGOww folded before Flop (didn't bet)
Seat 2: 1ScqYmNf7/uWx1XSBgPTBw folded before Flop (didn't bet)
Seat 3: e7PupvaIASKltHFJTx+bcQ folded before Flop (didn't bet)
Seat 4: jkH6qYMpn8JA/IyBOhQPMw (button) folded before Flop (didn't bet)
Seat 5: BbirlZJeYiPjSFVvLtEDVw (small blind) folded before Flop
Seat 6: 3mTlg4g0FJN2bo939h/0Wg (big blind) collected ($10)



PokerStars Game #59951779876:  Hold'em No Limit ($5/$10) - 2009/07/01 7:30:28 ET
Table 'vjzKoIBF5FqU9W3OSXU85g' 6-max Seat #5 is the button
Seat 1: 83N3uOHZXXb6QNQOaBGOww ($1000 in chips)
Seat 2: 1ScqYmNf7/uWx1XSBgPTBw ($160 in chips)
Seat 3: e7PupvaIASKltHFJTx+bcQ ($633 in chips)
Seat 4: jkH6qYMpn8JA/IyBOhQPMw ($1254 in chips)
Seat 5: BbirlZJeYiPjSFVvLtEDVw ($1694 in chips)
Seat 6: 3mTlg4g0FJN2bo939h/0Wg ($160 in chips)
3mTlg4g0FJN2bo939h/0Wg: posts small blind $5
83N3uOHZXXb6QNQOaBGOww: posts big blind $10
*** HOLE CARDS ***
1ScqYmNf7/uWx1XSBgPTBw: raises $10 to $20
e7PupvaIASKltHFJTx+bcQ: folds
jkH6qYMpn8JA/IyBOhQPMw: folds
BbirlZJeYiPjSFVvLtEDVw: folds
3mTlg4g0FJN2bo939h/0Wg: folds
83N3uOHZXXb6QNQOaBGOww: folds
1ScqYmNf7/uWx1XSBgPTBw collected $25 from pot
*** SUMMARY ***
Total pot $25 | Rake $0
Seat 1: 83N3uOHZXXb6QNQOaBGOww (big blind) folded before Flop
Seat 2: 1ScqYmNf7/uWx1XSBgPTBw collected ($25)
Seat 3: e7PupvaIASKltHFJTx+bcQ folded before Flop (didn't bet)
Seat 4: jkH6qYMpn8JA/IyBOhQPMw folded before Flop (didn't bet)
Seat 5: BbirlZJeYiPjSFVvLtEDVw (button) folded before Flop (didn't bet)
Seat 6: 3mTlg4g0FJN2bo939h/0Wg (small blind) folded before Flop



PokerStars Game #59951780836:  Hold'em No Limit ($5/$10) - 2009/07/01 7:30:30 ET
Table 'B7gQa8IrNZTRZX43XhFKUA' 6-max Seat #5 is the button
Seat 1: jkH6qYMpn8JA/IyBOhQPMw ($1000 in chips)
Seat 2: ObR8mkxB7pPf0NUAtp9riQ ($1152 in chips)
Seat 3: 1ScqYmNf7/uWx1XSBgPTBw ($532 in chips)
Seat 4: I1u3BrIcnPwCmkxtD03Q9A ($470 in chips)
Seat 5: BESARbstyvj3tWmTi4s3eg ($786 in chips)
Seat 6: 83N3uOHZXXb6QNQOaBGOww ($1000 in chips)
83N3uOHZXXb6QNQOaBGOww: posts small blind $5
jkH6qYMpn8JA/IyBOhQPMw: posts big blind $10
*** HOLE CARDS ***
ObR8mkxB7pPf0NUAtp9riQ: folds
1ScqYmNf7/uWx1XSBgPTBw: folds
I1u3BrIcnPwCmkxtD03Q9A: folds
BESARbstyvj3tWmTi4s3eg: folds
83N3uOHZXXb6QNQOaBGOww: folds
jkH6qYMpn8JA/IyBOhQPMw collected $10 from pot
*** SUMMARY ***
Total pot $10 | Rake $0
Seat 1: jkH6qYMpn8JA/IyBOhQPMw (big blind) collected ($10)
Seat 2: ObR8mkxB7pPf0NUAtp9riQ folded before Flop (didn't bet)
Seat 3: 1ScqYmNf7/uWx1XSBgPTBw folded before Flop (didn't bet)
Seat 4: I1u3BrIcnPwCmkxtD03Q9A folded before Flop (didn't bet)
Seat 5: BESARbstyvj3tWmTi4s3eg (button) folded before Flop (didn't bet)
Seat 6: 83N3uOHZXXb6QNQOaBGOww (small blind) folded before Flop



PokerStars Game #59951781872:  Hold'em No Limit ($5/$10) - 2009/07/01 7:30:31 ET
Table 'ZemUU8uyOTYQAgqnaWQDUA' 6-max Seat #6 is the button
Seat 1: 1ScqYmNf7/uWx1XSBgPTBw ($373 in chips)
Seat 3: jkH6qYMpn8JA/IyBOhQPMw ($1072.50 in chips)
Seat 4: n3h6CD5lzlIEFAqnZ5vkzg ($750 in chips)
Seat 6: 3mTlg4g0FJN2bo939h/0Wg ($444 in chips)
1ScqYmNf7/uWx1XSBgPTBw: posts small blind $5
83N3uOHZXXb6QNQOaBGOww: is sitting out
jkH6qYMpn8JA/IyBOhQPMw: posts big blind $10
*** HOLE CARDS ***
83N3uOHZXXb6QNQOaBGOww leaves the table
n3h6CD5lzlIEFAqnZ5vkzg: folds
3mTlg4g0FJN2bo939h/0Wg: raises $10 to $20
1ScqYmNf7/uWx1XSBgPTBw: folds
jkH6qYMpn8JA/IyBOhQPMw: calls $10
*** FLOP *** [Kh 7c 9d]
jkH6qYMpn8JA/IyBOhQPMw: checks
3mTlg4g0FJN2bo939h/0Wg: checks
*** TURN *** [Kh 7c 9d] [Ac]
jkH6qYMpn8JA/IyBOhQPMw: bets $32
3mTlg4g0FJN2bo939h/0Wg: calls $32
*** RIVER *** [Kh 7c 9d Ac] [4h]
jkH6qYMpn8JA/IyBOhQPMw: checks
3mTlg4g0FJN2bo939h/0Wg: bets $70
jkH6qYMpn8JA/IyBOhQPMw: folds
3mTlg4g0FJN2bo939h/0Wg collected $107 from pot
*** SUMMARY ***
Total pot $109 | Rake $2
Board [Kh 7c 9d Ac 4h]
Seat 1: 1ScqYmNf7/uWx1XSBgPTBw (small blind) folded before Flop
Seat 3: jkH6qYMpn8JA/IyBOhQPMw (big blind) folded on the River
Seat 4: n3h6CD5lzlIEFAqnZ5vkzg folded before Flop (didn't bet)
Seat 6: 3mTlg4g0FJN2bo939h/0Wg (button) collected ($107)



PokerStars Game #59951786420:  Hold'em No Limit ($5/$10) - 2009/07/01 7:30:39 ET
Table 'S53kfSbNcK1y2IhnKFrs4g' 6-max Seat #1 is the button
Seat 1: UC0/YZSO2sBe2bJGZ3gn+Q ($1020 in chips)
Seat 3: 1ScqYmNf7/uWx1XSBgPTBw ($165 in chips)
Seat 5: n3h6CD5lzlIEFAqnZ5vkzg ($1374.50 in chips)
Seat 6: 83N3uOHZXXb6QNQOaBGOww ($1613 in chips)
1ScqYmNf7/uWx1XSBgPTBw: posts small blind $5
jkH6qYMpn8JA/IyBOhQPMw: is sitting out
n3h6CD5lzlIEFAqnZ5vkzg: posts big blind $10
*** HOLE CARDS ***
3mTlg4g0FJN2bo939h/0Wg leaves the table
jkH6qYMpn8JA/IyBOhQPMw leaves the table
83N3uOHZXXb6QNQOaBGOww: folds
UC0/YZSO2sBe2bJGZ3gn+Q: raises $20 to $30
1ScqYmNf7/uWx1XSBgPTBw: folds
n3h6CD5lzlIEFAqnZ5vkzg: calls $20
*** FLOP *** [6d Jh Qc]
n3h6CD5lzlIEFAqnZ5vkzg: checks
UC0/YZSO2sBe2bJGZ3gn+Q: checks
*** TURN *** [6d Jh Qc] [Kc]
n3h6CD5lzlIEFAqnZ5vkzg: checks
UC0/YZSO2sBe2bJGZ3gn+Q: checks
*** RIVER *** [6d Jh Qc Kc] [2h]
n3h6CD5lzlIEFAqnZ5vkzg: checks
UC0/YZSO2sBe2bJGZ3gn+Q: checks
*** SHOW DOWN ***
n3h6CD5lzlIEFAqnZ5vkzg: shows [7c 7s] (a pair of Sevens)
UC0/YZSO2sBe2bJGZ3gn+Q: shows [Ts Td] (a pair of Tens)
UC0/YZSO2sBe2bJGZ3gn+Q collected $63 from pot
*** SUMMARY ***
Total pot $65 | Rake $2
Board [6d Jh Qc Kc 2h]
Seat 1: UC0/YZSO2sBe2bJGZ3gn+Q (button) showed [Ts Td] and won ($63) with a pair of Tens
Seat 3: 1ScqYmNf7/uWx1XSBgPTBw (small blind) folded before Flop
Seat 5: n3h6CD5lzlIEFAqnZ5vkzg (big blind) showed [7c 7s] and lost with a pair of Sevens
Seat 6: 83N3uOHZXXb6QNQOaBGOww folded before Flop (didn't bet)



PokerStars Game #59951793946:  Hold'em No Limit ($5/$10) - 2009/07/01 7:30:52 ET
Table 'B7gQa8IrNZTRZX43XhFKUA' 6-max Seat #6 is the button
Seat 1: jkH6qYMpn8JA/IyBOhQPMw ($1005 in chips)
Seat 2: ObR8mkxB7pPf0NUAtp9riQ ($1152 in chips)
Seat 3: 1ScqYmNf7/uWx1XSBgPTBw ($532 in chips)
Seat 4: I1u3BrIcnPwCmkxtD03Q9A ($470 in chips)
Seat 5: BESARbstyvj3tWmTi4s3eg ($786 in chips)
Seat 6: 83N3uOHZXXb6QNQOaBGOww ($1000 in chips)
jkH6qYMpn8JA/IyBOhQPMw: posts small blind $5
ObR8mkxB7pPf0NUAtp9riQ: posts big blind $10
*** HOLE CARDS ***
1ScqYmNf7/uWx1XSBgPTBw: folds
1ScqYmNf7/uWx1XSBgPTBw is sitting out
I1u3BrIcnPwCmkxtD03Q9A: raises $20 to $30
1ScqYmNf7/uWx1XSBgPTBw leaves the table
n3h6CD5lzlIEFAqnZ5vkzg joins the table at seat #3
BESARbstyvj3tWmTi4s3eg: folds
83N3uOHZXXb6QNQOaBGOww: folds
jkH6qYMpn8JA/IyBOhQPMw: folds
ObR8mkxB7pPf0NUAtp9riQ: folds
I1u3BrIcnPwCmkxtD03Q9A collected $25 from pot
*** SUMMARY ***
Total pot $25 | Rake $0
Seat 1: jkH6qYMpn8JA/IyBOhQPMw (small blind) folded before Flop
Seat 2: ObR8mkxB7pPf0NUAtp9riQ (big blind) folded before Flop
Seat 3: 1ScqYmNf7/uWx1XSBgPTBw folded before Flop (didn't bet)
Seat 4: I1u3BrIcnPwCmkxtD03Q9A collected ($25)
Seat 5: BESARbstyvj3tWmTi4s3eg folded before Flop (didn't bet)
Seat 6: 83N3uOHZXXb6QNQOaBGOww (button) folded before Flop (didn't bet)



PokerStars Game #59951796622:  Hold'em No Limit ($5/$10) - 2009/07/01 7:30:57 ET
Table 'vjzKoIBF5FqU9W3OSXU85g' 6-max Seat #6 is the button
Seat 1: 83N3uOHZXXb6QNQOaBGOww ($1000 in chips)
Seat 2: 1ScqYmNf7/uWx1XSBgPTBw ($175 in chips)
Seat 3: e7PupvaIASKltHFJTx+bcQ ($633 in chips)
Seat 4: jkH6qYMpn8JA/IyBOhQPMw ($1254 in chips)
Seat 5: BbirlZJeYiPjSFVvLtEDVw ($1694 in chips)
Seat 6: 3mTlg4g0FJN2bo939h/0Wg ($155 in chips)
83N3uOHZXXb6QNQOaBGOww: posts small blind $5
1ScqYmNf7/uWx1XSBgPTBw: posts big blind $10
*** HOLE CARDS ***
e7PupvaIASKltHFJTx+bcQ: calls $10
jkH6qYMpn8JA/IyBOhQPMw: folds
BbirlZJeYiPjSFVvLtEDVw: folds
3mTlg4g0FJN2bo939h/0Wg: raises $20 to $30
83N3uOHZXXb6QNQOaBGOww: folds
1ScqYmNf7/uWx1XSBgPTBw: folds
e7PupvaIASKltHFJTx+bcQ: calls $20
*** FLOP *** [Ah Jh Kh]
e7PupvaIASKltHFJTx+bcQ: checks
3mTlg4g0FJN2bo939h/0Wg: checks
*** TURN *** [Ah Jh Kh] [7h]
e7PupvaIASKltHFJTx+bcQ: bets $50
3mTlg4g0FJN2bo939h/0Wg: folds
e7PupvaIASKltHFJTx+bcQ collected $72 from pot
*** SUMMARY ***
Total pot $75 | Rake $3
Board [Ah Jh Kh 7h]
Seat 1: 83N3uOHZXXb6QNQOaBGOww (small blind) folded before Flop
Seat 2: 1ScqYmNf7/uWx1XSBgPTBw (big blind) folded before Flop
Seat 3: e7PupvaIASKltHFJTx+bcQ collected ($72)
Seat 4: jkH6qYMpn8JA/IyBOhQPMw folded before Flop (didn't bet)
Seat 5: BbirlZJeYiPjSFVvLtEDVw folded before Flop (didn't bet)
Seat 6: 3mTlg4g0FJN2bo939h/0Wg (button) folded on the Turn



PokerStars Game #59951817044:  Hold'em No Limit ($5/$10) - 2009/07/01 7:31:32 ET
Table 'ZemUU8uyOTYQAgqnaWQDUA' 6-max Seat #1 is the button
Seat 1: 1ScqYmNf7/uWx1XSBgPTBw ($368 in chips)
Seat 3: jkH6qYMpn8JA/IyBOhQPMw ($1020.50 in chips)
Seat 4: n3h6CD5lzlIEFAqnZ5vkzg ($750 in chips)
Seat 6: 3mTlg4g0FJN2bo939h/0Wg ($499 in chips)
jkH6qYMpn8JA/IyBOhQPMw: posts small blind $5
n3h6CD5lzlIEFAqnZ5vkzg: posts big blind $10
*** HOLE CARDS ***
3mTlg4g0FJN2bo939h/0Wg: folds
1ScqYmNf7/uWx1XSBgPTBw: raises $10 to $20
3mTlg4g0FJN2bo939h/0Wg leaves the table
jkH6qYMpn8JA/IyBOhQPMw: folds
n3h6CD5lzlIEFAqnZ5vkzg: folds
1ScqYmNf7/uWx1XSBgPTBw collected $25 from pot
1ScqYmNf7/uWx1XSBgPTBw: doesn't show hand
*** SUMMARY ***
Total pot $25 | Rake $0
Seat 1: 1ScqYmNf7/uWx1XSBgPTBw (button) collected ($25)
Seat 3: jkH6qYMpn8JA/IyBOhQPMw (small blind) folded before Flop
Seat 4: n3h6CD5lzlIEFAqnZ5vkzg (big blind) folded before Flop
Seat 6: 3mTlg4g0FJN2bo939h/0Wg folded before Flop (didn't bet)



PokerStars Game #59951822048:  Hold'em No Limit ($5/$10) - 2009/07/01 7:31:41 ET
Table 'S53kfSbNcK1y2IhnKFrs4g' 6-max Seat #3 is the button
Seat 1: UC0/YZSO2sBe2bJGZ3gn+Q ($1053 in chips)
Seat 3: 1ScqYmNf7/uWx1XSBgPTBw ($160 in chips)
Seat 5: n3h6CD5lzlIEFAqnZ5vkzg ($1344.50 in chips)
Seat 6: 83N3uOHZXXb6QNQOaBGOww ($1613 in chips)
n3h6CD5lzlIEFAqnZ5vkzg: posts small blind $5
83N3uOHZXXb6QNQOaBGOww: posts big blind $10
*** HOLE CARDS ***
UC0/YZSO2sBe2bJGZ3gn+Q: folds
1ScqYmNf7/uWx1XSBgPTBw: folds
n3h6CD5lzlIEFAqnZ5vkzg: folds
83N3uOHZXXb6QNQOaBGOww collected $10 from pot
83N3uOHZXXb6QNQOaBGOww: doesn't show hand
*** SUMMARY ***
Total pot $10 | Rake $0
Seat 1: UC0/YZSO2sBe2bJGZ3gn+Q folded before Flop (didn't bet)
Seat 3: 1ScqYmNf7/uWx1XSBgPTBw (button) folded before Flop (didn't bet)
Seat 5: n3h6CD5lzlIEFAqnZ5vkzg (small blind) folded before Flop
Seat 6: 83N3uOHZXXb6QNQOaBGOww (big blind) collected ($10)



PokerStars Game #59951823026:  Hold'em No Limit ($5/$10) - 2009/07/01 7:31:42 ET
Table 'B7gQa8IrNZTRZX43XhFKUA' 6-max Seat #1 is the button
Seat 1: jkH6qYMpn8JA/IyBOhQPMw ($1000 in chips)
Seat 2: ObR8mkxB7pPf0NUAtp9riQ ($1142 in chips)
Seat 3: n3h6CD5lzlIEFAqnZ5vkzg ($950 in chips)
Seat 4: I1u3BrIcnPwCmkxtD03Q9A ($485 in chips)
Seat 5: BESARbstyvj3tWmTi4s3eg ($786 in chips)
Seat 6: 83N3uOHZXXb6QNQOaBGOww ($1000 in chips)
ObR8mkxB7pPf0NUAtp9riQ: posts small blind $5
I1u3BrIcnPwCmkxtD03Q9A is connected
n3h6CD5lzlIEFAqnZ5vkzg: posts big blind $10
*** HOLE CARDS ***
I1u3BrIcnPwCmkxtD03Q9A: folds
BESARbstyvj3tWmTi4s3eg: raises $20 to $30
83N3uOHZXXb6QNQOaBGOww: folds
jkH6qYMpn8JA/IyBOhQPMw: raises $70 to $100
ObR8mkxB7pPf0NUAtp9riQ: folds
n3h6CD5lzlIEFAqnZ5vkzg: folds
BESARbstyvj3tWmTi4s3eg: folds
jkH6qYMpn8JA/IyBOhQPMw collected $75 from pot
*** SUMMARY ***
Total pot $75 | Rake $0
Seat 1: jkH6qYMpn8JA/IyBOhQPMw (button) collected ($75)
Seat 2: ObR8mkxB7pPf0NUAtp9riQ (small blind) folded before Flop
Seat 3: n3h6CD5lzlIEFAqnZ5vkzg (big blind) folded before Flop
Seat 4: I1u3BrIcnPwCmkxtD03Q9A folded before Flop (didn't bet)
Seat 5: BESARbstyvj3tWmTi4s3eg folded before Flop
Seat 6: 83N3uOHZXXb6QNQOaBGOww folded before Flop (didn't bet)



PokerStars Game #59951826296:  Hold'em No Limit ($5/$10) - 2009/07/01 7:31:48 ET
Table 'vjzKoIBF5FqU9W3OSXU85g' 6-max Seat #1 is the button
Seat 1: 83N3uOHZXXb6QNQOaBGOww ($1000 in chips)
Seat 2: 1ScqYmNf7/uWx1XSBgPTBw ($165 in chips)
Seat 3: e7PupvaIASKltHFJTx+bcQ ($675 in chips)
Seat 4: jkH6qYMpn8JA/IyBOhQPMw ($1254 in chips)
Seat 5: BbirlZJeYiPjSFVvLtEDVw ($1694 in chips)
Seat 6: 3mTlg4g0FJN2bo939h/0Wg ($125 in chips)
1ScqYmNf7/uWx1XSBgPTBw: posts small blind $5
e7PupvaIASKltHFJTx+bcQ: posts big blind $10
*** HOLE CARDS ***
jkH6qYMpn8JA/IyBOhQPMw: folds
BbirlZJeYiPjSFVvLtEDVw: folds
3mTlg4g0FJN2bo939h/0Wg: raises $20 to $30
83N3uOHZXXb6QNQOaBGOww: folds
1ScqYmNf7/uWx1XSBgPTBw: raises $135 to $165 and is all-in
e7PupvaIASKltHFJTx+bcQ: folds
e7PupvaIASKltHFJTx+bcQ is sitting out
3mTlg4g0FJN2bo939h/0Wg: calls $95 and is all-in
e7PupvaIASKltHFJTx+bcQ leaves the table
*** FLOP *** [9s Ad Jh]
*** TURN *** [9s Ad Jh] [6d]
*** RIVER *** [9s Ad Jh 6d] [4d]
*** SHOW DOWN ***
1ScqYmNf7/uWx1XSBgPTBw: shows [Qd Kd] (a flush, Ace high)
3mTlg4g0FJN2bo939h/0Wg: mucks hand
1ScqYmNf7/uWx1XSBgPTBw collected $257 from pot
*** SUMMARY ***
Total pot $260 | Rake $3
Board [9s Ad Jh 6d 4d]
Seat 1: 83N3uOHZXXb6QNQOaBGOww (button) folded before Flop (didn't bet)
Seat 2: 1ScqYmNf7/uWx1XSBgPTBw (small blind) showed [Qd Kd] and won ($257) with a flush, Ace high
Seat 3: e7PupvaIASKltHFJTx+bcQ (big blind) folded before Flop
Seat 4: jkH6qYMpn8JA/IyBOhQPMw folded before Flop (didn't bet)
Seat 5: BbirlZJeYiPjSFVvLtEDVw folded before Flop (didn't bet)
Seat 6: 3mTlg4g0FJN2bo939h/0Wg mucked



PokerStars Game #59951852716:  Hold'em No Limit ($5/$10) - 2009/07/01 7:32:33 ET
Table 'vjzKoIBF5FqU9W3OSXU85g' 6-max Seat #2 is the button
Seat 1: 83N3uOHZXXb6QNQOaBGOww ($1000 in chips)
Seat 2: 1ScqYmNf7/uWx1XSBgPTBw ($297 in chips)
Seat 4: jkH6qYMpn8JA/IyBOhQPMw ($1254 in chips)
Seat 5: BbirlZJeYiPjSFVvLtEDVw ($1694 in chips)
jkH6qYMpn8JA/IyBOhQPMw: posts small blind $5
BbirlZJeYiPjSFVvLtEDVw: posts big blind $10
*** HOLE CARDS ***
83N3uOHZXXb6QNQOaBGOww: raises $20 to $30
1ScqYmNf7/uWx1XSBgPTBw: folds
jkH6qYMpn8JA/IyBOhQPMw: folds
BbirlZJeYiPjSFVvLtEDVw: folds
83N3uOHZXXb6QNQOaBGOww collected $25 from pot
*** SUMMARY ***
Total pot $25 | Rake $0
Seat 1: 83N3uOHZXXb6QNQOaBGOww collected ($25)
Seat 2: 1ScqYmNf7/uWx1XSBgPTBw (button) folded before Flop (didn't bet)
Seat 4: jkH6qYMpn8JA/IyBOhQPMw (small blind) folded before Flop
Seat 5: BbirlZJeYiPjSFVvLtEDVw (big blind) folded before Flop



PokerStars Game #59951861928:  Hold'em No Limit ($5/$10) - 2009/07/01 7:32:49 ET
Table 'B7gQa8IrNZTRZX43XhFKUA' 6-max Seat #2 is the button
Seat 1: jkH6qYMpn8JA/IyBOhQPMw ($1045 in chips)
Seat 2: ObR8mkxB7pPf0NUAtp9riQ ($1137 in chips)
Seat 3: n3h6CD5lzlIEFAqnZ5vkzg ($940 in chips)
Seat 4: I1u3BrIcnPwCmkxtD03Q9A ($485 in chips)
Seat 5: BESARbstyvj3tWmTi4s3eg ($756 in chips)
Seat 6: 83N3uOHZXXb6QNQOaBGOww ($1000 in chips)
n3h6CD5lzlIEFAqnZ5vkzg: posts small blind $5
I1u3BrIcnPwCmkxtD03Q9A: posts big blind $10
*** HOLE CARDS ***
BESARbstyvj3tWmTi4s3eg: folds
83N3uOHZXXb6QNQOaBGOww: folds
jkH6qYMpn8JA/IyBOhQPMw: raises $20 to $30
ObR8mkxB7pPf0NUAtp9riQ: raises $70 to $100
n3h6CD5lzlIEFAqnZ5vkzg: folds
I1u3BrIcnPwCmkxtD03Q9A: folds
jkH6qYMpn8JA/IyBOhQPMw: raises $145 to $245
ObR8mkxB7pPf0NUAtp9riQ: raises $421 to $666
jkH6qYMpn8JA/IyBOhQPMw: folds
ObR8mkxB7pPf0NUAtp9riQ collected $505 from pot
*** SUMMARY ***
Total pot $505 | Rake $0
Seat 1: jkH6qYMpn8JA/IyBOhQPMw folded before Flop
Seat 2: ObR8mkxB7pPf0NUAtp9riQ (button) collected ($505)
Seat 3: n3h6CD5lzlIEFAqnZ5vkzg (small blind) folded before Flop
Seat 4: I1u3BrIcnPwCmkxtD03Q9A (big blind) folded before Flop
Seat 5: BESARbstyvj3tWmTi4s3eg folded before Flop (didn't bet)
Seat 6: 83N3uOHZXXb6QNQOaBGOww folded before Flop (didn't bet)



PokerStars Game #59951918026:  Hold'em No Limit ($5/$10) - 2009/07/01 7:34:26 ET
Table 'B7gQa8IrNZTRZX43XhFKUA' 6-max Seat #3 is the button
Seat 1: jkH6qYMpn8JA/IyBOhQPMw ($1000 in chips)
Seat 2: ObR8mkxB7pPf0NUAtp9riQ ($1397 in chips)
Seat 3: n3h6CD5lzlIEFAqnZ5vkzg ($935 in chips)
Seat 4: I1u3BrIcnPwCmkxtD03Q9A ($475 in chips)
Seat 5: BESARbstyvj3tWmTi4s3eg ($756 in chips)
Seat 6: 83N3uOHZXXb6QNQOaBGOww ($1000 in chips)
I1u3BrIcnPwCmkxtD03Q9A: posts small blind $5
BESARbstyvj3tWmTi4s3eg: posts big blind $10
*** HOLE CARDS ***
83N3uOHZXXb6QNQOaBGOww: folds
jkH6qYMpn8JA/IyBOhQPMw: folds
ObR8mkxB7pPf0NUAtp9riQ: folds
n3h6CD5lzlIEFAqnZ5vkzg: folds
I1u3BrIcnPwCmkxtD03Q9A: raises $20 to $30
BESARbstyvj3tWmTi4s3eg: calls $20
*** FLOP *** [5s 8s 2d]
I1u3BrIcnPwCmkxtD03Q9A: bets $50
BESARbstyvj3tWmTi4s3eg: folds
I1u3BrIcnPwCmkxtD03Q9A collected $57 from pot
*** SUMMARY ***
Total pot $60 | Rake $3
Board [5s 8s 2d]
Seat 1: jkH6qYMpn8JA/IyBOhQPMw folded before Flop (didn't bet)
Seat 2: ObR8mkxB7pPf0NUAtp9riQ folded before Flop (didn't bet)
Seat 3: n3h6CD5lzlIEFAqnZ5vkzg (button) folded before Flop (didn't bet)
Seat 4: I1u3BrIcnPwCmkxtD03Q9A (small blind) collected ($57)
Seat 5: BESARbstyvj3tWmTi4s3eg (big blind) folded on the Flop
Seat 6: 83N3uOHZXXb6QNQOaBGOww folded before Flop (didn't bet)



PokerStars Game #59951953468:  Hold'em No Limit ($5/$10) - 2009/07/01 7:35:27 ET
Table 'B7gQa8IrNZTRZX43XhFKUA' 6-max Seat #4 is the button
Seat 1: jkH6qYMpn8JA/IyBOhQPMw ($1000 in chips)
Seat 2: ObR8mkxB7pPf0NUAtp9riQ ($1397 in chips)
Seat 3: n3h6CD5lzlIEFAqnZ5vkzg ($935 in chips)
Seat 4: I1u3BrIcnPwCmkxtD03Q9A ($502 in chips)
Seat 5: BESARbstyvj3tWmTi4s3eg ($726 in chips)
Seat 6: 83N3uOHZXXb6QNQOaBGOww ($1000 in chips)
BESARbstyvj3tWmTi4s3eg: posts small blind $5
83N3uOHZXXb6QNQOaBGOww: posts big blind $10
*** HOLE CARDS ***
jkH6qYMpn8JA/IyBOhQPMw: raises $20 to $30
ObR8mkxB7pPf0NUAtp9riQ: folds
n3h6CD5lzlIEFAqnZ5vkzg: folds
I1u3BrIcnPwCmkxtD03Q9A: folds
BESARbstyvj3tWmTi4s3eg: folds
83N3uOHZXXb6QNQOaBGOww: raises $70 to $100
jkH6qYMpn8JA/IyBOhQPMw: folds
83N3uOHZXXb6QNQOaBGOww collected $65 from pot
*** SUMMARY ***
Total pot $65 | Rake $0
Seat 1: jkH6qYMpn8JA/IyBOhQPMw folded before Flop
Seat 2: ObR8mkxB7pPf0NUAtp9riQ folded before Flop (didn't bet)
Seat 3: n3h6CD5lzlIEFAqnZ5vkzg folded before Flop (didn't bet)
Seat 4: I1u3BrIcnPwCmkxtD03Q9A (button) folded before Flop (didn't bet)
Seat 5: BESARbstyvj3tWmTi4s3eg (small blind) folded before Flop
Seat 6: 83N3uOHZXXb6QNQOaBGOww (big blind) collected ($65)



PokerStars Game #59951972398:  Hold'em No Limit ($5/$10) - 2009/07/01 7:36:00 ET
Table 'B7gQa8IrNZTRZX43XhFKUA' 6-max Seat #5 is the button
Seat 1: jkH6qYMpn8JA/IyBOhQPMw ($1000 in chips)
Seat 2: ObR8mkxB7pPf0NUAtp9riQ ($1397 in chips)
Seat 3: n3h6CD5lzlIEFAqnZ5vkzg ($935 in chips)
Seat 4: I1u3BrIcnPwCmkxtD03Q9A ($502 in chips)
Seat 5: BESARbstyvj3tWmTi4s3eg ($721 in chips)
Seat 6: 83N3uOHZXXb6QNQOaBGOww ($1035 in chips)
83N3uOHZXXb6QNQOaBGOww: posts small blind $5
jkH6qYMpn8JA/IyBOhQPMw: posts big blind $10
*** HOLE CARDS ***
ObR8mkxB7pPf0NUAtp9riQ: folds
n3h6CD5lzlIEFAqnZ5vkzg: folds
I1u3BrIcnPwCmkxtD03Q9A: raises $20 to $30
ObR8mkxB7pPf0NUAtp9riQ is connected
BESARbstyvj3tWmTi4s3eg: folds
83N3uOHZXXb6QNQOaBGOww: folds
ObR8mkxB7pPf0NUAtp9riQ is disconnected
jkH6qYMpn8JA/IyBOhQPMw: calls $20
*** FLOP *** [4s 5d 9h]
ObR8mkxB7pPf0NUAtp9riQ is connected
jkH6qYMpn8JA/IyBOhQPMw: checks
I1u3BrIcnPwCmkxtD03Q9A: bets $40
jkH6qYMpn8JA/IyBOhQPMw: folds
I1u3BrIcnPwCmkxtD03Q9A collected $62 from pot
*** SUMMARY ***
Total pot $65 | Rake $3
Board [4s 5d 9h]
Seat 1: jkH6qYMpn8JA/IyBOhQPMw (big blind) folded on the Flop
Seat 2: ObR8mkxB7pPf0NUAtp9riQ folded before Flop (didn't bet)
Seat 3: n3h6CD5lzlIEFAqnZ5vkzg folded before Flop (didn't bet)
Seat 4: I1u3BrIcnPwCmkxtD03Q9A collected ($62)
Seat 5: BESARbstyvj3tWmTi4s3eg (button) folded before Flop (didn't bet)
Seat 6: 83N3uOHZXXb6QNQOaBGOww (small blind) folded before Flop



PokerStars Game #59952014608:  Hold'em No Limit ($5/$10) - 2009/07/01 7:37:12 ET
Table 'B7gQa8IrNZTRZX43XhFKUA' 6-max Seat #6 is the button
Seat 1: jkH6qYMpn8JA/IyBOhQPMw ($1000 in chips)
Seat 2: ObR8mkxB7pPf0NUAtp9riQ ($1397 in chips)
Seat 3: n3h6CD5lzlIEFAqnZ5vkzg ($935 in chips)
Seat 4: I1u3BrIcnPwCmkxtD03Q9A ($534 in chips)
Seat 5: BESARbstyvj3tWmTi4s3eg ($721 in chips)
Seat 6: 83N3uOHZXXb6QNQOaBGOww ($1030 in chips)
jkH6qYMpn8JA/IyBOhQPMw: posts small blind $5
ObR8mkxB7pPf0NUAtp9riQ: posts big blind $10
*** HOLE CARDS ***
n3h6CD5lzlIEFAqnZ5vkzg: folds
I1u3BrIcnPwCmkxtD03Q9A: raises $20 to $30
BESARbstyvj3tWmTi4s3eg: raises $120 to $150
83N3uOHZXXb6QNQOaBGOww: folds
jkH6qYMpn8JA/IyBOhQPMw: folds
ObR8mkxB7pPf0NUAtp9riQ: folds
I1u3BrIcnPwCmkxtD03Q9A: folds
BESARbstyvj3tWmTi4s3eg collected $75 from pot
*** SUMMARY ***
Total pot $75 | Rake $0
Seat 1: jkH6qYMpn8JA/IyBOhQPMw (small blind) folded before Flop
Seat 2: ObR8mkxB7pPf0NUAtp9riQ (big blind) folded before Flop
Seat 3: n3h6CD5lzlIEFAqnZ5vkzg folded before Flop (didn't bet)
Seat 4: I1u3BrIcnPwCmkxtD03Q9A folded before Flop
Seat 5: BESARbstyvj3tWmTi4s3eg collected ($75)
Seat 6: 83N3uOHZXXb6QNQOaBGOww (button) folded before Flop (didn't bet)



PokerStars Game #59952035688:  Hold'em No Limit ($5/$10) - 2009/07/01 7:37:49 ET
Table 'B7gQa8IrNZTRZX43XhFKUA' 6-max Seat #1 is the button
Seat 1: jkH6qYMpn8JA/IyBOhQPMw ($1000 in chips)
Seat 2: ObR8mkxB7pPf0NUAtp9riQ ($1387 in chips)
Seat 3: n3h6CD5lzlIEFAqnZ5vkzg ($935 in chips)
Seat 4: I1u3BrIcnPwCmkxtD03Q9A ($504 in chips)
Seat 5: BESARbstyvj3tWmTi4s3eg ($766 in chips)
Seat 6: 83N3uOHZXXb6QNQOaBGOww ($1030 in chips)
ObR8mkxB7pPf0NUAtp9riQ: posts small blind $5
n3h6CD5lzlIEFAqnZ5vkzg: posts big blind $10
*** HOLE CARDS ***
I1u3BrIcnPwCmkxtD03Q9A: folds
BESARbstyvj3tWmTi4s3eg: folds
83N3uOHZXXb6QNQOaBGOww: folds
jkH6qYMpn8JA/IyBOhQPMw: folds
ObR8mkxB7pPf0NUAtp9riQ: folds
n3h6CD5lzlIEFAqnZ5vkzg collected $10 from pot
*** SUMMARY ***
Total pot $10 | Rake $0
Seat 1: jkH6qYMpn8JA/IyBOhQPMw (button) folded before Flop (didn't bet)
Seat 2: ObR8mkxB7pPf0NUAtp9riQ (small blind) folded before Flop
Seat 3: n3h6CD5lzlIEFAqnZ5vkzg (big blind) collected ($10)
Seat 4: I1u3BrIcnPwCmkxtD03Q9A folded before Flop (didn't bet)
Seat 5: BESARbstyvj3tWmTi4s3eg folded before Flop (didn't bet)
Seat 6: 83N3uOHZXXb6QNQOaBGOww folded before Flop (didn't bet)



PokerStars Game #59952514532:  Hold'em No Limit ($5/$10) - 2009/07/01 7:51:34 ET
Table 'B7gQa8IrNZTRZX43XhFKUA' 6-max Seat #1 is the button
Seat 1: jkH6qYMpn8JA/IyBOhQPMw ($1000 in chips)
Seat 2: ObR8mkxB7pPf0NUAtp9riQ ($1543 in chips)
Seat 3: n3h6CD5lzlIEFAqnZ5vkzg ($1379 in chips)
Seat 4: I1u3BrIcnPwCmkxtD03Q9A ($264 in chips)
Seat 5: BbirlZJeYiPjSFVvLtEDVw ($2486.10 in chips)
Seat 6: 83N3uOHZXXb6QNQOaBGOww ($1000 in chips)
ObR8mkxB7pPf0NUAtp9riQ: posts small blind $5
n3h6CD5lzlIEFAqnZ5vkzg: posts big blind $10
*** HOLE CARDS ***
I1u3BrIcnPwCmkxtD03Q9A is disconnected
I1u3BrIcnPwCmkxtD03Q9A is connected
I1u3BrIcnPwCmkxtD03Q9A: folds
BbirlZJeYiPjSFVvLtEDVw: folds
83N3uOHZXXb6QNQOaBGOww: folds
jkH6qYMpn8JA/IyBOhQPMw: folds
ObR8mkxB7pPf0NUAtp9riQ: raises $30 to $40
n3h6CD5lzlIEFAqnZ5vkzg: raises $100 to $140
ObR8mkxB7pPf0NUAtp9riQ: folds
n3h6CD5lzlIEFAqnZ5vkzg collected $80 from pot
n3h6CD5lzlIEFAqnZ5vkzg: doesn't show hand
*** SUMMARY ***
Total pot $80 | Rake $0
Seat 1: jkH6qYMpn8JA/IyBOhQPMw (button) folded before Flop (didn't bet)
Seat 2: ObR8mkxB7pPf0NUAtp9riQ (small blind) folded before Flop
Seat 3: n3h6CD5lzlIEFAqnZ5vkzg (big blind) collected ($80)
Seat 4: I1u3BrIcnPwCmkxtD03Q9A folded before Flop (didn't bet)
Seat 5: BbirlZJeYiPjSFVvLtEDVw folded before Flop (didn't bet)
Seat 6: 83N3uOHZXXb6QNQOaBGOww folded before Flop (didn't bet)



PokerStars Game #59952560338:  Hold'em No Limit ($5/$10) - 2009/07/01 7:52:51 ET
Table 'B7gQa8IrNZTRZX43XhFKUA' 6-max Seat #2 is the button
Seat 1: jkH6qYMpn8JA/IyBOhQPMw ($1000 in chips)
Seat 2: ObR8mkxB7pPf0NUAtp9riQ ($1503 in chips)
Seat 3: n3h6CD5lzlIEFAqnZ5vkzg ($1419 in chips)
Seat 4: I1u3BrIcnPwCmkxtD03Q9A ($264 in chips)
Seat 5: BbirlZJeYiPjSFVvLtEDVw ($2486.10 in chips)
Seat 6: 83N3uOHZXXb6QNQOaBGOww ($1000 in chips)
n3h6CD5lzlIEFAqnZ5vkzg: posts small blind $5
I1u3BrIcnPwCmkxtD03Q9A: posts big blind $10
*** HOLE CARDS ***
BbirlZJeYiPjSFVvLtEDVw: folds
83N3uOHZXXb6QNQOaBGOww: folds
jkH6qYMpn8JA/IyBOhQPMw: raises $20 to $30
ObR8mkxB7pPf0NUAtp9riQ: calls $30
n3h6CD5lzlIEFAqnZ5vkzg: folds
I1u3BrIcnPwCmkxtD03Q9A: folds
*** FLOP *** [6c Td Ac]
jkH6qYMpn8JA/IyBOhQPMw: bets $52
ObR8mkxB7pPf0NUAtp9riQ is connected
ObR8mkxB7pPf0NUAtp9riQ: folds
jkH6qYMpn8JA/IyBOhQPMw collected $72 from pot
*** SUMMARY ***
Total pot $75 | Rake $3
Board [6c Td Ac]
Seat 1: jkH6qYMpn8JA/IyBOhQPMw collected ($72)
Seat 2: ObR8mkxB7pPf0NUAtp9riQ (button) folded on the Flop
Seat 3: n3h6CD5lzlIEFAqnZ5vkzg (small blind) folded before Flop
Seat 4: I1u3BrIcnPwCmkxtD03Q9A (big blind) folded before Flop
Seat 5: BbirlZJeYiPjSFVvLtEDVw folded before Flop (didn't bet)
Seat 6: 83N3uOHZXXb6QNQOaBGOww folded before Flop (didn't bet)



PokerStars Game #59952606250:  Hold'em No Limit ($5/$10) - 2009/07/01 7:54:10 ET
Table 'B7gQa8IrNZTRZX43XhFKUA' 6-max Seat #3 is the button
Seat 1: jkH6qYMpn8JA/IyBOhQPMw ($1042 in chips)
Seat 2: ObR8mkxB7pPf0NUAtp9riQ ($1473 in chips)
Seat 3: n3h6CD5lzlIEFAqnZ5vkzg ($1414 in chips)
Seat 4: I1u3BrIcnPwCmkxtD03Q9A ($254 in chips)
Seat 5: BbirlZJeYiPjSFVvLtEDVw ($2486.10 in chips)
Seat 6: 83N3uOHZXXb6QNQOaBGOww ($1000 in chips)
I1u3BrIcnPwCmkxtD03Q9A: posts small blind $5
BbirlZJeYiPjSFVvLtEDVw: posts big blind $10
*** HOLE CARDS ***
83N3uOHZXXb6QNQOaBGOww: folds
jkH6qYMpn8JA/IyBOhQPMw: folds
ObR8mkxB7pPf0NUAtp9riQ: folds
n3h6CD5lzlIEFAqnZ5vkzg: folds
I1u3BrIcnPwCmkxtD03Q9A: folds
BbirlZJeYiPjSFVvLtEDVw collected $10 from pot
*** SUMMARY ***
Total pot $10 | Rake $0
Seat 1: jkH6qYMpn8JA/IyBOhQPMw folded before Flop (didn't bet)
Seat 2: ObR8mkxB7pPf0NUAtp9riQ folded before Flop (didn't bet)
Seat 3: n3h6CD5lzlIEFAqnZ5vkzg (button) folded before Flop (didn't bet)
Seat 4: I1u3BrIcnPwCmkxtD03Q9A (small blind) folded before Flop
Seat 5: BbirlZJeYiPjSFVvLtEDVw (big blind) collected ($10)
Seat 6: 83N3uOHZXXb6QNQOaBGOww folded before Flop (didn't bet)



PokerStars Game #59952623296:  Hold'em No Limit ($5/$10) - 2009/07/01 7:54:39 ET
Table 'B7gQa8IrNZTRZX43XhFKUA' 6-max Seat #4 is the button
Seat 1: jkH6qYMpn8JA/IyBOhQPMw ($1042 in chips)
Seat 2: ObR8mkxB7pPf0NUAtp9riQ ($1473 in chips)
Seat 3: n3h6CD5lzlIEFAqnZ5vkzg ($1414 in chips)
Seat 4: I1u3BrIcnPwCmkxtD03Q9A ($249 in chips)
Seat 5: BbirlZJeYiPjSFVvLtEDVw ($2491.10 in chips)
Seat 6: 83N3uOHZXXb6QNQOaBGOww ($1000 in chips)
BbirlZJeYiPjSFVvLtEDVw: posts small blind $5
83N3uOHZXXb6QNQOaBGOww: posts big blind $10
*** HOLE CARDS ***
jkH6qYMpn8JA/IyBOhQPMw: raises $20 to $30
ObR8mkxB7pPf0NUAtp9riQ: folds
n3h6CD5lzlIEFAqnZ5vkzg: folds
I1u3BrIcnPwCmkxtD03Q9A: calls $30
BbirlZJeYiPjSFVvLtEDVw: folds
83N3uOHZXXb6QNQOaBGOww: folds
*** FLOP *** [9s 2c 6d]
jkH6qYMpn8JA/IyBOhQPMw: checks
I1u3BrIcnPwCmkxtD03Q9A: bets $40
jkH6qYMpn8JA/IyBOhQPMw: folds
I1u3BrIcnPwCmkxtD03Q9A collected $72 from pot
*** SUMMARY ***
Total pot $75 | Rake $3
Board [9s 2c 6d]
Seat 1: jkH6qYMpn8JA/IyBOhQPMw folded on the Flop
Seat 2: ObR8mkxB7pPf0NUAtp9riQ folded before Flop (didn't bet)
Seat 3: n3h6CD5lzlIEFAqnZ5vkzg folded before Flop (didn't bet)
Seat 4: I1u3BrIcnPwCmkxtD03Q9A (button) collected ($72)
Seat 5: BbirlZJeYiPjSFVvLtEDVw (small blind) folded before Flop
Seat 6: 83N3uOHZXXb6QNQOaBGOww (big blind) folded before Flop



PokerStars Game #59952649832:  Hold'em No Limit ($5/$10) - 2009/07/01 7:55:23 ET
Table 'B7gQa8IrNZTRZX43XhFKUA' 6-max Seat #5 is the button
Seat 1: jkH6qYMpn8JA/IyBOhQPMw ($1012 in chips)
Seat 2: ObR8mkxB7pPf0NUAtp9riQ ($1473 in chips)
Seat 3: n3h6CD5lzlIEFAqnZ5vkzg ($1414 in chips)
Seat 4: I1u3BrIcnPwCmkxtD03Q9A ($291 in chips)
Seat 5: BbirlZJeYiPjSFVvLtEDVw ($2486.10 in chips)
Seat 6: 83N3uOHZXXb6QNQOaBGOww ($1000 in chips)
83N3uOHZXXb6QNQOaBGOww: posts small blind $5
jkH6qYMpn8JA/IyBOhQPMw: posts big blind $10
*** HOLE CARDS ***
ObR8mkxB7pPf0NUAtp9riQ: folds
n3h6CD5lzlIEFAqnZ5vkzg: raises $20 to $30
I1u3BrIcnPwCmkxtD03Q9A: folds
BbirlZJeYiPjSFVvLtEDVw: folds
83N3uOHZXXb6QNQOaBGOww: folds
jkH6qYMpn8JA/IyBOhQPMw: folds
n3h6CD5lzlIEFAqnZ5vkzg collected $25 from pot
*** SUMMARY ***
Total pot $25 | Rake $0
Seat 1: jkH6qYMpn8JA/IyBOhQPMw (big blind) folded before Flop
Seat 2: ObR8mkxB7pPf0NUAtp9riQ folded before Flop (didn't bet)
Seat 3: n3h6CD5lzlIEFAqnZ5vkzg collected ($25)
Seat 4: I1u3BrIcnPwCmkxtD03Q9A folded before Flop (didn't bet)
Seat 5: BbirlZJeYiPjSFVvLtEDVw (button) folded before Flop (didn't bet)
Seat 6: 83N3uOHZXXb6QNQOaBGOww (small blind) folded before Flop



PokerStars Game #59952667018:  Hold'em No Limit ($5/$10) - 2009/07/01 7:55:53 ET
Table 'B7gQa8IrNZTRZX43XhFKUA' 6-max Seat #6 is the button
Seat 1: jkH6qYMpn8JA/IyBOhQPMw ($1002 in chips)
Seat 2: ObR8mkxB7pPf0NUAtp9riQ ($1473 in chips)
Seat 3: n3h6CD5lzlIEFAqnZ5vkzg ($1429 in chips)
Seat 4: I1u3BrIcnPwCmkxtD03Q9A ($291 in chips)
Seat 5: BbirlZJeYiPjSFVvLtEDVw ($2486.10 in chips)
Seat 6: 83N3uOHZXXb6QNQOaBGOww ($1000 in chips)
jkH6qYMpn8JA/IyBOhQPMw: posts small blind $5
ObR8mkxB7pPf0NUAtp9riQ: posts big blind $10
*** HOLE CARDS ***
n3h6CD5lzlIEFAqnZ5vkzg: folds
I1u3BrIcnPwCmkxtD03Q9A: raises $20 to $30
BbirlZJeYiPjSFVvLtEDVw: folds
83N3uOHZXXb6QNQOaBGOww: folds
jkH6qYMpn8JA/IyBOhQPMw: folds
ObR8mkxB7pPf0NUAtp9riQ is disconnected
ObR8mkxB7pPf0NUAtp9riQ is connected
ObR8mkxB7pPf0NUAtp9riQ: folds
I1u3BrIcnPwCmkxtD03Q9A collected $25 from pot
*** SUMMARY ***
Total pot $25 | Rake $0
Seat 1: jkH6qYMpn8JA/IyBOhQPMw (small blind) folded before Flop
Seat 2: ObR8mkxB7pPf0NUAtp9riQ (big blind) folded before Flop
Seat 3: n3h6CD5lzlIEFAqnZ5vkzg folded before Flop (didn't bet)
Seat 4: I1u3BrIcnPwCmkxtD03Q9A collected ($25)
Seat 5: BbirlZJeYiPjSFVvLtEDVw folded before Flop (didn't bet)
Seat 6: 83N3uOHZXXb6QNQOaBGOww (button) folded before Flop (didn't bet)



PokerStars Game #59952700444:  Hold'em No Limit ($5/$10) - 2009/07/01 7:56:50 ET
Table 'B7gQa8IrNZTRZX43XhFKUA' 6-max Seat #1 is the button
Seat 1: jkH6qYMpn8JA/IyBOhQPMw ($1000 in chips)
Seat 2: ObR8mkxB7pPf0NUAtp9riQ ($1463 in chips)
Seat 3: n3h6CD5lzlIEFAqnZ5vkzg ($1429 in chips)
Seat 4: I1u3BrIcnPwCmkxtD03Q9A ($306 in chips)
Seat 5: BbirlZJeYiPjSFVvLtEDVw ($2486.10 in chips)
Seat 6: 83N3uOHZXXb6QNQOaBGOww ($1000 in chips)
ObR8mkxB7pPf0NUAtp9riQ: posts small blind $5
n3h6CD5lzlIEFAqnZ5vkzg: posts big blind $10
*** HOLE CARDS ***
I1u3BrIcnPwCmkxtD03Q9A: raises $20 to $30
BbirlZJeYiPjSFVvLtEDVw: folds
83N3uOHZXXb6QNQOaBGOww: folds
jkH6qYMpn8JA/IyBOhQPMw: folds
ObR8mkxB7pPf0NUAtp9riQ: folds
n3h6CD5lzlIEFAqnZ5vkzg: folds
I1u3BrIcnPwCmkxtD03Q9A collected $25 from pot
*** SUMMARY ***
Total pot $25 | Rake $0
Seat 1: jkH6qYMpn8JA/IyBOhQPMw (button) folded before Flop (didn't bet)
Seat 2: ObR8mkxB7pPf0NUAtp9riQ (small blind) folded before Flop
Seat 3: n3h6CD5lzlIEFAqnZ5vkzg (big blind) folded before Flop
Seat 4: I1u3BrIcnPwCmkxtD03Q9A collected ($25)
Seat 5: BbirlZJeYiPjSFVvLtEDVw folded before Flop (didn't bet)
Seat 6: 83N3uOHZXXb6QNQOaBGOww folded before Flop (didn't bet)



PokerStars Game #59952720814:  Hold'em No Limit ($5/$10) - 2009/07/01 7:57:24 ET
Table 'B7gQa8IrNZTRZX43XhFKUA' 6-max Seat #2 is the button
Seat 1: jkH6qYMpn8JA/IyBOhQPMw ($1000 in chips)
Seat 2: ObR8mkxB7pPf0NUAtp9riQ ($1458 in chips)
Seat 3: n3h6CD5lzlIEFAqnZ5vkzg ($1419 in chips)
Seat 5: BbirlZJeYiPjSFVvLtEDVw ($2486.10 in chips)
Seat 6: 83N3uOHZXXb6QNQOaBGOww ($1000 in chips)
n3h6CD5lzlIEFAqnZ5vkzg: posts small blind $5
I1u3BrIcnPwCmkxtD03Q9A: is sitting out
I1u3BrIcnPwCmkxtD03Q9A leaves the table
BbirlZJeYiPjSFVvLtEDVw: posts big blind $10
*** HOLE CARDS ***
83N3uOHZXXb6QNQOaBGOww: folds
jkH6qYMpn8JA/IyBOhQPMw: folds
ObR8mkxB7pPf0NUAtp9riQ is disconnected
ObR8mkxB7pPf0NUAtp9riQ has timed out while disconnected
ObR8mkxB7pPf0NUAtp9riQ: folds
ObR8mkxB7pPf0NUAtp9riQ is sitting out
n3h6CD5lzlIEFAqnZ5vkzg: folds
BbirlZJeYiPjSFVvLtEDVw collected $10 from pot
*** SUMMARY ***
Total pot $10 | Rake $0
Seat 1: jkH6qYMpn8JA/IyBOhQPMw folded before Flop (didn't bet)
Seat 2: ObR8mkxB7pPf0NUAtp9riQ (button) folded before Flop (didn't bet)
Seat 3: n3h6CD5lzlIEFAqnZ5vkzg (small blind) folded before Flop
Seat 5: BbirlZJeYiPjSFVvLtEDVw (big blind) collected ($10)
Seat 6: 83N3uOHZXXb6QNQOaBGOww folded before Flop (didn't bet)



PokerStars Game #59952753894:  Hold'em No Limit ($5/$10) - 2009/07/01 7:58:21 ET
Table 'B7gQa8IrNZTRZX43XhFKUA' 6-max Seat #3 is the button
Seat 1: jkH6qYMpn8JA/IyBOhQPMw ($1000 in chips)
Seat 3: n3h6CD5lzlIEFAqnZ5vkzg ($1414 in chips)
Seat 5: BbirlZJeYiPjSFVvLtEDVw ($2491.10 in chips)
Seat 6: 83N3uOHZXXb6QNQOaBGOww ($1000 in chips)
BbirlZJeYiPjSFVvLtEDVw: posts small blind $5
83N3uOHZXXb6QNQOaBGOww: posts big blind $10
*** HOLE CARDS ***
ObR8mkxB7pPf0NUAtp9riQ is connected
jkH6qYMpn8JA/IyBOhQPMw: raises $20 to $30
n3h6CD5lzlIEFAqnZ5vkzg: raises $70 to $100
BbirlZJeYiPjSFVvLtEDVw: folds
83N3uOHZXXb6QNQOaBGOww: folds
jkH6qYMpn8JA/IyBOhQPMw: calls $70
*** FLOP *** [2d Td 9s]
jkH6qYMpn8JA/IyBOhQPMw: checks
n3h6CD5lzlIEFAqnZ5vkzg: bets $140
jkH6qYMpn8JA/IyBOhQPMw: folds
n3h6CD5lzlIEFAqnZ5vkzg collected $213 from pot
*** SUMMARY ***
Total pot $215 | Rake $2
Board [2d Td 9s]
Seat 1: jkH6qYMpn8JA/IyBOhQPMw folded on the Flop
Seat 3: n3h6CD5lzlIEFAqnZ5vkzg (button) collected ($213)
Seat 5: BbirlZJeYiPjSFVvLtEDVw (small blind) folded before Flop
Seat 6: 83N3uOHZXXb6QNQOaBGOww (big blind) folded before Flop



PokerStars Game #59954668126:  Hold'em No Limit ($5/$10) - 2009/07/01 8:45:14 ET
Table 'ZBmu0cAiV+H0nkZCGN43DQ' 2-max Seat #1 is the button
Seat 1: afWGNf/WBEpJ7XTIK3WoTw ($456.50 in chips)
Seat 2: IpDViWUJYXS6u+b2OxDwhQ ($347 in chips)
afWGNf/WBEpJ7XTIK3WoTw: posts small blind $5
IpDViWUJYXS6u+b2OxDwhQ: posts big blind $10
*** HOLE CARDS ***
afWGNf/WBEpJ7XTIK3WoTw: folds
IpDViWUJYXS6u+b2OxDwhQ collected $10 from pot
IpDViWUJYXS6u+b2OxDwhQ: doesn't show hand
*** SUMMARY ***
Total pot $10 | Rake $0
Seat 1: afWGNf/WBEpJ7XTIK3WoTw (button) (small blind) folded before Flop
Seat 2: IpDViWUJYXS6u+b2OxDwhQ (big blind) collected ($10)



PokerStars Game #59954673788:  Hold'em No Limit ($5/$10) - 2009/07/01 8:45:22 ET
Table 'ZBmu0cAiV+H0nkZCGN43DQ' 2-max Seat #2 is the button
Seat 1: afWGNf/WBEpJ7XTIK3WoTw ($451.50 in chips)
Seat 2: IpDViWUJYXS6u+b2OxDwhQ ($352 in chips)
IpDViWUJYXS6u+b2OxDwhQ: posts small blind $5
afWGNf/WBEpJ7XTIK3WoTw: posts big blind $10
*** HOLE CARDS ***
IpDViWUJYXS6u+b2OxDwhQ: raises $20 to $30
afWGNf/WBEpJ7XTIK3WoTw: calls $20
*** FLOP *** [6s 4d Jc]
afWGNf/WBEpJ7XTIK3WoTw: checks
IpDViWUJYXS6u+b2OxDwhQ: bets $30
afWGNf/WBEpJ7XTIK3WoTw: calls $30
*** TURN *** [6s 4d Jc] [3c]
afWGNf/WBEpJ7XTIK3WoTw: checks
IpDViWUJYXS6u+b2OxDwhQ: checks
*** RIVER *** [6s 4d Jc 3c] [Ah]
afWGNf/WBEpJ7XTIK3WoTw: checks
IpDViWUJYXS6u+b2OxDwhQ: bets $50
afWGNf/WBEpJ7XTIK3WoTw: folds
IpDViWUJYXS6u+b2OxDwhQ collected $119.50 from pot
IpDViWUJYXS6u+b2OxDwhQ: doesn't show hand
*** SUMMARY ***
Total pot $120 | Rake $0.50
Board [6s 4d Jc 3c Ah]
Seat 1: afWGNf/WBEpJ7XTIK3WoTw (big blind) folded on the River
Seat 2: IpDViWUJYXS6u+b2OxDwhQ (button) (small blind) collected ($119.50)



PokerStars Game #59954696012:  Hold'em No Limit ($5/$10) - 2009/07/01 8:45:55 ET
Table 'ZBmu0cAiV+H0nkZCGN43DQ' 2-max Seat #1 is the button
Seat 1: afWGNf/WBEpJ7XTIK3WoTw ($391.50 in chips)
Seat 2: IpDViWUJYXS6u+b2OxDwhQ ($411.50 in chips)
afWGNf/WBEpJ7XTIK3WoTw: posts small blind $5
IpDViWUJYXS6u+b2OxDwhQ: posts big blind $10
*** HOLE CARDS ***
afWGNf/WBEpJ7XTIK3WoTw: raises $20 to $30
IpDViWUJYXS6u+b2OxDwhQ: folds
afWGNf/WBEpJ7XTIK3WoTw collected $20 from pot
afWGNf/WBEpJ7XTIK3WoTw: doesn't show hand
*** SUMMARY ***
Total pot $20 | Rake $0
Seat 1: afWGNf/WBEpJ7XTIK3WoTw (button) (small blind) collected ($20)
Seat 2: IpDViWUJYXS6u+b2OxDwhQ (big blind) folded before Flop



PokerStars Game #59955136916:  Hold'em No Limit ($5/$10) - 2009/07/01 8:56:40 ET
Table '2a86NK3xhs21kwGZmbj0QA' 6-max Seat #6 is the button
Seat 1: BbirlZJeYiPjSFVvLtEDVw ($1082 in chips)
Seat 2: ef+xjxT8TlniduS+o14iYg ($765 in chips)
Seat 3: 7nu3NHCN2s0uUleNuVaGww ($1385.75 in chips)
Seat 4: 33XJu1CVnl9YOngoPIhi0A ($1232 in chips)
Seat 5: KVUX8NzxJOWN94yxutATnw ($200 in chips)
Seat 6: 3mTlg4g0FJN2bo939h/0Wg ($647 in chips)
BbirlZJeYiPjSFVvLtEDVw: posts small blind $5
ef+xjxT8TlniduS+o14iYg: posts big blind $10
*** HOLE CARDS ***
7nu3NHCN2s0uUleNuVaGww: folds
33XJu1CVnl9YOngoPIhi0A: folds
KVUX8NzxJOWN94yxutATnw: folds
3mTlg4g0FJN2bo939h/0Wg: folds
BbirlZJeYiPjSFVvLtEDVw: raises $20 to $30
ef+xjxT8TlniduS+o14iYg: calls $20
*** FLOP *** [8s As 3c]
BbirlZJeYiPjSFVvLtEDVw: bets $40
ef+xjxT8TlniduS+o14iYg: calls $40
*** TURN *** [8s As 3c] [Kh]
BbirlZJeYiPjSFVvLtEDVw: bets $100
ef+xjxT8TlniduS+o14iYg: folds
BbirlZJeYiPjSFVvLtEDVw collected $137 from pot
BbirlZJeYiPjSFVvLtEDVw: doesn't show hand
*** SUMMARY ***
Total pot $140 | Rake $3
Board [8s As 3c Kh]
Seat 1: BbirlZJeYiPjSFVvLtEDVw (small blind) collected ($137)
Seat 2: ef+xjxT8TlniduS+o14iYg (big blind) folded on the Turn
Seat 3: 7nu3NHCN2s0uUleNuVaGww folded before Flop (didn't bet)
Seat 4: 33XJu1CVnl9YOngoPIhi0A folded before Flop (didn't bet)
Seat 5: KVUX8NzxJOWN94yxutATnw folded before Flop (didn't bet)
Seat 6: 3mTlg4g0FJN2bo939h/0Wg (button) folded before Flop (didn't bet)



PokerStars Game #59955164852:  Hold'em No Limit ($5/$10) - 2009/07/01 8:57:22 ET
Table '2a86NK3xhs21kwGZmbj0QA' 6-max Seat #1 is the button
Seat 1: BbirlZJeYiPjSFVvLtEDVw ($1149 in chips)
Seat 2: ef+xjxT8TlniduS+o14iYg ($695 in chips)
Seat 3: 7nu3NHCN2s0uUleNuVaGww ($1385.75 in chips)
Seat 4: 33XJu1CVnl9YOngoPIhi0A ($1232 in chips)
Seat 5: KVUX8NzxJOWN94yxutATnw ($200 in chips)
Seat 6: 3mTlg4g0FJN2bo939h/0Wg ($647 in chips)
ef+xjxT8TlniduS+o14iYg: posts small blind $5
7nu3NHCN2s0uUleNuVaGww: posts big blind $10
*** HOLE CARDS ***
33XJu1CVnl9YOngoPIhi0A: folds
KVUX8NzxJOWN94yxutATnw: folds
3mTlg4g0FJN2bo939h/0Wg: folds
BbirlZJeYiPjSFVvLtEDVw: raises $20 to $30
ef+xjxT8TlniduS+o14iYg: calls $25
7nu3NHCN2s0uUleNuVaGww: raises $95 to $125
BbirlZJeYiPjSFVvLtEDVw: folds
ef+xjxT8TlniduS+o14iYg: folds
7nu3NHCN2s0uUleNuVaGww collected $90 from pot
*** SUMMARY ***
Total pot $90 | Rake $0
Seat 1: BbirlZJeYiPjSFVvLtEDVw (button) folded before Flop
Seat 2: ef+xjxT8TlniduS+o14iYg (small blind) folded before Flop
Seat 3: 7nu3NHCN2s0uUleNuVaGww (big blind) collected ($90)
Seat 4: 33XJu1CVnl9YOngoPIhi0A folded before Flop (didn't bet)
Seat 5: KVUX8NzxJOWN94yxutATnw folded before Flop (didn't bet)
Seat 6: 3mTlg4g0FJN2bo939h/0Wg folded before Flop (didn't bet)



PokerStars Game #59955182984:  Hold'em No Limit ($5/$10) - 2009/07/01 8:57:48 ET
Table '2a86NK3xhs21kwGZmbj0QA' 6-max Seat #2 is the button
Seat 1: BbirlZJeYiPjSFVvLtEDVw ($1119 in chips)
Seat 2: ef+xjxT8TlniduS+o14iYg ($665 in chips)
Seat 3: 7nu3NHCN2s0uUleNuVaGww ($1445.75 in chips)
Seat 4: 33XJu1CVnl9YOngoPIhi0A ($1232 in chips)
Seat 5: KVUX8NzxJOWN94yxutATnw ($200 in chips)
Seat 6: 3mTlg4g0FJN2bo939h/0Wg ($647 in chips)
7nu3NHCN2s0uUleNuVaGww: posts small blind $5
33XJu1CVnl9YOngoPIhi0A: posts big blind $10
*** HOLE CARDS ***
KVUX8NzxJOWN94yxutATnw: folds
3mTlg4g0FJN2bo939h/0Wg: raises $10 to $20
BbirlZJeYiPjSFVvLtEDVw: calls $20
ef+xjxT8TlniduS+o14iYg: folds
7nu3NHCN2s0uUleNuVaGww: folds
33XJu1CVnl9YOngoPIhi0A: raises $60 to $80
3mTlg4g0FJN2bo939h/0Wg: folds
BbirlZJeYiPjSFVvLtEDVw: calls $60
*** FLOP *** [5d 9c 5h]
33XJu1CVnl9YOngoPIhi0A: bets $110
BbirlZJeYiPjSFVvLtEDVw: calls $110
*** TURN *** [5d 9c 5h] [6c]
33XJu1CVnl9YOngoPIhi0A: bets $280
BbirlZJeYiPjSFVvLtEDVw: folds
33XJu1CVnl9YOngoPIhi0A collected $402 from pot
33XJu1CVnl9YOngoPIhi0A: doesn't show hand
*** SUMMARY ***
Total pot $405 | Rake $3
Board [5d 9c 5h 6c]
Seat 1: BbirlZJeYiPjSFVvLtEDVw folded on the Turn
Seat 2: ef+xjxT8TlniduS+o14iYg (button) folded before Flop (didn't bet)
Seat 3: 7nu3NHCN2s0uUleNuVaGww (small blind) folded before Flop
Seat 4: 33XJu1CVnl9YOngoPIhi0A (big blind) collected ($402)
Seat 5: KVUX8NzxJOWN94yxutATnw folded before Flop (didn't bet)
Seat 6: 3mTlg4g0FJN2bo939h/0Wg folded before Flop



PokerStars Game #59955219412:  Hold'em No Limit ($5/$10) - 2009/07/01 8:58:42 ET
Table '2a86NK3xhs21kwGZmbj0QA' 6-max Seat #3 is the button
Seat 1: BbirlZJeYiPjSFVvLtEDVw ($1000 in chips)
Seat 2: ef+xjxT8TlniduS+o14iYg ($665 in chips)
Seat 3: 7nu3NHCN2s0uUleNuVaGww ($1440.75 in chips)
Seat 4: 33XJu1CVnl9YOngoPIhi0A ($1444 in chips)
Seat 5: KVUX8NzxJOWN94yxutATnw ($200 in chips)
Seat 6: 3mTlg4g0FJN2bo939h/0Wg ($627 in chips)
33XJu1CVnl9YOngoPIhi0A: posts small blind $5
KVUX8NzxJOWN94yxutATnw: posts big blind $10
*** HOLE CARDS ***
3mTlg4g0FJN2bo939h/0Wg: raises $20 to $30
BbirlZJeYiPjSFVvLtEDVw: folds
ef+xjxT8TlniduS+o14iYg: calls $30
7nu3NHCN2s0uUleNuVaGww: folds
33XJu1CVnl9YOngoPIhi0A: folds
KVUX8NzxJOWN94yxutATnw: folds
*** FLOP *** [Ah 7d 3d]
3mTlg4g0FJN2bo939h/0Wg: bets $30
ef+xjxT8TlniduS+o14iYg: calls $30
*** TURN *** [Ah 7d 3d] [Tc]
3mTlg4g0FJN2bo939h/0Wg: checks
ef+xjxT8TlniduS+o14iYg: bets $40
3mTlg4g0FJN2bo939h/0Wg: calls $40
*** RIVER *** [Ah 7d 3d Tc] [6s]
3mTlg4g0FJN2bo939h/0Wg: checks
ef+xjxT8TlniduS+o14iYg: checks
*** SHOW DOWN ***
3mTlg4g0FJN2bo939h/0Wg: shows [Ks Td] (a pair of Tens)
ef+xjxT8TlniduS+o14iYg: shows [5d Ac] (a pair of Aces)
ef+xjxT8TlniduS+o14iYg collected $212 from pot
*** SUMMARY ***
Total pot $215 | Rake $3
Board [Ah 7d 3d Tc 6s]
Seat 1: BbirlZJeYiPjSFVvLtEDVw folded before Flop (didn't bet)
Seat 2: ef+xjxT8TlniduS+o14iYg showed [5d Ac] and won ($212) with a pair of Aces
Seat 3: 7nu3NHCN2s0uUleNuVaGww (button) folded before Flop (didn't bet)
Seat 4: 33XJu1CVnl9YOngoPIhi0A (small blind) folded before Flop
Seat 5: KVUX8NzxJOWN94yxutATnw (big blind) folded before Flop
Seat 6: 3mTlg4g0FJN2bo939h/0Wg showed [Ks Td] and lost with a pair of Tens



PokerStars Game #59955250040:  Hold'em No Limit ($5/$10) - 2009/07/01 8:59:28 ET
Table '2a86NK3xhs21kwGZmbj0QA' 6-max Seat #4 is the button
Seat 1: BbirlZJeYiPjSFVvLtEDVw ($1000 in chips)
Seat 2: ef+xjxT8TlniduS+o14iYg ($777 in chips)
Seat 3: 7nu3NHCN2s0uUleNuVaGww ($1440.75 in chips)
Seat 4: 33XJu1CVnl9YOngoPIhi0A ($1439 in chips)
Seat 5: KVUX8NzxJOWN94yxutATnw ($190 in chips)
Seat 6: 3mTlg4g0FJN2bo939h/0Wg ($527 in chips)
KVUX8NzxJOWN94yxutATnw: posts small blind $5
3mTlg4g0FJN2bo939h/0Wg: posts big blind $10
*** HOLE CARDS ***
BbirlZJeYiPjSFVvLtEDVw: folds
ef+xjxT8TlniduS+o14iYg: folds
7nu3NHCN2s0uUleNuVaGww: folds
33XJu1CVnl9YOngoPIhi0A: folds
KVUX8NzxJOWN94yxutATnw: folds
3mTlg4g0FJN2bo939h/0Wg collected $10 from pot
*** SUMMARY ***
Total pot $10 | Rake $0
Seat 1: BbirlZJeYiPjSFVvLtEDVw folded before Flop (didn't bet)
Seat 2: ef+xjxT8TlniduS+o14iYg folded before Flop (didn't bet)
Seat 3: 7nu3NHCN2s0uUleNuVaGww folded before Flop (didn't bet)
Seat 4: 33XJu1CVnl9YOngoPIhi0A (button) folded before Flop (didn't bet)
Seat 5: KVUX8NzxJOWN94yxutATnw (small blind) folded before Flop
Seat 6: 3mTlg4g0FJN2bo939h/0Wg (big blind) collected ($10)



PokerStars Game #59955257372:  Hold'em No Limit ($5/$10) - 2009/07/01 8:59:38 ET
Table '2a86NK3xhs21kwGZmbj0QA' 6-max Seat #5 is the button
Seat 1: BbirlZJeYiPjSFVvLtEDVw ($1000 in chips)
Seat 2: ef+xjxT8TlniduS+o14iYg ($777 in chips)
Seat 3: 7nu3NHCN2s0uUleNuVaGww ($1440.75 in chips)
Seat 4: 33XJu1CVnl9YOngoPIhi0A ($1439 in chips)
Seat 5: KVUX8NzxJOWN94yxutATnw ($185 in chips)
Seat 6: 3mTlg4g0FJN2bo939h/0Wg ($532 in chips)
3mTlg4g0FJN2bo939h/0Wg: posts small blind $5
BbirlZJeYiPjSFVvLtEDVw: posts big blind $10
*** HOLE CARDS ***
ef+xjxT8TlniduS+o14iYg: raises $20 to $30
7nu3NHCN2s0uUleNuVaGww: folds
33XJu1CVnl9YOngoPIhi0A: folds
KVUX8NzxJOWN94yxutATnw: calls $30
3mTlg4g0FJN2bo939h/0Wg: calls $25
BbirlZJeYiPjSFVvLtEDVw: folds
*** FLOP *** [9c 6h Qd]
3mTlg4g0FJN2bo939h/0Wg: checks
ef+xjxT8TlniduS+o14iYg: checks
KVUX8NzxJOWN94yxutATnw: bets $20
3mTlg4g0FJN2bo939h/0Wg: folds
ef+xjxT8TlniduS+o14iYg: folds
KVUX8NzxJOWN94yxutATnw collected $97 from pot
*** SUMMARY ***
Total pot $100 | Rake $3
Board [9c 6h Qd]
Seat 1: BbirlZJeYiPjSFVvLtEDVw (big blind) folded before Flop
Seat 2: ef+xjxT8TlniduS+o14iYg folded on the Flop
Seat 3: 7nu3NHCN2s0uUleNuVaGww folded before Flop (didn't bet)
Seat 4: 33XJu1CVnl9YOngoPIhi0A folded before Flop (didn't bet)
Seat 5: KVUX8NzxJOWN94yxutATnw (button) collected ($97)
Seat 6: 3mTlg4g0FJN2bo939h/0Wg (small blind) folded on the Flop



PokerStars Game #59955276594:  Hold'em No Limit ($5/$10) - 2009/07/01 9:00:06 ET
Table 'mAacPTyMuJ4IQhEFOonFPg' 2-max Seat #1 is the button
Seat 1: XFruyoQqeueL4N+qXEkusw ($1000 in chips)
Seat 2: Qy3sRcEECbAW4QhB/+9tLA ($1000 in chips)
XFruyoQqeueL4N+qXEkusw: posts small blind $5
Qy3sRcEECbAW4QhB/+9tLA: posts big blind $10
*** HOLE CARDS ***
XFruyoQqeueL4N+qXEkusw has timed out
XFruyoQqeueL4N+qXEkusw: folds
XFruyoQqeueL4N+qXEkusw is sitting out
Qy3sRcEECbAW4QhB/+9tLA collected $10 from pot
*** SUMMARY ***
Total pot $10 | Rake $0
Seat 1: XFruyoQqeueL4N+qXEkusw (button) (small blind) folded before Flop
Seat 2: Qy3sRcEECbAW4QhB/+9tLA (big blind) collected ($10)



PokerStars Game #59955290554:  Hold'em No Limit ($5/$10) - 2009/07/01 9:00:27 ET
Table '2a86NK3xhs21kwGZmbj0QA' 6-max Seat #6 is the button
Seat 1: BbirlZJeYiPjSFVvLtEDVw ($1000 in chips)
Seat 2: ef+xjxT8TlniduS+o14iYg ($747 in chips)
Seat 3: 7nu3NHCN2s0uUleNuVaGww ($1440.75 in chips)
Seat 4: 33XJu1CVnl9YOngoPIhi0A ($1439 in chips)
Seat 5: KVUX8NzxJOWN94yxutATnw ($252 in chips)
Seat 6: 3mTlg4g0FJN2bo939h/0Wg ($502 in chips)
BbirlZJeYiPjSFVvLtEDVw: posts small blind $5
ef+xjxT8TlniduS+o14iYg: posts big blind $10
*** HOLE CARDS ***
7nu3NHCN2s0uUleNuVaGww: raises $20 to $30
33XJu1CVnl9YOngoPIhi0A: raises $70 to $100
KVUX8NzxJOWN94yxutATnw: folds
3mTlg4g0FJN2bo939h/0Wg: folds
BbirlZJeYiPjSFVvLtEDVw: folds
ef+xjxT8TlniduS+o14iYg: folds
7nu3NHCN2s0uUleNuVaGww: raises $165 to $265
33XJu1CVnl9YOngoPIhi0A: raises $275 to $540
7nu3NHCN2s0uUleNuVaGww: raises $900.75 to $1440.75 and is all-in
33XJu1CVnl9YOngoPIhi0A: calls $899 and is all-in
*** FLOP *** [Kc 9d Qs]
*** TURN *** [Kc 9d Qs] [Td]
*** RIVER *** [Kc 9d Qs Td] [Ad]
*** SHOW DOWN ***
7nu3NHCN2s0uUleNuVaGww: shows [Ac Ks] (two pair, Aces and Kings)
33XJu1CVnl9YOngoPIhi0A: shows [Ah As] (three of a kind, Aces)
33XJu1CVnl9YOngoPIhi0A collected $2890 from pot
*** SUMMARY ***
Total pot $2893 | Rake $3
Board [Kc 9d Qs Td Ad]
Seat 1: BbirlZJeYiPjSFVvLtEDVw (small blind) folded before Flop
Seat 2: ef+xjxT8TlniduS+o14iYg (big blind) folded before Flop
Seat 3: 7nu3NHCN2s0uUleNuVaGww showed [Ac Ks] and lost with two pair, Aces and Kings
Seat 4: 33XJu1CVnl9YOngoPIhi0A showed [Ah As] and won ($2890) with three of a kind, Aces
Seat 5: KVUX8NzxJOWN94yxutATnw folded before Flop (didn't bet)
Seat 6: 3mTlg4g0FJN2bo939h/0Wg (button) folded before Flop (didn't bet)



PokerStars Game #59955324224:  Hold'em No Limit ($5/$10) - 2009/07/01 9:01:16 ET
Table '2a86NK3xhs21kwGZmbj0QA' 6-max Seat #1 is the button
Seat 1: BbirlZJeYiPjSFVvLtEDVw ($1000 in chips)
Seat 2: ef+xjxT8TlniduS+o14iYg ($737 in chips)
Seat 3: 7nu3NHCN2s0uUleNuVaGww ($1000 in chips)
Seat 4: 33XJu1CVnl9YOngoPIhi0A ($2890 in chips)
Seat 5: KVUX8NzxJOWN94yxutATnw ($252 in chips)
Seat 6: 3mTlg4g0FJN2bo939h/0Wg ($502 in chips)
ef+xjxT8TlniduS+o14iYg: posts small blind $5
7nu3NHCN2s0uUleNuVaGww: posts big blind $10
*** HOLE CARDS ***
33XJu1CVnl9YOngoPIhi0A: folds
KVUX8NzxJOWN94yxutATnw: folds
3mTlg4g0FJN2bo939h/0Wg: folds
BbirlZJeYiPjSFVvLtEDVw: folds
ef+xjxT8TlniduS+o14iYg: folds
ef+xjxT8TlniduS+o14iYg is sitting out
7nu3NHCN2s0uUleNuVaGww collected $10 from pot
*** SUMMARY ***
Total pot $10 | Rake $0
Seat 1: BbirlZJeYiPjSFVvLtEDVw (button) folded before Flop (didn't bet)
Seat 2: ef+xjxT8TlniduS+o14iYg (small blind) folded before Flop
Seat 3: 7nu3NHCN2s0uUleNuVaGww (big blind) collected ($10)
Seat 4: 33XJu1CVnl9YOngoPIhi0A folded before Flop (didn't bet)
Seat 5: KVUX8NzxJOWN94yxutATnw folded before Flop (didn't bet)
Seat 6: 3mTlg4g0FJN2bo939h/0Wg folded before Flop (didn't bet)



PokerStars Game #59955332066:  Hold'em No Limit ($5/$10) - 2009/07/01 9:01:28 ET
Table '2a86NK3xhs21kwGZmbj0QA' 6-max Seat #3 is the button
Seat 1: BbirlZJeYiPjSFVvLtEDVw ($1000 in chips)
Seat 3: 7nu3NHCN2s0uUleNuVaGww ($1005 in chips)
Seat 4: 33XJu1CVnl9YOngoPIhi0A ($2890 in chips)
Seat 6: 3mTlg4g0FJN2bo939h/0Wg ($502 in chips)
33XJu1CVnl9YOngoPIhi0A: posts small blind $5
KVUX8NzxJOWN94yxutATnw: is sitting out
3mTlg4g0FJN2bo939h/0Wg: posts big blind $10
*** HOLE CARDS ***
KVUX8NzxJOWN94yxutATnw leaves the table
BbirlZJeYiPjSFVvLtEDVw: folds
7nu3NHCN2s0uUleNuVaGww: raises $20 to $30
33XJu1CVnl9YOngoPIhi0A: folds
3mTlg4g0FJN2bo939h/0Wg: folds
7nu3NHCN2s0uUleNuVaGww collected $25 from pot
*** SUMMARY ***
Total pot $25 | Rake $0
Seat 1: BbirlZJeYiPjSFVvLtEDVw folded before Flop (didn't bet)
Seat 3: 7nu3NHCN2s0uUleNuVaGww (button) collected ($25)
Seat 4: 33XJu1CVnl9YOngoPIhi0A (small blind) folded before Flop
Seat 6: 3mTlg4g0FJN2bo939h/0Wg (big blind) folded before Flop



PokerStars Game #59955345224:  Hold'em No Limit ($5/$10) - 2009/07/01 9:01:47 ET
Table '2a86NK3xhs21kwGZmbj0QA' 6-max Seat #4 is the button
Seat 1: BbirlZJeYiPjSFVvLtEDVw ($1000 in chips)
Seat 3: 7nu3NHCN2s0uUleNuVaGww ($1020 in chips)
Seat 4: 33XJu1CVnl9YOngoPIhi0A ($2885 in chips)
Seat 6: 3mTlg4g0FJN2bo939h/0Wg ($492 in chips)
3mTlg4g0FJN2bo939h/0Wg: posts small blind $5
8PKEEFuiGhgwIgzB6GZWVQ joins the table at seat #5
BbirlZJeYiPjSFVvLtEDVw: posts big blind $10
*** HOLE CARDS ***
7nu3NHCN2s0uUleNuVaGww: raises $20 to $30
33XJu1CVnl9YOngoPIhi0A: folds
3mTlg4g0FJN2bo939h/0Wg: calls $25
BbirlZJeYiPjSFVvLtEDVw: folds
*** FLOP *** [Ac 6d Th]
3mTlg4g0FJN2bo939h/0Wg: checks
7nu3NHCN2s0uUleNuVaGww: checks
*** TURN *** [Ac 6d Th] [5c]
3mTlg4g0FJN2bo939h/0Wg: checks
7nu3NHCN2s0uUleNuVaGww: checks
*** RIVER *** [Ac 6d Th 5c] [9h]
3mTlg4g0FJN2bo939h/0Wg: checks
7nu3NHCN2s0uUleNuVaGww: checks
*** SHOW DOWN ***
3mTlg4g0FJN2bo939h/0Wg: shows [7d 7h] (a pair of Sevens)
7nu3NHCN2s0uUleNuVaGww: mucks hand
3mTlg4g0FJN2bo939h/0Wg collected $68 from pot
*** SUMMARY ***
Total pot $70 | Rake $2
Board [Ac 6d Th 5c 9h]
Seat 1: BbirlZJeYiPjSFVvLtEDVw (big blind) folded before Flop
Seat 3: 7nu3NHCN2s0uUleNuVaGww mucked
Seat 4: 33XJu1CVnl9YOngoPIhi0A (button) folded before Flop (didn't bet)
Seat 6: 3mTlg4g0FJN2bo939h/0Wg (small blind) showed [7d 7h] and won ($68) with a pair of Sevens



PokerStars Game #59955358608:  Hold'em No Limit ($5/$10) - 2009/07/01 9:02:05 ET
Table 'agogFDSQKF+U0NUTbR6ZlA' 6-max Seat #1 is the button
Seat 1: ZaYCGtNHUeItoUEheoYDMw ($215 in chips)
Seat 2: BbirlZJeYiPjSFVvLtEDVw ($1000 in chips)
Seat 4: y9vGciYuJ4+4Z79YDgtBLg ($421 in chips)
Seat 5: KVUX8NzxJOWN94yxutATnw ($481 in chips)
Seat 6: 3mTlg4g0FJN2bo939h/0Wg ($180 in chips)
BbirlZJeYiPjSFVvLtEDVw: posts small blind $5
8PKEEFuiGhgwIgzB6GZWVQ: is sitting out
y9vGciYuJ4+4Z79YDgtBLg: posts big blind $10
*** HOLE CARDS ***
KVUX8NzxJOWN94yxutATnw: folds
8PKEEFuiGhgwIgzB6GZWVQ leaves the table
3mTlg4g0FJN2bo939h/0Wg: folds
ZaYCGtNHUeItoUEheoYDMw: folds
BbirlZJeYiPjSFVvLtEDVw: folds
KVUX8NzxJOWN94yxutATnw leaves the table
33XJu1CVnl9YOngoPIhi0A joins the table at seat #3
y9vGciYuJ4+4Z79YDgtBLg collected $10 from pot
y9vGciYuJ4+4Z79YDgtBLg: doesn't show hand
*** SUMMARY ***
Total pot $10 | Rake $0
Seat 1: ZaYCGtNHUeItoUEheoYDMw (button) folded before Flop (didn't bet)
Seat 2: BbirlZJeYiPjSFVvLtEDVw (small blind) folded before Flop
Seat 4: y9vGciYuJ4+4Z79YDgtBLg (big blind) collected ($10)
Seat 5: KVUX8NzxJOWN94yxutATnw folded before Flop (didn't bet)
Seat 6: 3mTlg4g0FJN2bo939h/0Wg folded before Flop (didn't bet)



PokerStars Game #59955369162:  Hold'em No Limit ($5/$10) - 2009/07/01 9:02:21 ET
Table '2a86NK3xhs21kwGZmbj0QA' 6-max Seat #6 is the button
Seat 1: BbirlZJeYiPjSFVvLtEDVw ($1000 in chips)
Seat 3: 7nu3NHCN2s0uUleNuVaGww ($1000 in chips)
Seat 4: 33XJu1CVnl9YOngoPIhi0A ($2885 in chips)
Seat 6: 3mTlg4g0FJN2bo939h/0Wg ($530 in chips)
BbirlZJeYiPjSFVvLtEDVw: posts small blind $5
7nu3NHCN2s0uUleNuVaGww: posts big blind $10
8PKEEFuiGhgwIgzB6GZWVQ: sits out
*** HOLE CARDS ***
33XJu1CVnl9YOngoPIhi0A: raises $20 to $30
3mTlg4g0FJN2bo939h/0Wg: raises $40 to $70
BbirlZJeYiPjSFVvLtEDVw: folds
ef+xjxT8TlniduS+o14iYg has returned
7nu3NHCN2s0uUleNuVaGww: folds
33XJu1CVnl9YOngoPIhi0A: calls $40
*** FLOP *** [6h 9d Jd]
33XJu1CVnl9YOngoPIhi0A: checks
ef+xjxT8TlniduS+o14iYg leaves the table
3mTlg4g0FJN2bo939h/0Wg: bets $60
33XJu1CVnl9YOngoPIhi0A: folds
3mTlg4g0FJN2bo939h/0Wg collected $153 from pot
*** SUMMARY ***
Total pot $155 | Rake $2
Board [6h 9d Jd]
Seat 1: BbirlZJeYiPjSFVvLtEDVw (small blind) folded before Flop
Seat 3: 7nu3NHCN2s0uUleNuVaGww (big blind) folded before Flop
Seat 4: 33XJu1CVnl9YOngoPIhi0A folded on the Flop
Seat 6: 3mTlg4g0FJN2bo939h/0Wg (button) collected ($153)



PokerStars Game #59955377472:  Hold'em No Limit ($5/$10) - 2009/07/01 9:02:33 ET
Table 'agogFDSQKF+U0NUTbR6ZlA' 6-max Seat #2 is the button
Seat 1: ZaYCGtNHUeItoUEheoYDMw ($215 in chips)
Seat 2: BbirlZJeYiPjSFVvLtEDVw ($1000 in chips)
Seat 4: y9vGciYuJ4+4Z79YDgtBLg ($426 in chips)
Seat 6: 3mTlg4g0FJN2bo939h/0Wg ($180 in chips)
33XJu1CVnl9YOngoPIhi0A will be allowed to play after the button
y9vGciYuJ4+4Z79YDgtBLg: posts small blind $5
3mTlg4g0FJN2bo939h/0Wg: posts big blind $10
*** HOLE CARDS ***
ZaYCGtNHUeItoUEheoYDMw: folds
BbirlZJeYiPjSFVvLtEDVw: raises $20 to $30
y9vGciYuJ4+4Z79YDgtBLg: calls $25
3mTlg4g0FJN2bo939h/0Wg: folds
*** FLOP *** [8c Th 4h]
y9vGciYuJ4+4Z79YDgtBLg: checks
BbirlZJeYiPjSFVvLtEDVw: bets $50
y9vGciYuJ4+4Z79YDgtBLg: raises $90 to $140
BbirlZJeYiPjSFVvLtEDVw: folds
y9vGciYuJ4+4Z79YDgtBLg collected $168 from pot
*** SUMMARY ***
Total pot $170 | Rake $2
Board [8c Th 4h]
Seat 1: ZaYCGtNHUeItoUEheoYDMw folded before Flop (didn't bet)
Seat 2: BbirlZJeYiPjSFVvLtEDVw (button) folded on the Flop
Seat 4: y9vGciYuJ4+4Z79YDgtBLg (small blind) collected ($168)
Seat 6: 3mTlg4g0FJN2bo939h/0Wg (big blind) folded before Flop



PokerStars Game #59955401382:  Hold'em No Limit ($5/$10) - 2009/07/01 9:03:08 ET
Table '2a86NK3xhs21kwGZmbj0QA' 6-max Seat #1 is the button
Seat 1: BbirlZJeYiPjSFVvLtEDVw ($1000 in chips)
Seat 3: 7nu3NHCN2s0uUleNuVaGww ($990 in chips)
Seat 4: 33XJu1CVnl9YOngoPIhi0A ($2815 in chips)
Seat 6: 3mTlg4g0FJN2bo939h/0Wg ($613 in chips)
7nu3NHCN2s0uUleNuVaGww: posts small blind $5
33XJu1CVnl9YOngoPIhi0A: posts big blind $10
8PKEEFuiGhgwIgzB6GZWVQ: sits out
*** HOLE CARDS ***
3mTlg4g0FJN2bo939h/0Wg: folds
BbirlZJeYiPjSFVvLtEDVw: raises $20 to $30
z/zDzN9GsrGWKD4D635nKA joins the table at seat #2
7nu3NHCN2s0uUleNuVaGww: folds
33XJu1CVnl9YOngoPIhi0A: calls $20
*** FLOP *** [2d 9s Ts]
33XJu1CVnl9YOngoPIhi0A: checks
BbirlZJeYiPjSFVvLtEDVw: bets $50
33XJu1CVnl9YOngoPIhi0A: folds
BbirlZJeYiPjSFVvLtEDVw collected $63 from pot
BbirlZJeYiPjSFVvLtEDVw: doesn't show hand
*** SUMMARY ***
Total pot $65 | Rake $2
Board [2d 9s Ts]
Seat 1: BbirlZJeYiPjSFVvLtEDVw (button) collected ($63)
Seat 3: 7nu3NHCN2s0uUleNuVaGww (small blind) folded before Flop
Seat 4: 33XJu1CVnl9YOngoPIhi0A (big blind) folded on the Flop
Seat 6: 3mTlg4g0FJN2bo939h/0Wg folded before Flop (didn't bet)



PokerStars Game #59955417892:  Hold'em No Limit ($5/$10) - 2009/07/01 9:03:32 ET
Table '2a86NK3xhs21kwGZmbj0QA' 6-max Seat #3 is the button
Seat 1: BbirlZJeYiPjSFVvLtEDVw ($1033 in chips)
Seat 3: 7nu3NHCN2s0uUleNuVaGww ($985 in chips)
Seat 4: 33XJu1CVnl9YOngoPIhi0A ($2785 in chips)
Seat 5: 8PKEEFuiGhgwIgzB6GZWVQ ($200 in chips)
Seat 6: 3mTlg4g0FJN2bo939h/0Wg ($613 in chips)
33XJu1CVnl9YOngoPIhi0A: posts small blind $5
8PKEEFuiGhgwIgzB6GZWVQ: posts big blind $10
z/zDzN9GsrGWKD4D635nKA: sits out
*** HOLE CARDS ***
3mTlg4g0FJN2bo939h/0Wg: folds
BbirlZJeYiPjSFVvLtEDVw: folds
7nu3NHCN2s0uUleNuVaGww: folds
33XJu1CVnl9YOngoPIhi0A: raises $20 to $30
8PKEEFuiGhgwIgzB6GZWVQ: raises $70 to $100
33XJu1CVnl9YOngoPIhi0A: raises $2685 to $2785 and is all-in
8PKEEFuiGhgwIgzB6GZWVQ: calls $100 and is all-in
*** FLOP *** [Ad 4s Jh]
*** TURN *** [Ad 4s Jh] [2d]
*** RIVER *** [Ad 4s Jh 2d] [Qc]
*** SHOW DOWN ***
33XJu1CVnl9YOngoPIhi0A: shows [Ks Kh] (a pair of Kings)
8PKEEFuiGhgwIgzB6GZWVQ: shows [Js Ah] (two pair, Aces and Jacks)
8PKEEFuiGhgwIgzB6GZWVQ collected $398 from pot
*** SUMMARY ***
Total pot $400 | Rake $2
Board [Ad 4s Jh 2d Qc]
Seat 1: BbirlZJeYiPjSFVvLtEDVw folded before Flop (didn't bet)
Seat 3: 7nu3NHCN2s0uUleNuVaGww (button) folded before Flop (didn't bet)
Seat 4: 33XJu1CVnl9YOngoPIhi0A (small blind) showed [Ks Kh] and lost with a pair of Kings
Seat 5: 8PKEEFuiGhgwIgzB6GZWVQ (big blind) showed [Js Ah] and won ($398) with two pair, Aces and Jacks
Seat 6: 3mTlg4g0FJN2bo939h/0Wg folded before Flop (didn't bet)



PokerStars Game #59955437768:  Hold'em No Limit ($5/$10) - 2009/07/01 9:04:01 ET
Table '2a86NK3xhs21kwGZmbj0QA' 6-max Seat #4 is the button
Seat 1: BbirlZJeYiPjSFVvLtEDVw ($1033 in chips)
Seat 3: 7nu3NHCN2s0uUleNuVaGww ($985 in chips)
Seat 4: 33XJu1CVnl9YOngoPIhi0A ($2585 in chips)
Seat 5: 8PKEEFuiGhgwIgzB6GZWVQ ($398 in chips)
Seat 6: 3mTlg4g0FJN2bo939h/0Wg ($613 in chips)
8PKEEFuiGhgwIgzB6GZWVQ: posts small blind $5
3mTlg4g0FJN2bo939h/0Wg: posts big blind $10
z/zDzN9GsrGWKD4D635nKA: sits out
*** HOLE CARDS ***
BbirlZJeYiPjSFVvLtEDVw: folds
7nu3NHCN2s0uUleNuVaGww: folds
33XJu1CVnl9YOngoPIhi0A: raises $20 to $30
8PKEEFuiGhgwIgzB6GZWVQ: folds
3mTlg4g0FJN2bo939h/0Wg: folds
33XJu1CVnl9YOngoPIhi0A collected $25 from pot
33XJu1CVnl9YOngoPIhi0A: doesn't show hand
*** SUMMARY ***
Total pot $25 | Rake $0
Seat 1: BbirlZJeYiPjSFVvLtEDVw folded before Flop (didn't bet)
Seat 3: 7nu3NHCN2s0uUleNuVaGww folded before Flop (didn't bet)
Seat 4: 33XJu1CVnl9YOngoPIhi0A (button) collected ($25)
Seat 5: 8PKEEFuiGhgwIgzB6GZWVQ (small blind) folded before Flop
Seat 6: 3mTlg4g0FJN2bo939h/0Wg (big blind) folded before Flop



PokerStars Game #59955443042:  Hold'em No Limit ($5/$10) - 2009/07/01 9:04:08 ET
Table 'agogFDSQKF+U0NUTbR6ZlA' 6-max Seat #4 is the button
Seat 1: ZaYCGtNHUeItoUEheoYDMw ($215 in chips)
Seat 2: BbirlZJeYiPjSFVvLtEDVw ($1000 in chips)
Seat 4: y9vGciYuJ4+4Z79YDgtBLg ($514 in chips)
Seat 6: 3mTlg4g0FJN2bo939h/0Wg ($170 in chips)
3mTlg4g0FJN2bo939h/0Wg: posts small blind $5
ZaYCGtNHUeItoUEheoYDMw: posts big blind $10
33XJu1CVnl9YOngoPIhi0A: sits out
*** HOLE CARDS ***
BbirlZJeYiPjSFVvLtEDVw: folds
y9vGciYuJ4+4Z79YDgtBLg: folds
3mTlg4g0FJN2bo939h/0Wg: calls $5
ZaYCGtNHUeItoUEheoYDMw: raises $20 to $30
3mTlg4g0FJN2bo939h/0Wg: calls $20
*** FLOP *** [Kh 8d Ts]
3mTlg4g0FJN2bo939h/0Wg: checks
ZaYCGtNHUeItoUEheoYDMw: checks
*** TURN *** [Kh 8d Ts] [Tc]
3mTlg4g0FJN2bo939h/0Wg: bets $30
ZaYCGtNHUeItoUEheoYDMw: folds
3mTlg4g0FJN2bo939h/0Wg collected $58 from pot
*** SUMMARY ***
Total pot $60 | Rake $2
Board [Kh 8d Ts Tc]
Seat 1: ZaYCGtNHUeItoUEheoYDMw (big blind) folded on the Turn
Seat 2: BbirlZJeYiPjSFVvLtEDVw folded before Flop (didn't bet)
Seat 4: y9vGciYuJ4+4Z79YDgtBLg (button) folded before Flop (didn't bet)
Seat 6: 3mTlg4g0FJN2bo939h/0Wg (small blind) collected ($58)



PokerStars Game #59955458464:  Hold'em No Limit ($5/$10) - 2009/07/01 9:04:30 ET
Table '2a86NK3xhs21kwGZmbj0QA' 6-max Seat #5 is the button
Seat 1: BbirlZJeYiPjSFVvLtEDVw ($1033 in chips)
Seat 3: 7nu3NHCN2s0uUleNuVaGww ($985 in chips)
Seat 4: 33XJu1CVnl9YOngoPIhi0A ($2600 in chips)
Seat 5: 8PKEEFuiGhgwIgzB6GZWVQ ($393 in chips)
Seat 6: 3mTlg4g0FJN2bo939h/0Wg ($603 in chips)
3mTlg4g0FJN2bo939h/0Wg: posts small blind $5
BbirlZJeYiPjSFVvLtEDVw: posts big blind $10
z/zDzN9GsrGWKD4D635nKA: sits out
*** HOLE CARDS ***
7nu3NHCN2s0uUleNuVaGww: raises $20 to $30
33XJu1CVnl9YOngoPIhi0A: folds
8PKEEFuiGhgwIgzB6GZWVQ: folds
3mTlg4g0FJN2bo939h/0Wg: calls $25
BbirlZJeYiPjSFVvLtEDVw: folds
*** FLOP *** [4d Qd 9c]
3mTlg4g0FJN2bo939h/0Wg: checks
7nu3NHCN2s0uUleNuVaGww: bets $40
3mTlg4g0FJN2bo939h/0Wg: folds
7nu3NHCN2s0uUleNuVaGww collected $68 from pot
*** SUMMARY ***
Total pot $70 | Rake $2
Board [4d Qd 9c]
Seat 1: BbirlZJeYiPjSFVvLtEDVw (big blind) folded before Flop
Seat 3: 7nu3NHCN2s0uUleNuVaGww collected ($68)
Seat 4: 33XJu1CVnl9YOngoPIhi0A folded before Flop (didn't bet)
Seat 5: 8PKEEFuiGhgwIgzB6GZWVQ (button) folded before Flop (didn't bet)
Seat 6: 3mTlg4g0FJN2bo939h/0Wg (small blind) folded on the Flop



PokerStars Game #59955470706:  Hold'em No Limit ($5/$10) - 2009/07/01 9:04:48 ET
Table 'agogFDSQKF+U0NUTbR6ZlA' 6-max Seat #6 is the button
Seat 1: ZaYCGtNHUeItoUEheoYDMw ($185 in chips)
Seat 2: BbirlZJeYiPjSFVvLtEDVw ($1000 in chips)
Seat 4: y9vGciYuJ4+4Z79YDgtBLg ($514 in chips)
Seat 6: 3mTlg4g0FJN2bo939h/0Wg ($198 in chips)
ZaYCGtNHUeItoUEheoYDMw: posts small blind $5
BbirlZJeYiPjSFVvLtEDVw: posts big blind $10
33XJu1CVnl9YOngoPIhi0A: sits out
*** HOLE CARDS ***
y9vGciYuJ4+4Z79YDgtBLg: folds
3mTlg4g0FJN2bo939h/0Wg: folds
ZaYCGtNHUeItoUEheoYDMw: raises $10 to $20
BbirlZJeYiPjSFVvLtEDVw: folds
ZaYCGtNHUeItoUEheoYDMw collected $20 from pot
*** SUMMARY ***
Total pot $20 | Rake $0
Seat 1: ZaYCGtNHUeItoUEheoYDMw (small blind) collected ($20)
Seat 2: BbirlZJeYiPjSFVvLtEDVw (big blind) folded before Flop
Seat 4: y9vGciYuJ4+4Z79YDgtBLg folded before Flop (didn't bet)
Seat 6: 3mTlg4g0FJN2bo939h/0Wg (button) folded before Flop (didn't bet)



PokerStars Game #59955486406:  Hold'em No Limit ($5/$10) - 2009/07/01 9:05:11 ET
Table 'agogFDSQKF+U0NUTbR6ZlA' 6-max Seat #1 is the button
Seat 1: ZaYCGtNHUeItoUEheoYDMw ($195 in chips)
Seat 2: BbirlZJeYiPjSFVvLtEDVw ($1000 in chips)
Seat 3: 33XJu1CVnl9YOngoPIhi0A ($1000 in chips)
Seat 4: y9vGciYuJ4+4Z79YDgtBLg ($514 in chips)
Seat 6: 3mTlg4g0FJN2bo939h/0Wg ($198 in chips)
BbirlZJeYiPjSFVvLtEDVw: posts small blind $5
33XJu1CVnl9YOngoPIhi0A: posts big blind $10
*** HOLE CARDS ***
y9vGciYuJ4+4Z79YDgtBLg: folds
3mTlg4g0FJN2bo939h/0Wg: folds
ZaYCGtNHUeItoUEheoYDMw: folds
BbirlZJeYiPjSFVvLtEDVw: folds
33XJu1CVnl9YOngoPIhi0A collected $10 from pot
*** SUMMARY ***
Total pot $10 | Rake $0
Seat 1: ZaYCGtNHUeItoUEheoYDMw (button) folded before Flop (didn't bet)
Seat 2: BbirlZJeYiPjSFVvLtEDVw (small blind) folded before Flop
Seat 3: 33XJu1CVnl9YOngoPIhi0A (big blind) collected ($10)
Seat 4: y9vGciYuJ4+4Z79YDgtBLg folded before Flop (didn't bet)
Seat 6: 3mTlg4g0FJN2bo939h/0Wg folded before Flop (didn't bet)



PokerStars Game #59955488660:  Hold'em No Limit ($5/$10) - 2009/07/01 9:05:14 ET
Table '2a86NK3xhs21kwGZmbj0QA' 6-max Seat #6 is the button
Seat 1: BbirlZJeYiPjSFVvLtEDVw ($1023 in chips)
Seat 2: z/zDzN9GsrGWKD4D635nKA ($1000 in chips)
Seat 3: 7nu3NHCN2s0uUleNuVaGww ($1023 in chips)
Seat 4: 33XJu1CVnl9YOngoPIhi0A ($2600 in chips)
Seat 5: 8PKEEFuiGhgwIgzB6GZWVQ ($393 in chips)
Seat 6: 3mTlg4g0FJN2bo939h/0Wg ($573 in chips)
BbirlZJeYiPjSFVvLtEDVw: posts small blind $5
z/zDzN9GsrGWKD4D635nKA: posts big blind $10
*** HOLE CARDS ***
7nu3NHCN2s0uUleNuVaGww: raises $20 to $30
33XJu1CVnl9YOngoPIhi0A: folds
8PKEEFuiGhgwIgzB6GZWVQ: folds
3mTlg4g0FJN2bo939h/0Wg: folds
BbirlZJeYiPjSFVvLtEDVw: raises $80 to $110
z/zDzN9GsrGWKD4D635nKA: folds
7nu3NHCN2s0uUleNuVaGww: calls $80
*** FLOP *** [Ac Ks Kc]
BbirlZJeYiPjSFVvLtEDVw: bets $90
7nu3NHCN2s0uUleNuVaGww: calls $90
*** TURN *** [Ac Ks Kc] [Jd]
BbirlZJeYiPjSFVvLtEDVw: checks
7nu3NHCN2s0uUleNuVaGww: checks
*** RIVER *** [Ac Ks Kc Jd] [9s]
BbirlZJeYiPjSFVvLtEDVw: checks
7nu3NHCN2s0uUleNuVaGww: bets $245
BbirlZJeYiPjSFVvLtEDVw: folds
7nu3NHCN2s0uUleNuVaGww collected $407 from pot
*** SUMMARY ***
Total pot $410 | Rake $3
Board [Ac Ks Kc Jd 9s]
Seat 1: BbirlZJeYiPjSFVvLtEDVw (small blind) folded on the River
Seat 2: z/zDzN9GsrGWKD4D635nKA (big blind) folded before Flop
Seat 3: 7nu3NHCN2s0uUleNuVaGww collected ($407)
Seat 4: 33XJu1CVnl9YOngoPIhi0A folded before Flop (didn't bet)
Seat 5: 8PKEEFuiGhgwIgzB6GZWVQ folded before Flop (didn't bet)
Seat 6: 3mTlg4g0FJN2bo939h/0Wg (button) folded before Flop (didn't bet)



PokerStars Game #59955503670:  Hold'em No Limit ($5/$10) - 2009/07/01 9:05:36 ET
Table 'agogFDSQKF+U0NUTbR6ZlA' 6-max Seat #2 is the button
Seat 1: ZaYCGtNHUeItoUEheoYDMw ($195 in chips)
Seat 2: BbirlZJeYiPjSFVvLtEDVw ($1000 in chips)
Seat 3: 33XJu1CVnl9YOngoPIhi0A ($1005 in chips)
Seat 4: y9vGciYuJ4+4Z79YDgtBLg ($514 in chips)
Seat 6: 3mTlg4g0FJN2bo939h/0Wg ($198 in chips)
33XJu1CVnl9YOngoPIhi0A: posts small blind $5
y9vGciYuJ4+4Z79YDgtBLg: posts big blind $10
*** HOLE CARDS ***
3mTlg4g0FJN2bo939h/0Wg: folds
ZaYCGtNHUeItoUEheoYDMw: folds
BbirlZJeYiPjSFVvLtEDVw: raises $20 to $30
33XJu1CVnl9YOngoPIhi0A: calls $25
y9vGciYuJ4+4Z79YDgtBLg: folds
*** FLOP *** [8c Js 6c]
33XJu1CVnl9YOngoPIhi0A: checks
BbirlZJeYiPjSFVvLtEDVw: bets $50
33XJu1CVnl9YOngoPIhi0A: folds
BbirlZJeYiPjSFVvLtEDVw collected $68 from pot
*** SUMMARY ***
Total pot $70 | Rake $2
Board [8c Js 6c]
Seat 1: ZaYCGtNHUeItoUEheoYDMw folded before Flop (didn't bet)
Seat 2: BbirlZJeYiPjSFVvLtEDVw (button) collected ($68)
Seat 3: 33XJu1CVnl9YOngoPIhi0A (small blind) folded on the Flop
Seat 4: y9vGciYuJ4+4Z79YDgtBLg (big blind) folded before Flop
Seat 6: 3mTlg4g0FJN2bo939h/0Wg folded before Flop (didn't bet)



PokerStars Game #59955523932:  Hold'em No Limit ($5/$10) - 2009/07/01 9:06:05 ET
Table 'agogFDSQKF+U0NUTbR6ZlA' 6-max Seat #3 is the button
Seat 1: ZaYCGtNHUeItoUEheoYDMw ($195 in chips)
Seat 2: BbirlZJeYiPjSFVvLtEDVw ($1038 in chips)
Seat 3: 33XJu1CVnl9YOngoPIhi0A ($975 in chips)
Seat 4: y9vGciYuJ4+4Z79YDgtBLg ($504 in chips)
Seat 6: 3mTlg4g0FJN2bo939h/0Wg ($198 in chips)
y9vGciYuJ4+4Z79YDgtBLg: posts small blind $5
3mTlg4g0FJN2bo939h/0Wg: posts big blind $10
*** HOLE CARDS ***
ZaYCGtNHUeItoUEheoYDMw: raises $10 to $20
BbirlZJeYiPjSFVvLtEDVw: folds
33XJu1CVnl9YOngoPIhi0A: calls $20
y9vGciYuJ4+4Z79YDgtBLg: folds
3mTlg4g0FJN2bo939h/0Wg: calls $10
*** FLOP *** [3s 8d 7h]
3mTlg4g0FJN2bo939h/0Wg: checks
ZaYCGtNHUeItoUEheoYDMw: checks
33XJu1CVnl9YOngoPIhi0A: checks
*** TURN *** [3s 8d 7h] [3h]
3mTlg4g0FJN2bo939h/0Wg: bets $30
ZaYCGtNHUeItoUEheoYDMw: folds
33XJu1CVnl9YOngoPIhi0A: folds
3mTlg4g0FJN2bo939h/0Wg collected $63 from pot
*** SUMMARY ***
Total pot $65 | Rake $2
Board [3s 8d 7h 3h]
Seat 1: ZaYCGtNHUeItoUEheoYDMw folded on the Turn
Seat 2: BbirlZJeYiPjSFVvLtEDVw folded before Flop (didn't bet)
Seat 3: 33XJu1CVnl9YOngoPIhi0A (button) folded on the Turn
Seat 4: y9vGciYuJ4+4Z79YDgtBLg (small blind) folded before Flop
Seat 6: 3mTlg4g0FJN2bo939h/0Wg (big blind) collected ($63)



PokerStars Game #59955545676:  Hold'em No Limit ($5/$10) - 2009/07/01 9:06:37 ET
Table '2a86NK3xhs21kwGZmbj0QA' 6-max Seat #1 is the button
Seat 1: BbirlZJeYiPjSFVvLtEDVw ($1000 in chips)
Seat 2: z/zDzN9GsrGWKD4D635nKA ($1000 in chips)
Seat 3: 7nu3NHCN2s0uUleNuVaGww ($1230 in chips)
Seat 4: 33XJu1CVnl9YOngoPIhi0A ($2600 in chips)
Seat 5: 8PKEEFuiGhgwIgzB6GZWVQ ($393 in chips)
Seat 6: 3mTlg4g0FJN2bo939h/0Wg ($573 in chips)
z/zDzN9GsrGWKD4D635nKA: posts small blind $5
7nu3NHCN2s0uUleNuVaGww: posts big blind $10
*** HOLE CARDS ***
33XJu1CVnl9YOngoPIhi0A: folds
8PKEEFuiGhgwIgzB6GZWVQ: folds
3mTlg4g0FJN2bo939h/0Wg: folds
BbirlZJeYiPjSFVvLtEDVw: raises $20 to $30
z/zDzN9GsrGWKD4D635nKA: folds
7nu3NHCN2s0uUleNuVaGww: calls $20
*** FLOP *** [4h Kh 7s]
7nu3NHCN2s0uUleNuVaGww: checks
BbirlZJeYiPjSFVvLtEDVw: bets $40
7nu3NHCN2s0uUleNuVaGww: raises $95 to $135
BbirlZJeYiPjSFVvLtEDVw: folds
7nu3NHCN2s0uUleNuVaGww collected $142 from pot
*** SUMMARY ***
Total pot $145 | Rake $3
Board [4h Kh 7s]
Seat 1: BbirlZJeYiPjSFVvLtEDVw (button) folded on the Flop
Seat 2: z/zDzN9GsrGWKD4D635nKA (small blind) folded before Flop
Seat 3: 7nu3NHCN2s0uUleNuVaGww (big blind) collected ($142)
Seat 4: 33XJu1CVnl9YOngoPIhi0A folded before Flop (didn't bet)
Seat 5: 8PKEEFuiGhgwIgzB6GZWVQ folded before Flop (didn't bet)
Seat 6: 3mTlg4g0FJN2bo939h/0Wg folded before Flop (didn't bet)



PokerStars Game #59955560742:  Hold'em No Limit ($5/$10) - 2009/07/01 9:06:59 ET
Table 'agogFDSQKF+U0NUTbR6ZlA' 6-max Seat #4 is the button
Seat 1: ZaYCGtNHUeItoUEheoYDMw ($175 in chips)
Seat 2: BbirlZJeYiPjSFVvLtEDVw ($1038 in chips)
Seat 3: 33XJu1CVnl9YOngoPIhi0A ($955 in chips)
Seat 4: y9vGciYuJ4+4Z79YDgtBLg ($499 in chips)
Seat 6: 3mTlg4g0FJN2bo939h/0Wg ($241 in chips)
3mTlg4g0FJN2bo939h/0Wg: posts small blind $5
ZaYCGtNHUeItoUEheoYDMw: posts big blind $10
*** HOLE CARDS ***
BbirlZJeYiPjSFVvLtEDVw: folds
33XJu1CVnl9YOngoPIhi0A: folds
y9vGciYuJ4+4Z79YDgtBLg: folds
3mTlg4g0FJN2bo939h/0Wg: calls $5
ZaYCGtNHUeItoUEheoYDMw: checks
*** FLOP *** [8d Qd 7c]
3mTlg4g0FJN2bo939h/0Wg: checks
ZaYCGtNHUeItoUEheoYDMw: bets $10
3mTlg4g0FJN2bo939h/0Wg: folds
ZaYCGtNHUeItoUEheoYDMw collected $19 from pot
*** SUMMARY ***
Total pot $20 | Rake $1
Board [8d Qd 7c]
Seat 1: ZaYCGtNHUeItoUEheoYDMw (big blind) collected ($19)
Seat 2: BbirlZJeYiPjSFVvLtEDVw folded before Flop (didn't bet)
Seat 3: 33XJu1CVnl9YOngoPIhi0A folded before Flop (didn't bet)
Seat 4: y9vGciYuJ4+4Z79YDgtBLg (button) folded before Flop (didn't bet)
Seat 6: 3mTlg4g0FJN2bo939h/0Wg (small blind) folded on the Flop



PokerStars Game #59955580998:  Hold'em No Limit ($5/$10) - 2009/07/01 9:07:28 ET
Table '2a86NK3xhs21kwGZmbj0QA' 6-max Seat #2 is the button
Seat 1: BbirlZJeYiPjSFVvLtEDVw ($1000 in chips)
Seat 2: z/zDzN9GsrGWKD4D635nKA ($1000 in chips)
Seat 3: 7nu3NHCN2s0uUleNuVaGww ($1302 in chips)
Seat 4: 33XJu1CVnl9YOngoPIhi0A ($2600 in chips)
Seat 5: 8PKEEFuiGhgwIgzB6GZWVQ ($393 in chips)
Seat 6: 3mTlg4g0FJN2bo939h/0Wg ($573 in chips)
7nu3NHCN2s0uUleNuVaGww: posts small blind $5
33XJu1CVnl9YOngoPIhi0A: posts big blind $10
*** HOLE CARDS ***
8PKEEFuiGhgwIgzB6GZWVQ: folds
8PKEEFuiGhgwIgzB6GZWVQ leaves the table
3mTlg4g0FJN2bo939h/0Wg: folds
BbirlZJeYiPjSFVvLtEDVw: raises $20 to $30
z/zDzN9GsrGWKD4D635nKA: raises $70 to $100
7nu3NHCN2s0uUleNuVaGww: folds
33XJu1CVnl9YOngoPIhi0A: folds
BbirlZJeYiPjSFVvLtEDVw: folds
z/zDzN9GsrGWKD4D635nKA collected $75 from pot
z/zDzN9GsrGWKD4D635nKA: doesn't show hand
*** SUMMARY ***
Total pot $75 | Rake $0
Seat 1: BbirlZJeYiPjSFVvLtEDVw folded before Flop
Seat 2: z/zDzN9GsrGWKD4D635nKA (button) collected ($75)
Seat 3: 7nu3NHCN2s0uUleNuVaGww (small blind) folded before Flop
Seat 4: 33XJu1CVnl9YOngoPIhi0A (big blind) folded before Flop
Seat 5: 8PKEEFuiGhgwIgzB6GZWVQ folded before Flop (didn't bet)
Seat 6: 3mTlg4g0FJN2bo939h/0Wg folded before Flop (didn't bet)



PokerStars Game #59955591812:  Hold'em No Limit ($5/$10) - 2009/07/01 9:07:44 ET
Table 'agogFDSQKF+U0NUTbR6ZlA' 6-max Seat #6 is the button
Seat 1: ZaYCGtNHUeItoUEheoYDMw ($184 in chips)
Seat 2: BbirlZJeYiPjSFVvLtEDVw ($1038 in chips)
Seat 3: 33XJu1CVnl9YOngoPIhi0A ($955 in chips)
Seat 4: y9vGciYuJ4+4Z79YDgtBLg ($499 in chips)
Seat 6: 3mTlg4g0FJN2bo939h/0Wg ($231 in chips)
ZaYCGtNHUeItoUEheoYDMw: posts small blind $5
BbirlZJeYiPjSFVvLtEDVw: posts big blind $10
*** HOLE CARDS ***
33XJu1CVnl9YOngoPIhi0A: folds
y9vGciYuJ4+4Z79YDgtBLg: calls $10
3mTlg4g0FJN2bo939h/0Wg: folds
ZaYCGtNHUeItoUEheoYDMw: calls $5
BbirlZJeYiPjSFVvLtEDVw: raises $10 to $20
y9vGciYuJ4+4Z79YDgtBLg: calls $10
ZaYCGtNHUeItoUEheoYDMw: calls $10
*** FLOP *** [4d 7h 4s]
ZaYCGtNHUeItoUEheoYDMw: checks
BbirlZJeYiPjSFVvLtEDVw: checks
y9vGciYuJ4+4Z79YDgtBLg: checks
*** TURN *** [4d 7h 4s] [Ts]
ZaYCGtNHUeItoUEheoYDMw: checks
BbirlZJeYiPjSFVvLtEDVw: checks
y9vGciYuJ4+4Z79YDgtBLg: bets $30
ZaYCGtNHUeItoUEheoYDMw: folds
BbirlZJeYiPjSFVvLtEDVw: folds
y9vGciYuJ4+4Z79YDgtBLg collected $58 from pot
*** SUMMARY ***
Total pot $60 | Rake $2
Board [4d 7h 4s Ts]
Seat 1: ZaYCGtNHUeItoUEheoYDMw (small blind) folded on the Turn
Seat 2: BbirlZJeYiPjSFVvLtEDVw (big blind) folded on the Turn
Seat 3: 33XJu1CVnl9YOngoPIhi0A folded before Flop (didn't bet)
Seat 4: y9vGciYuJ4+4Z79YDgtBLg collected ($58)
Seat 6: 3mTlg4g0FJN2bo939h/0Wg (button) folded before Flop (didn't bet)



PokerStars Game #59955600374:  Hold'em No Limit ($5/$10) - 2009/07/01 9:07:56 ET
Table '2a86NK3xhs21kwGZmbj0QA' 6-max Seat #3 is the button
Seat 1: BbirlZJeYiPjSFVvLtEDVw ($1000 in chips)
Seat 2: z/zDzN9GsrGWKD4D635nKA ($1045 in chips)
Seat 3: 7nu3NHCN2s0uUleNuVaGww ($1297 in chips)
Seat 4: 33XJu1CVnl9YOngoPIhi0A ($2590 in chips)
Seat 6: 3mTlg4g0FJN2bo939h/0Wg ($573 in chips)
33XJu1CVnl9YOngoPIhi0A: posts small blind $5
3mTlg4g0FJN2bo939h/0Wg: posts big blind $10
*** HOLE CARDS ***
BbirlZJeYiPjSFVvLtEDVw: folds
z/zDzN9GsrGWKD4D635nKA: folds
7nu3NHCN2s0uUleNuVaGww: folds
33XJu1CVnl9YOngoPIhi0A: folds
3mTlg4g0FJN2bo939h/0Wg collected $10 from pot
*** SUMMARY ***
Total pot $10 | Rake $0
Seat 1: BbirlZJeYiPjSFVvLtEDVw folded before Flop (didn't bet)
Seat 2: z/zDzN9GsrGWKD4D635nKA folded before Flop (didn't bet)
Seat 3: 7nu3NHCN2s0uUleNuVaGww (button) folded before Flop (didn't bet)
Seat 4: 33XJu1CVnl9YOngoPIhi0A (small blind) folded before Flop
Seat 6: 3mTlg4g0FJN2bo939h/0Wg (big blind) collected ($10)



PokerStars Game #59955613704:  Hold'em No Limit ($5/$10) - 2009/07/01 9:08:16 ET
Table '2a86NK3xhs21kwGZmbj0QA' 6-max Seat #4 is the button
Seat 1: BbirlZJeYiPjSFVvLtEDVw ($1000 in chips)
Seat 2: z/zDzN9GsrGWKD4D635nKA ($1045 in chips)
Seat 3: 7nu3NHCN2s0uUleNuVaGww ($1297 in chips)
Seat 4: 33XJu1CVnl9YOngoPIhi0A ($2585 in chips)
Seat 6: 3mTlg4g0FJN2bo939h/0Wg ($578 in chips)
3mTlg4g0FJN2bo939h/0Wg: posts small blind $5
BbirlZJeYiPjSFVvLtEDVw: posts big blind $10
*** HOLE CARDS ***
z/zDzN9GsrGWKD4D635nKA: folds
7nu3NHCN2s0uUleNuVaGww: folds
33XJu1CVnl9YOngoPIhi0A: folds
3mTlg4g0FJN2bo939h/0Wg: calls $5
BbirlZJeYiPjSFVvLtEDVw: checks
*** FLOP *** [Jd Js Td]
3mTlg4g0FJN2bo939h/0Wg: bets $20
BbirlZJeYiPjSFVvLtEDVw: folds
3mTlg4g0FJN2bo939h/0Wg collected $19 from pot
*** SUMMARY ***
Total pot $20 | Rake $1
Board [Jd Js Td]
Seat 1: BbirlZJeYiPjSFVvLtEDVw (big blind) folded on the Flop
Seat 2: z/zDzN9GsrGWKD4D635nKA folded before Flop (didn't bet)
Seat 3: 7nu3NHCN2s0uUleNuVaGww folded before Flop (didn't bet)
Seat 4: 33XJu1CVnl9YOngoPIhi0A (button) folded before Flop (didn't bet)
Seat 6: 3mTlg4g0FJN2bo939h/0Wg (small blind) collected ($19)



PokerStars Game #59955630044:  Hold'em No Limit ($5/$10) - 2009/07/01 9:08:40 ET
Table '2a86NK3xhs21kwGZmbj0QA' 6-max Seat #6 is the button
Seat 1: BbirlZJeYiPjSFVvLtEDVw ($1000 in chips)
Seat 2: z/zDzN9GsrGWKD4D635nKA ($1045 in chips)
Seat 3: 7nu3NHCN2s0uUleNuVaGww ($1297 in chips)
Seat 4: 33XJu1CVnl9YOngoPIhi0A ($2585 in chips)
Seat 6: 3mTlg4g0FJN2bo939h/0Wg ($587 in chips)
BbirlZJeYiPjSFVvLtEDVw: posts small blind $5
z/zDzN9GsrGWKD4D635nKA: posts big blind $10
*** HOLE CARDS ***
7nu3NHCN2s0uUleNuVaGww: folds
33XJu1CVnl9YOngoPIhi0A: folds
3mTlg4g0FJN2bo939h/0Wg: folds
BbirlZJeYiPjSFVvLtEDVw: raises $20 to $30
z/zDzN9GsrGWKD4D635nKA: folds
BbirlZJeYiPjSFVvLtEDVw collected $20 from pot
BbirlZJeYiPjSFVvLtEDVw: doesn't show hand
*** SUMMARY ***
Total pot $20 | Rake $0
Seat 1: BbirlZJeYiPjSFVvLtEDVw (small blind) collected ($20)
Seat 2: z/zDzN9GsrGWKD4D635nKA (big blind) folded before Flop
Seat 3: 7nu3NHCN2s0uUleNuVaGww folded before Flop (didn't bet)
Seat 4: 33XJu1CVnl9YOngoPIhi0A folded before Flop (didn't bet)
Seat 6: 3mTlg4g0FJN2bo939h/0Wg (button) folded before Flop (didn't bet)



PokerStars Game #59955633930:  Hold'em No Limit ($5/$10) - 2009/07/01 9:08:45 ET
Table 'agogFDSQKF+U0NUTbR6ZlA' 6-max Seat #1 is the button
Seat 1: ZaYCGtNHUeItoUEheoYDMw ($164 in chips)
Seat 2: BbirlZJeYiPjSFVvLtEDVw ($1018 in chips)
Seat 3: 33XJu1CVnl9YOngoPIhi0A ($955 in chips)
Seat 4: y9vGciYuJ4+4Z79YDgtBLg ($537 in chips)
Seat 6: 3mTlg4g0FJN2bo939h/0Wg ($231 in chips)
dywrHhCI+xO1Q+U4dfdVaQ joins the table at seat #5
BbirlZJeYiPjSFVvLtEDVw: posts small blind $5
33XJu1CVnl9YOngoPIhi0A: posts big blind $10
*** HOLE CARDS ***
y9vGciYuJ4+4Z79YDgtBLg: folds
3mTlg4g0FJN2bo939h/0Wg: folds
ZaYCGtNHUeItoUEheoYDMw: raises $10 to $20
BbirlZJeYiPjSFVvLtEDVw: folds
33XJu1CVnl9YOngoPIhi0A: calls $10
*** FLOP *** [Js 6d 6s]
33XJu1CVnl9YOngoPIhi0A: checks
ZaYCGtNHUeItoUEheoYDMw: bets $20
33XJu1CVnl9YOngoPIhi0A: raises $40 to $60
ZaYCGtNHUeItoUEheoYDMw: folds
33XJu1CVnl9YOngoPIhi0A collected $83 from pot
*** SUMMARY ***
Total pot $85 | Rake $2
Board [Js 6d 6s]
Seat 1: ZaYCGtNHUeItoUEheoYDMw (button) folded on the Flop
Seat 2: BbirlZJeYiPjSFVvLtEDVw (small blind) folded before Flop
Seat 3: 33XJu1CVnl9YOngoPIhi0A (big blind) collected ($83)
Seat 4: y9vGciYuJ4+4Z79YDgtBLg folded before Flop (didn't bet)
Seat 6: 3mTlg4g0FJN2bo939h/0Wg folded before Flop (didn't bet)



PokerStars Game #59955641230:  Hold'em No Limit ($5/$10) - 2009/07/01 9:08:56 ET
Table '2a86NK3xhs21kwGZmbj0QA' 6-max Seat #1 is the button
Seat 1: BbirlZJeYiPjSFVvLtEDVw ($1010 in chips)
Seat 2: z/zDzN9GsrGWKD4D635nKA ($1035 in chips)
Seat 3: 7nu3NHCN2s0uUleNuVaGww ($1297 in chips)
Seat 4: 33XJu1CVnl9YOngoPIhi0A ($2585 in chips)
Seat 6: 3mTlg4g0FJN2bo939h/0Wg ($587 in chips)
z/zDzN9GsrGWKD4D635nKA: posts small blind $5
7nu3NHCN2s0uUleNuVaGww: posts big blind $10
*** HOLE CARDS ***
33XJu1CVnl9YOngoPIhi0A: folds
3mTlg4g0FJN2bo939h/0Wg: raises $10 to $20
BbirlZJeYiPjSFVvLtEDVw: folds
z/zDzN9GsrGWKD4D635nKA: folds
7nu3NHCN2s0uUleNuVaGww: folds
3mTlg4g0FJN2bo939h/0Wg collected $25 from pot
*** SUMMARY ***
Total pot $25 | Rake $0
Seat 1: BbirlZJeYiPjSFVvLtEDVw (button) folded before Flop (didn't bet)
Seat 2: z/zDzN9GsrGWKD4D635nKA (small blind) folded before Flop
Seat 3: 7nu3NHCN2s0uUleNuVaGww (big blind) folded before Flop
Seat 4: 33XJu1CVnl9YOngoPIhi0A folded before Flop (didn't bet)
Seat 6: 3mTlg4g0FJN2bo939h/0Wg collected ($25)



PokerStars Game #59955661858:  Hold'em No Limit ($5/$10) - 2009/07/01 9:09:26 ET
Table '2a86NK3xhs21kwGZmbj0QA' 6-max Seat #2 is the button
Seat 1: BbirlZJeYiPjSFVvLtEDVw ($1010 in chips)
Seat 2: z/zDzN9GsrGWKD4D635nKA ($1030 in chips)
Seat 3: 7nu3NHCN2s0uUleNuVaGww ($1287 in chips)
Seat 4: 33XJu1CVnl9YOngoPIhi0A ($2585 in chips)
Seat 6: 3mTlg4g0FJN2bo939h/0Wg ($602 in chips)
7nu3NHCN2s0uUleNuVaGww: posts small blind $5
33XJu1CVnl9YOngoPIhi0A: posts big blind $10
*** HOLE CARDS ***
3mTlg4g0FJN2bo939h/0Wg: folds
BbirlZJeYiPjSFVvLtEDVw: folds
z/zDzN9GsrGWKD4D635nKA: folds
7nu3NHCN2s0uUleNuVaGww: folds
33XJu1CVnl9YOngoPIhi0A collected $10 from pot
33XJu1CVnl9YOngoPIhi0A: doesn't show hand
*** SUMMARY ***
Total pot $10 | Rake $0
Seat 1: BbirlZJeYiPjSFVvLtEDVw folded before Flop (didn't bet)
Seat 2: z/zDzN9GsrGWKD4D635nKA (button) folded before Flop (didn't bet)
Seat 3: 7nu3NHCN2s0uUleNuVaGww (small blind) folded before Flop
Seat 4: 33XJu1CVnl9YOngoPIhi0A (big blind) collected ($10)
Seat 6: 3mTlg4g0FJN2bo939h/0Wg folded before Flop (didn't bet)



PokerStars Game #59955671896:  Hold'em No Limit ($5/$10) - 2009/07/01 9:09:41 ET
Table '2a86NK3xhs21kwGZmbj0QA' 6-max Seat #3 is the button
Seat 1: BbirlZJeYiPjSFVvLtEDVw ($1010 in chips)
Seat 2: z/zDzN9GsrGWKD4D635nKA ($1030 in chips)
Seat 3: 7nu3NHCN2s0uUleNuVaGww ($1282 in chips)
Seat 4: 33XJu1CVnl9YOngoPIhi0A ($2590 in chips)
Seat 6: 3mTlg4g0FJN2bo939h/0Wg ($602 in chips)
33XJu1CVnl9YOngoPIhi0A: posts small blind $5
3mTlg4g0FJN2bo939h/0Wg: posts big blind $10
*** HOLE CARDS ***
BbirlZJeYiPjSFVvLtEDVw: folds
z/zDzN9GsrGWKD4D635nKA: folds
7nu3NHCN2s0uUleNuVaGww: folds
33XJu1CVnl9YOngoPIhi0A: raises $20 to $30
3mTlg4g0FJN2bo939h/0Wg: calls $20
*** FLOP *** [Jc 9s Jd]
33XJu1CVnl9YOngoPIhi0A: checks
3mTlg4g0FJN2bo939h/0Wg: checks
*** TURN *** [Jc 9s Jd] [9c]
33XJu1CVnl9YOngoPIhi0A: checks
3mTlg4g0FJN2bo939h/0Wg: bets $30
33XJu1CVnl9YOngoPIhi0A: folds
3mTlg4g0FJN2bo939h/0Wg collected $58 from pot
*** SUMMARY ***
Total pot $60 | Rake $2
Board [Jc 9s Jd 9c]
Seat 1: BbirlZJeYiPjSFVvLtEDVw folded before Flop (didn't bet)
Seat 2: z/zDzN9GsrGWKD4D635nKA folded before Flop (didn't bet)
Seat 3: 7nu3NHCN2s0uUleNuVaGww (button) folded before Flop (didn't bet)
Seat 4: 33XJu1CVnl9YOngoPIhi0A (small blind) folded on the Turn
Seat 6: 3mTlg4g0FJN2bo939h/0Wg (big blind) collected ($58)



PokerStars Game #59955680130:  Hold'em No Limit ($5/$10) - 2009/07/01 9:09:53 ET
Table 'agogFDSQKF+U0NUTbR6ZlA' 6-max Seat #2 is the button
Seat 1: ZaYCGtNHUeItoUEheoYDMw ($124 in chips)
Seat 2: BbirlZJeYiPjSFVvLtEDVw ($1013 in chips)
Seat 3: 33XJu1CVnl9YOngoPIhi0A ($998 in chips)
Seat 4: y9vGciYuJ4+4Z79YDgtBLg ($537 in chips)
Seat 6: 3mTlg4g0FJN2bo939h/0Wg ($231 in chips)
33XJu1CVnl9YOngoPIhi0A: posts small blind $5
y9vGciYuJ4+4Z79YDgtBLg: posts big blind $10
dywrHhCI+xO1Q+U4dfdVaQ: sits out
*** HOLE CARDS ***
3mTlg4g0FJN2bo939h/0Wg: folds
ZaYCGtNHUeItoUEheoYDMw: folds
BbirlZJeYiPjSFVvLtEDVw: raises $20 to $30
33XJu1CVnl9YOngoPIhi0A: folds
y9vGciYuJ4+4Z79YDgtBLg: folds
BbirlZJeYiPjSFVvLtEDVw collected $25 from pot
*** SUMMARY ***
Total pot $25 | Rake $0
Seat 1: ZaYCGtNHUeItoUEheoYDMw folded before Flop (didn't bet)
Seat 2: BbirlZJeYiPjSFVvLtEDVw (button) collected ($25)
Seat 3: 33XJu1CVnl9YOngoPIhi0A (small blind) folded before Flop
Seat 4: y9vGciYuJ4+4Z79YDgtBLg (big blind) folded before Flop
Seat 6: 3mTlg4g0FJN2bo939h/0Wg folded before Flop (didn't bet)



PokerStars Game #59955696648:  Hold'em No Limit ($5/$10) - 2009/07/01 9:10:17 ET
Table '2a86NK3xhs21kwGZmbj0QA' 6-max Seat #4 is the button
Seat 1: BbirlZJeYiPjSFVvLtEDVw ($1010 in chips)
Seat 2: z/zDzN9GsrGWKD4D635nKA ($1030 in chips)
Seat 3: 7nu3NHCN2s0uUleNuVaGww ($1282 in chips)
Seat 4: 33XJu1CVnl9YOngoPIhi0A ($2560 in chips)
Seat 6: 3mTlg4g0FJN2bo939h/0Wg ($630 in chips)
3mTlg4g0FJN2bo939h/0Wg: posts small blind $5
BbirlZJeYiPjSFVvLtEDVw: posts big blind $10
*** HOLE CARDS ***
z/zDzN9GsrGWKD4D635nKA: folds
7nu3NHCN2s0uUleNuVaGww: raises $20 to $30
33XJu1CVnl9YOngoPIhi0A: folds
AP3ihgkR8SLQyf0O1jly0g joins the table at seat #5
3mTlg4g0FJN2bo939h/0Wg: folds
BbirlZJeYiPjSFVvLtEDVw: folds
7nu3NHCN2s0uUleNuVaGww collected $25 from pot
*** SUMMARY ***
Total pot $25 | Rake $0
Seat 1: BbirlZJeYiPjSFVvLtEDVw (big blind) folded before Flop
Seat 2: z/zDzN9GsrGWKD4D635nKA folded before Flop (didn't bet)
Seat 3: 7nu3NHCN2s0uUleNuVaGww collected ($25)
Seat 4: 33XJu1CVnl9YOngoPIhi0A (button) folded before Flop (didn't bet)
Seat 6: 3mTlg4g0FJN2bo939h/0Wg (small blind) folded before Flop



PokerStars Game #59955699044:  Hold'em No Limit ($5/$10) - 2009/07/01 9:10:20 ET
Table 'agogFDSQKF+U0NUTbR6ZlA' 6-max Seat #3 is the button
Seat 1: ZaYCGtNHUeItoUEheoYDMw ($124 in chips)
Seat 2: BbirlZJeYiPjSFVvLtEDVw ($1028 in chips)
Seat 3: 33XJu1CVnl9YOngoPIhi0A ($993 in chips)
Seat 4: y9vGciYuJ4+4Z79YDgtBLg ($527 in chips)
Seat 5: dywrHhCI+xO1Q+U4dfdVaQ ($1000 in chips)
Seat 6: 3mTlg4g0FJN2bo939h/0Wg ($231 in chips)
y9vGciYuJ4+4Z79YDgtBLg: posts small blind $5
dywrHhCI+xO1Q+U4dfdVaQ: posts big blind $10
*** HOLE CARDS ***
3mTlg4g0FJN2bo939h/0Wg: folds
ZaYCGtNHUeItoUEheoYDMw: folds
BbirlZJeYiPjSFVvLtEDVw: raises $20 to $30
33XJu1CVnl9YOngoPIhi0A: folds
y9vGciYuJ4+4Z79YDgtBLg: calls $25
dywrHhCI+xO1Q+U4dfdVaQ: folds
*** FLOP *** [Kc As Qd]
y9vGciYuJ4+4Z79YDgtBLg: checks
BbirlZJeYiPjSFVvLtEDVw: bets $50
y9vGciYuJ4+4Z79YDgtBLg: folds
BbirlZJeYiPjSFVvLtEDVw collected $67 from pot
*** SUMMARY ***
Total pot $70 | Rake $3
Board [Kc As Qd]
Seat 1: ZaYCGtNHUeItoUEheoYDMw folded before Flop (didn't bet)
Seat 2: BbirlZJeYiPjSFVvLtEDVw collected ($67)
Seat 3: 33XJu1CVnl9YOngoPIhi0A (button) folded before Flop (didn't bet)
Seat 4: y9vGciYuJ4+4Z79YDgtBLg (small blind) folded on the Flop
Seat 5: dywrHhCI+xO1Q+U4dfdVaQ (big blind) folded before Flop
Seat 6: 3mTlg4g0FJN2bo939h/0Wg folded before Flop (didn't bet)



PokerStars Game #59955716404:  Hold'em No Limit ($5/$10) - 2009/07/01 9:10:45 ET
Table '2a86NK3xhs21kwGZmbj0QA' 6-max Seat #6 is the button
Seat 1: BbirlZJeYiPjSFVvLtEDVw ($1000 in chips)
Seat 2: z/zDzN9GsrGWKD4D635nKA ($1030 in chips)
Seat 3: 7nu3NHCN2s0uUleNuVaGww ($1297 in chips)
Seat 4: 33XJu1CVnl9YOngoPIhi0A ($2560 in chips)
Seat 6: 3mTlg4g0FJN2bo939h/0Wg ($625 in chips)
BbirlZJeYiPjSFVvLtEDVw: posts small blind $5
z/zDzN9GsrGWKD4D635nKA: posts big blind $10
AP3ihgkR8SLQyf0O1jly0g: sits out
*** HOLE CARDS ***
7nu3NHCN2s0uUleNuVaGww: folds
33XJu1CVnl9YOngoPIhi0A: folds
3mTlg4g0FJN2bo939h/0Wg: raises $10 to $20
BbirlZJeYiPjSFVvLtEDVw: calls $15
z/zDzN9GsrGWKD4D635nKA: folds
*** FLOP *** [9h 8s Jd]
BbirlZJeYiPjSFVvLtEDVw: checks
3mTlg4g0FJN2bo939h/0Wg: bets $20
BbirlZJeYiPjSFVvLtEDVw: calls $20
*** TURN *** [9h 8s Jd] [8h]
BbirlZJeYiPjSFVvLtEDVw: checks
3mTlg4g0FJN2bo939h/0Wg: checks
*** RIVER *** [9h 8s Jd 8h] [Qh]
BbirlZJeYiPjSFVvLtEDVw: bets $60
3mTlg4g0FJN2bo939h/0Wg: raises $60 to $120
BbirlZJeYiPjSFVvLtEDVw: calls $60
*** SHOW DOWN ***
3mTlg4g0FJN2bo939h/0Wg: shows [Ah Ts] (a straight, Eight to Queen)
BbirlZJeYiPjSFVvLtEDVw: shows [Td Kc] (a straight, Nine to King)
BbirlZJeYiPjSFVvLtEDVw collected $328 from pot
*** SUMMARY ***
Total pot $330 | Rake $2
Board [9h 8s Jd 8h Qh]
Seat 1: BbirlZJeYiPjSFVvLtEDVw (small blind) showed [Td Kc] and won ($328) with a straight, Nine to King
Seat 2: z/zDzN9GsrGWKD4D635nKA (big blind) folded before Flop
Seat 3: 7nu3NHCN2s0uUleNuVaGww folded before Flop (didn't bet)
Seat 4: 33XJu1CVnl9YOngoPIhi0A folded before Flop (didn't bet)
Seat 6: 3mTlg4g0FJN2bo939h/0Wg (button) showed [Ah Ts] and lost with a straight, Eight to Queen



PokerStars Game #59955732128:  Hold'em No Limit ($5/$10) - 2009/07/01 9:11:08 ET
Table 'agogFDSQKF+U0NUTbR6ZlA' 6-max Seat #4 is the button
Seat 1: ZaYCGtNHUeItoUEheoYDMw ($124 in chips)
Seat 2: BbirlZJeYiPjSFVvLtEDVw ($1065 in chips)
Seat 3: 33XJu1CVnl9YOngoPIhi0A ($993 in chips)
Seat 4: y9vGciYuJ4+4Z79YDgtBLg ($497 in chips)
Seat 5: dywrHhCI+xO1Q+U4dfdVaQ ($1000 in chips)
Seat 6: 3mTlg4g0FJN2bo939h/0Wg ($231 in chips)
dywrHhCI+xO1Q+U4dfdVaQ: posts small blind $5
3mTlg4g0FJN2bo939h/0Wg: posts big blind $10
*** HOLE CARDS ***
ZaYCGtNHUeItoUEheoYDMw: folds
BbirlZJeYiPjSFVvLtEDVw: folds
33XJu1CVnl9YOngoPIhi0A: folds
y9vGciYuJ4+4Z79YDgtBLg: folds
dywrHhCI+xO1Q+U4dfdVaQ: raises $20 to $30
3mTlg4g0FJN2bo939h/0Wg: calls $20
*** FLOP *** [4h Qh 7h]
dywrHhCI+xO1Q+U4dfdVaQ: bets $30
3mTlg4g0FJN2bo939h/0Wg: folds
dywrHhCI+xO1Q+U4dfdVaQ collected $57 from pot
*** SUMMARY ***
Total pot $60 | Rake $3
Board [4h Qh 7h]
Seat 1: ZaYCGtNHUeItoUEheoYDMw folded before Flop (didn't bet)
Seat 2: BbirlZJeYiPjSFVvLtEDVw folded before Flop (didn't bet)
Seat 3: 33XJu1CVnl9YOngoPIhi0A folded before Flop (didn't bet)
Seat 4: y9vGciYuJ4+4Z79YDgtBLg (button) folded before Flop (didn't bet)
Seat 5: dywrHhCI+xO1Q+U4dfdVaQ (small blind) collected ($57)
Seat 6: 3mTlg4g0FJN2bo939h/0Wg (big blind) folded on the Flop



PokerStars Game #59955754770:  Hold'em No Limit ($5/$10) - 2009/07/01 9:11:41 ET
Table 'agogFDSQKF+U0NUTbR6ZlA' 6-max Seat #5 is the button
Seat 1: ZaYCGtNHUeItoUEheoYDMw ($124 in chips)
Seat 2: BbirlZJeYiPjSFVvLtEDVw ($1065 in chips)
Seat 3: 33XJu1CVnl9YOngoPIhi0A ($993 in chips)
Seat 4: y9vGciYuJ4+4Z79YDgtBLg ($497 in chips)
Seat 5: dywrHhCI+xO1Q+U4dfdVaQ ($1027 in chips)
Seat 6: 3mTlg4g0FJN2bo939h/0Wg ($201 in chips)
3mTlg4g0FJN2bo939h/0Wg: posts small blind $5
ZaYCGtNHUeItoUEheoYDMw: posts big blind $10
*** HOLE CARDS ***
BbirlZJeYiPjSFVvLtEDVw: folds
33XJu1CVnl9YOngoPIhi0A: folds
y9vGciYuJ4+4Z79YDgtBLg: folds
dywrHhCI+xO1Q+U4dfdVaQ: raises $10 to $20
3mTlg4g0FJN2bo939h/0Wg: folds
ZaYCGtNHUeItoUEheoYDMw: folds
dywrHhCI+xO1Q+U4dfdVaQ collected $25 from pot
*** SUMMARY ***
Total pot $25 | Rake $0
Seat 1: ZaYCGtNHUeItoUEheoYDMw (big blind) folded before Flop
Seat 2: BbirlZJeYiPjSFVvLtEDVw folded before Flop (didn't bet)
Seat 3: 33XJu1CVnl9YOngoPIhi0A folded before Flop (didn't bet)
Seat 4: y9vGciYuJ4+4Z79YDgtBLg folded before Flop (didn't bet)
Seat 5: dywrHhCI+xO1Q+U4dfdVaQ (button) collected ($25)
Seat 6: 3mTlg4g0FJN2bo939h/0Wg (small blind) folded before Flop



PokerStars Game #59955769460:  Hold'em No Limit ($5/$10) - 2009/07/01 9:12:03 ET
Table '2a86NK3xhs21kwGZmbj0QA' 6-max Seat #1 is the button
Seat 1: BbirlZJeYiPjSFVvLtEDVw ($1168 in chips)
Seat 2: z/zDzN9GsrGWKD4D635nKA ($1020 in chips)
Seat 3: 7nu3NHCN2s0uUleNuVaGww ($1297 in chips)
Seat 4: 33XJu1CVnl9YOngoPIhi0A ($2560 in chips)
Seat 6: 3mTlg4g0FJN2bo939h/0Wg ($465 in chips)
z/zDzN9GsrGWKD4D635nKA: posts small blind $5
7nu3NHCN2s0uUleNuVaGww: posts big blind $10
AP3ihgkR8SLQyf0O1jly0g: sits out
*** HOLE CARDS ***
33XJu1CVnl9YOngoPIhi0A: folds
3mTlg4g0FJN2bo939h/0Wg: folds
BbirlZJeYiPjSFVvLtEDVw: folds
z/zDzN9GsrGWKD4D635nKA: folds
7nu3NHCN2s0uUleNuVaGww collected $10 from pot
*** SUMMARY ***
Total pot $10 | Rake $0
Seat 1: BbirlZJeYiPjSFVvLtEDVw (button) folded before Flop (didn't bet)
Seat 2: z/zDzN9GsrGWKD4D635nKA (small blind) folded before Flop
Seat 3: 7nu3NHCN2s0uUleNuVaGww (big blind) collected ($10)
Seat 4: 33XJu1CVnl9YOngoPIhi0A folded before Flop (didn't bet)
Seat 6: 3mTlg4g0FJN2bo939h/0Wg folded before Flop (didn't bet)



PokerStars Game #59955785070:  Hold'em No Limit ($5/$10) - 2009/07/01 9:12:25 ET
Table '2a86NK3xhs21kwGZmbj0QA' 6-max Seat #2 is the button
Seat 1: BbirlZJeYiPjSFVvLtEDVw ($1168 in chips)
Seat 2: z/zDzN9GsrGWKD4D635nKA ($1015 in chips)
Seat 3: 7nu3NHCN2s0uUleNuVaGww ($1302 in chips)
Seat 4: 33XJu1CVnl9YOngoPIhi0A ($2560 in chips)
Seat 6: 3mTlg4g0FJN2bo939h/0Wg ($465 in chips)
7nu3NHCN2s0uUleNuVaGww: posts small blind $5
33XJu1CVnl9YOngoPIhi0A: posts big blind $10
AP3ihgkR8SLQyf0O1jly0g: sits out
*** HOLE CARDS ***
3mTlg4g0FJN2bo939h/0Wg: folds
BbirlZJeYiPjSFVvLtEDVw: folds
z/zDzN9GsrGWKD4D635nKA: raises $20 to $30
7nu3NHCN2s0uUleNuVaGww: folds
AP3ihgkR8SLQyf0O1jly0g said, "goodafternoon everybody"
33XJu1CVnl9YOngoPIhi0A: folds
z/zDzN9GsrGWKD4D635nKA collected $25 from pot
z/zDzN9GsrGWKD4D635nKA: doesn't show hand
*** SUMMARY ***
Total pot $25 | Rake $0
Seat 1: BbirlZJeYiPjSFVvLtEDVw folded before Flop (didn't bet)
Seat 2: z/zDzN9GsrGWKD4D635nKA (button) collected ($25)
Seat 3: 7nu3NHCN2s0uUleNuVaGww (small blind) folded before Flop
Seat 4: 33XJu1CVnl9YOngoPIhi0A (big blind) folded before Flop
Seat 6: 3mTlg4g0FJN2bo939h/0Wg folded before Flop (didn't bet)



PokerStars Game #59955795040:  Hold'em No Limit ($5/$10) - 2009/07/01 9:12:40 ET
Table 'agogFDSQKF+U0NUTbR6ZlA' 6-max Seat #6 is the button
Seat 1: ZaYCGtNHUeItoUEheoYDMw ($114 in chips)
Seat 2: BbirlZJeYiPjSFVvLtEDVw ($1065 in chips)
Seat 3: 33XJu1CVnl9YOngoPIhi0A ($993 in chips)
Seat 4: y9vGciYuJ4+4Z79YDgtBLg ($497 in chips)
Seat 5: dywrHhCI+xO1Q+U4dfdVaQ ($1042 in chips)
Seat 6: 3mTlg4g0FJN2bo939h/0Wg ($196 in chips)
ZaYCGtNHUeItoUEheoYDMw: posts small blind $5
BbirlZJeYiPjSFVvLtEDVw: posts big blind $10
*** HOLE CARDS ***
33XJu1CVnl9YOngoPIhi0A: folds
y9vGciYuJ4+4Z79YDgtBLg: folds
dywrHhCI+xO1Q+U4dfdVaQ: folds
3mTlg4g0FJN2bo939h/0Wg: folds
ZaYCGtNHUeItoUEheoYDMw: raises $104 to $114 and is all-in
BbirlZJeYiPjSFVvLtEDVw: folds
ZaYCGtNHUeItoUEheoYDMw collected $20 from pot
*** SUMMARY ***
Total pot $20 | Rake $0
Seat 1: ZaYCGtNHUeItoUEheoYDMw (small blind) collected ($20)
Seat 2: BbirlZJeYiPjSFVvLtEDVw (big blind) folded before Flop
Seat 3: 33XJu1CVnl9YOngoPIhi0A folded before Flop (didn't bet)
Seat 4: y9vGciYuJ4+4Z79YDgtBLg folded before Flop (didn't bet)
Seat 5: dywrHhCI+xO1Q+U4dfdVaQ folded before Flop (didn't bet)
Seat 6: 3mTlg4g0FJN2bo939h/0Wg (button) folded before Flop (didn't bet)



PokerStars Game #59955800010:  Hold'em No Limit ($5/$10) - 2009/07/01 9:12:47 ET
Table '2a86NK3xhs21kwGZmbj0QA' 6-max Seat #3 is the button
Seat 1: BbirlZJeYiPjSFVvLtEDVw ($1168 in chips)
Seat 2: z/zDzN9GsrGWKD4D635nKA ($1030 in chips)
Seat 3: 7nu3NHCN2s0uUleNuVaGww ($1297 in chips)
Seat 4: 33XJu1CVnl9YOngoPIhi0A ($2550 in chips)
Seat 5: AP3ihgkR8SLQyf0O1jly0g ($375 in chips)
Seat 6: 3mTlg4g0FJN2bo939h/0Wg ($465 in chips)
33XJu1CVnl9YOngoPIhi0A: posts small blind $5
AP3ihgkR8SLQyf0O1jly0g: posts big blind $10
*** HOLE CARDS ***
3mTlg4g0FJN2bo939h/0Wg: folds
BbirlZJeYiPjSFVvLtEDVw: folds
z/zDzN9GsrGWKD4D635nKA: raises $20 to $30
7nu3NHCN2s0uUleNuVaGww: folds
33XJu1CVnl9YOngoPIhi0A: folds
AP3ihgkR8SLQyf0O1jly0g: calls $20
*** FLOP *** [7s 6s 6d]
AP3ihgkR8SLQyf0O1jly0g: checks
z/zDzN9GsrGWKD4D635nKA: bets $40
AP3ihgkR8SLQyf0O1jly0g: raises $80 to $120
z/zDzN9GsrGWKD4D635nKA: folds
AP3ihgkR8SLQyf0O1jly0g collected $142 from pot
AP3ihgkR8SLQyf0O1jly0g: doesn't show hand
*** SUMMARY ***
Total pot $145 | Rake $3
Board [7s 6s 6d]
Seat 1: BbirlZJeYiPjSFVvLtEDVw folded before Flop (didn't bet)
Seat 2: z/zDzN9GsrGWKD4D635nKA folded on the Flop
Seat 3: 7nu3NHCN2s0uUleNuVaGww (button) folded before Flop (didn't bet)
Seat 4: 33XJu1CVnl9YOngoPIhi0A (small blind) folded before Flop
Seat 5: AP3ihgkR8SLQyf0O1jly0g (big blind) collected ($142)
Seat 6: 3mTlg4g0FJN2bo939h/0Wg folded before Flop (didn't bet)



PokerStars Game #59955811028:  Hold'em No Limit ($5/$10) - 2009/07/01 9:13:03 ET
Table 'agogFDSQKF+U0NUTbR6ZlA' 6-max Seat #1 is the button
Seat 1: ZaYCGtNHUeItoUEheoYDMw ($124 in chips)
Seat 2: BbirlZJeYiPjSFVvLtEDVw ($1055 in chips)
Seat 3: 33XJu1CVnl9YOngoPIhi0A ($993 in chips)
Seat 4: y9vGciYuJ4+4Z79YDgtBLg ($497 in chips)
Seat 5: dywrHhCI+xO1Q+U4dfdVaQ ($1042 in chips)
Seat 6: 3mTlg4g0FJN2bo939h/0Wg ($196 in chips)
BbirlZJeYiPjSFVvLtEDVw: posts small blind $5
33XJu1CVnl9YOngoPIhi0A: posts big blind $10
*** HOLE CARDS ***
y9vGciYuJ4+4Z79YDgtBLg: folds
dywrHhCI+xO1Q+U4dfdVaQ: raises $20 to $30
3mTlg4g0FJN2bo939h/0Wg: folds
ZaYCGtNHUeItoUEheoYDMw: folds
BbirlZJeYiPjSFVvLtEDVw: folds
33XJu1CVnl9YOngoPIhi0A: folds
dywrHhCI+xO1Q+U4dfdVaQ collected $25 from pot
*** SUMMARY ***
Total pot $25 | Rake $0
Seat 1: ZaYCGtNHUeItoUEheoYDMw (button) folded before Flop (didn't bet)
Seat 2: BbirlZJeYiPjSFVvLtEDVw (small blind) folded before Flop
Seat 3: 33XJu1CVnl9YOngoPIhi0A (big blind) folded before Flop
Seat 4: y9vGciYuJ4+4Z79YDgtBLg folded before Flop (didn't bet)
Seat 5: dywrHhCI+xO1Q+U4dfdVaQ collected ($25)
Seat 6: 3mTlg4g0FJN2bo939h/0Wg folded before Flop (didn't bet)



PokerStars Game #59955826664:  Hold'em No Limit ($5/$10) - 2009/07/01 9:13:26 ET
Table '2a86NK3xhs21kwGZmbj0QA' 6-max Seat #4 is the button
Seat 1: BbirlZJeYiPjSFVvLtEDVw ($1168 in chips)
Seat 2: z/zDzN9GsrGWKD4D635nKA ($1000 in chips)
Seat 3: 7nu3NHCN2s0uUleNuVaGww ($1297 in chips)
Seat 4: 33XJu1CVnl9YOngoPIhi0A ($2545 in chips)
Seat 5: AP3ihgkR8SLQyf0O1jly0g ($447 in chips)
Seat 6: 3mTlg4g0FJN2bo939h/0Wg ($465 in chips)
AP3ihgkR8SLQyf0O1jly0g: posts small blind $5
3mTlg4g0FJN2bo939h/0Wg: posts big blind $10
*** HOLE CARDS ***
BbirlZJeYiPjSFVvLtEDVw: folds
z/zDzN9GsrGWKD4D635nKA: folds
7nu3NHCN2s0uUleNuVaGww: raises $20 to $30
33XJu1CVnl9YOngoPIhi0A: folds
AP3ihgkR8SLQyf0O1jly0g: raises $60 to $90
3mTlg4g0FJN2bo939h/0Wg: folds
7nu3NHCN2s0uUleNuVaGww: folds
AP3ihgkR8SLQyf0O1jly0g collected $70 from pot
AP3ihgkR8SLQyf0O1jly0g: doesn't show hand
*** SUMMARY ***
Total pot $70 | Rake $0
Seat 1: BbirlZJeYiPjSFVvLtEDVw folded before Flop (didn't bet)
Seat 2: z/zDzN9GsrGWKD4D635nKA folded before Flop (didn't bet)
Seat 3: 7nu3NHCN2s0uUleNuVaGww folded before Flop
Seat 4: 33XJu1CVnl9YOngoPIhi0A (button) folded before Flop (didn't bet)
Seat 5: AP3ihgkR8SLQyf0O1jly0g (small blind) collected ($70)
Seat 6: 3mTlg4g0FJN2bo939h/0Wg (big blind) folded before Flop



PokerStars Game #59955828402:  Hold'em No Limit ($5/$10) - 2009/07/01 9:13:29 ET
Table 'agogFDSQKF+U0NUTbR6ZlA' 6-max Seat #2 is the button
Seat 1: ZaYCGtNHUeItoUEheoYDMw ($124 in chips)
Seat 2: BbirlZJeYiPjSFVvLtEDVw ($1050 in chips)
Seat 3: 33XJu1CVnl9YOngoPIhi0A ($983 in chips)
Seat 4: y9vGciYuJ4+4Z79YDgtBLg ($497 in chips)
Seat 5: dywrHhCI+xO1Q+U4dfdVaQ ($1057 in chips)
Seat 6: 3mTlg4g0FJN2bo939h/0Wg ($196 in chips)
33XJu1CVnl9YOngoPIhi0A: posts small blind $5
y9vGciYuJ4+4Z79YDgtBLg: posts big blind $10
*** HOLE CARDS ***
dywrHhCI+xO1Q+U4dfdVaQ: folds
3mTlg4g0FJN2bo939h/0Wg: folds
ZaYCGtNHUeItoUEheoYDMw: folds
BbirlZJeYiPjSFVvLtEDVw: folds
33XJu1CVnl9YOngoPIhi0A: folds
y9vGciYuJ4+4Z79YDgtBLg collected $10 from pot
*** SUMMARY ***
Total pot $10 | Rake $0
Seat 1: ZaYCGtNHUeItoUEheoYDMw folded before Flop (didn't bet)
Seat 2: BbirlZJeYiPjSFVvLtEDVw (button) folded before Flop (didn't bet)
Seat 3: 33XJu1CVnl9YOngoPIhi0A (small blind) folded before Flop
Seat 4: y9vGciYuJ4+4Z79YDgtBLg (big blind) collected ($10)
Seat 5: dywrHhCI+xO1Q+U4dfdVaQ folded before Flop (didn't bet)
Seat 6: 3mTlg4g0FJN2bo939h/0Wg folded before Flop (didn't bet)



PokerStars Game #59955844268:  Hold'em No Limit ($5/$10) - 2009/07/01 9:13:52 ET
Table 'agogFDSQKF+U0NUTbR6ZlA' 6-max Seat #3 is the button
Seat 1: ZaYCGtNHUeItoUEheoYDMw ($124 in chips)
Seat 2: BbirlZJeYiPjSFVvLtEDVw ($1050 in chips)
Seat 3: 33XJu1CVnl9YOngoPIhi0A ($978 in chips)
Seat 4: y9vGciYuJ4+4Z79YDgtBLg ($502 in chips)
Seat 5: dywrHhCI+xO1Q+U4dfdVaQ ($1057 in chips)
Seat 6: 3mTlg4g0FJN2bo939h/0Wg ($196 in chips)
y9vGciYuJ4+4Z79YDgtBLg: posts small blind $5
dywrHhCI+xO1Q+U4dfdVaQ: posts big blind $10
*** HOLE CARDS ***
3mTlg4g0FJN2bo939h/0Wg: raises $20 to $30
ZaYCGtNHUeItoUEheoYDMw: folds
BbirlZJeYiPjSFVvLtEDVw: folds
33XJu1CVnl9YOngoPIhi0A: folds
y9vGciYuJ4+4Z79YDgtBLg: folds
dywrHhCI+xO1Q+U4dfdVaQ: folds
3mTlg4g0FJN2bo939h/0Wg collected $25 from pot
*** SUMMARY ***
Total pot $25 | Rake $0
Seat 1: ZaYCGtNHUeItoUEheoYDMw folded before Flop (didn't bet)
Seat 2: BbirlZJeYiPjSFVvLtEDVw folded before Flop (didn't bet)
Seat 3: 33XJu1CVnl9YOngoPIhi0A (button) folded before Flop (didn't bet)
Seat 4: y9vGciYuJ4+4Z79YDgtBLg (small blind) folded before Flop
Seat 5: dywrHhCI+xO1Q+U4dfdVaQ (big blind) folded before Flop
Seat 6: 3mTlg4g0FJN2bo939h/0Wg collected ($25)



PokerStars Game #59955845438:  Hold'em No Limit ($5/$10) - 2009/07/01 9:13:54 ET
Table '2a86NK3xhs21kwGZmbj0QA' 6-max Seat #5 is the button
Seat 1: BbirlZJeYiPjSFVvLtEDVw ($1168 in chips)
Seat 2: z/zDzN9GsrGWKD4D635nKA ($1000 in chips)
Seat 3: 7nu3NHCN2s0uUleNuVaGww ($1267 in chips)
Seat 4: 33XJu1CVnl9YOngoPIhi0A ($2545 in chips)
Seat 5: AP3ihgkR8SLQyf0O1jly0g ($487 in chips)
Seat 6: 3mTlg4g0FJN2bo939h/0Wg ($455 in chips)
3mTlg4g0FJN2bo939h/0Wg: posts small blind $5
BbirlZJeYiPjSFVvLtEDVw: posts big blind $10
*** HOLE CARDS ***
z/zDzN9GsrGWKD4D635nKA: folds
7nu3NHCN2s0uUleNuVaGww: raises $20 to $30
33XJu1CVnl9YOngoPIhi0A: folds
AP3ihgkR8SLQyf0O1jly0g: folds
3mTlg4g0FJN2bo939h/0Wg: raises $40 to $70
BbirlZJeYiPjSFVvLtEDVw: folds
7nu3NHCN2s0uUleNuVaGww: calls $40
*** FLOP *** [9d Qs Jc]
3mTlg4g0FJN2bo939h/0Wg: checks
7nu3NHCN2s0uUleNuVaGww: bets $80
3mTlg4g0FJN2bo939h/0Wg: raises $110 to $190
7nu3NHCN2s0uUleNuVaGww: raises $600 to $790
3mTlg4g0FJN2bo939h/0Wg: calls $195 and is all-in
*** TURN *** [9d Qs Jc] [Th]
*** RIVER *** [9d Qs Jc Th] [Tc]
*** SHOW DOWN ***
3mTlg4g0FJN2bo939h/0Wg: shows [Ac Ah] (two pair, Aces and Tens)
7nu3NHCN2s0uUleNuVaGww: mucks hand
3mTlg4g0FJN2bo939h/0Wg collected $917 from pot
*** SUMMARY ***
Total pot $920 | Rake $3
Board [9d Qs Jc Th Tc]
Seat 1: BbirlZJeYiPjSFVvLtEDVw (big blind) folded before Flop
Seat 2: z/zDzN9GsrGWKD4D635nKA folded before Flop (didn't bet)
Seat 3: 7nu3NHCN2s0uUleNuVaGww mucked
Seat 4: 33XJu1CVnl9YOngoPIhi0A folded before Flop (didn't bet)
Seat 5: AP3ihgkR8SLQyf0O1jly0g (button) folded before Flop (didn't bet)
Seat 6: 3mTlg4g0FJN2bo939h/0Wg (small blind) showed [Ac Ah] and won ($917) with two pair, Aces and Tens



PokerStars Game #59955862536:  Hold'em No Limit ($5/$10) - 2009/07/01 9:14:19 ET
Table 'agogFDSQKF+U0NUTbR6ZlA' 6-max Seat #4 is the button
Seat 1: ZaYCGtNHUeItoUEheoYDMw ($124 in chips)
Seat 2: BbirlZJeYiPjSFVvLtEDVw ($1050 in chips)
Seat 3: 33XJu1CVnl9YOngoPIhi0A ($978 in chips)
Seat 4: y9vGciYuJ4+4Z79YDgtBLg ($497 in chips)
Seat 5: dywrHhCI+xO1Q+U4dfdVaQ ($1047 in chips)
Seat 6: 3mTlg4g0FJN2bo939h/0Wg ($211 in chips)
dywrHhCI+xO1Q+U4dfdVaQ: posts small blind $5
3mTlg4g0FJN2bo939h/0Wg: posts big blind $10
*** HOLE CARDS ***
ZaYCGtNHUeItoUEheoYDMw: folds
BbirlZJeYiPjSFVvLtEDVw: folds
33XJu1CVnl9YOngoPIhi0A: folds
y9vGciYuJ4+4Z79YDgtBLg: folds
dywrHhCI+xO1Q+U4dfdVaQ: folds
3mTlg4g0FJN2bo939h/0Wg collected $10 from pot
*** SUMMARY ***
Total pot $10 | Rake $0
Seat 1: ZaYCGtNHUeItoUEheoYDMw folded before Flop (didn't bet)
Seat 2: BbirlZJeYiPjSFVvLtEDVw folded before Flop (didn't bet)
Seat 3: 33XJu1CVnl9YOngoPIhi0A folded before Flop (didn't bet)
Seat 4: y9vGciYuJ4+4Z79YDgtBLg (button) folded before Flop (didn't bet)
Seat 5: dywrHhCI+xO1Q+U4dfdVaQ (small blind) folded before Flop
Seat 6: 3mTlg4g0FJN2bo939h/0Wg (big blind) collected ($10)



PokerStars Game #59955878136:  Hold'em No Limit ($5/$10) - 2009/07/01 9:14:42 ET
Table 'agogFDSQKF+U0NUTbR6ZlA' 6-max Seat #5 is the button
Seat 1: ZaYCGtNHUeItoUEheoYDMw ($124 in chips)
Seat 2: BbirlZJeYiPjSFVvLtEDVw ($1050 in chips)
Seat 3: 33XJu1CVnl9YOngoPIhi0A ($978 in chips)
Seat 4: y9vGciYuJ4+4Z79YDgtBLg ($497 in chips)
Seat 5: dywrHhCI+xO1Q+U4dfdVaQ ($1042 in chips)
Seat 6: 3mTlg4g0FJN2bo939h/0Wg ($216 in chips)
3mTlg4g0FJN2bo939h/0Wg: posts small blind $5
ZaYCGtNHUeItoUEheoYDMw: posts big blind $10
*** HOLE CARDS ***
BbirlZJeYiPjSFVvLtEDVw: folds
33XJu1CVnl9YOngoPIhi0A: folds
y9vGciYuJ4+4Z79YDgtBLg: folds
dywrHhCI+xO1Q+U4dfdVaQ: folds
3mTlg4g0FJN2bo939h/0Wg: calls $5
ZaYCGtNHUeItoUEheoYDMw: raises $114 to $124 and is all-in
3mTlg4g0FJN2bo939h/0Wg: folds
ZaYCGtNHUeItoUEheoYDMw collected $20 from pot
*** SUMMARY ***
Total pot $20 | Rake $0
Seat 1: ZaYCGtNHUeItoUEheoYDMw (big blind) collected ($20)
Seat 2: BbirlZJeYiPjSFVvLtEDVw folded before Flop (didn't bet)
Seat 3: 33XJu1CVnl9YOngoPIhi0A folded before Flop (didn't bet)
Seat 4: y9vGciYuJ4+4Z79YDgtBLg folded before Flop (didn't bet)
Seat 5: dywrHhCI+xO1Q+U4dfdVaQ (button) folded before Flop (didn't bet)
Seat 6: 3mTlg4g0FJN2bo939h/0Wg (small blind) folded before Flop



PokerStars Game #59955880744:  Hold'em No Limit ($5/$10) - 2009/07/01 9:14:45 ET
Table '2a86NK3xhs21kwGZmbj0QA' 6-max Seat #6 is the button
Seat 1: BbirlZJeYiPjSFVvLtEDVw ($1158 in chips)
Seat 2: z/zDzN9GsrGWKD4D635nKA ($1000 in chips)
Seat 3: 7nu3NHCN2s0uUleNuVaGww ($1000 in chips)
Seat 4: 33XJu1CVnl9YOngoPIhi0A ($2545 in chips)
Seat 5: AP3ihgkR8SLQyf0O1jly0g ($487 in chips)
Seat 6: 3mTlg4g0FJN2bo939h/0Wg ($917 in chips)
BbirlZJeYiPjSFVvLtEDVw: posts small blind $5
z/zDzN9GsrGWKD4D635nKA: posts big blind $10
*** HOLE CARDS ***
7nu3NHCN2s0uUleNuVaGww: folds
33XJu1CVnl9YOngoPIhi0A: folds
AP3ihgkR8SLQyf0O1jly0g: folds
3mTlg4g0FJN2bo939h/0Wg: raises $20 to $30
BbirlZJeYiPjSFVvLtEDVw: folds
z/zDzN9GsrGWKD4D635nKA: folds
3mTlg4g0FJN2bo939h/0Wg collected $25 from pot
*** SUMMARY ***
Total pot $25 | Rake $0
Seat 1: BbirlZJeYiPjSFVvLtEDVw (small blind) folded before Flop
Seat 2: z/zDzN9GsrGWKD4D635nKA (big blind) folded before Flop
Seat 3: 7nu3NHCN2s0uUleNuVaGww folded before Flop (didn't bet)
Seat 4: 33XJu1CVnl9YOngoPIhi0A folded before Flop (didn't bet)
Seat 5: AP3ihgkR8SLQyf0O1jly0g folded before Flop (didn't bet)
Seat 6: 3mTlg4g0FJN2bo939h/0Wg (button) collected ($25)



PokerStars Game #59955896728:  Hold'em No Limit ($5/$10) - 2009/07/01 9:15:09 ET
Table '2a86NK3xhs21kwGZmbj0QA' 6-max Seat #1 is the button
Seat 1: BbirlZJeYiPjSFVvLtEDVw ($1153 in chips)
Seat 2: z/zDzN9GsrGWKD4D635nKA ($1000 in chips)
Seat 3: 7nu3NHCN2s0uUleNuVaGww ($1000 in chips)
Seat 4: 33XJu1CVnl9YOngoPIhi0A ($2545 in chips)
Seat 5: AP3ihgkR8SLQyf0O1jly0g ($487 in chips)
Seat 6: 3mTlg4g0FJN2bo939h/0Wg ($932 in chips)
z/zDzN9GsrGWKD4D635nKA: posts small blind $5
7nu3NHCN2s0uUleNuVaGww: posts big blind $10
*** HOLE CARDS ***
33XJu1CVnl9YOngoPIhi0A: folds
AP3ihgkR8SLQyf0O1jly0g: folds
3mTlg4g0FJN2bo939h/0Wg: raises $20 to $30
BbirlZJeYiPjSFVvLtEDVw: folds
z/zDzN9GsrGWKD4D635nKA: folds
7nu3NHCN2s0uUleNuVaGww: folds
3mTlg4g0FJN2bo939h/0Wg collected $25 from pot
*** SUMMARY ***
Total pot $25 | Rake $0
Seat 1: BbirlZJeYiPjSFVvLtEDVw (button) folded before Flop (didn't bet)
Seat 2: z/zDzN9GsrGWKD4D635nKA (small blind) folded before Flop
Seat 3: 7nu3NHCN2s0uUleNuVaGww (big blind) folded before Flop
Seat 4: 33XJu1CVnl9YOngoPIhi0A folded before Flop (didn't bet)
Seat 5: AP3ihgkR8SLQyf0O1jly0g folded before Flop (didn't bet)
Seat 6: 3mTlg4g0FJN2bo939h/0Wg collected ($25)



PokerStars Game #59955899190:  Hold'em No Limit ($5/$10) - 2009/07/01 9:15:13 ET
Table 'agogFDSQKF+U0NUTbR6ZlA' 6-max Seat #6 is the button
Seat 1: ZaYCGtNHUeItoUEheoYDMw ($134 in chips)
Seat 2: BbirlZJeYiPjSFVvLtEDVw ($1050 in chips)
Seat 3: 33XJu1CVnl9YOngoPIhi0A ($978 in chips)
Seat 4: y9vGciYuJ4+4Z79YDgtBLg ($497 in chips)
Seat 5: dywrHhCI+xO1Q+U4dfdVaQ ($1042 in chips)
Seat 6: 3mTlg4g0FJN2bo939h/0Wg ($206 in chips)
ZaYCGtNHUeItoUEheoYDMw: posts small blind $5
BbirlZJeYiPjSFVvLtEDVw: posts big blind $10
*** HOLE CARDS ***
33XJu1CVnl9YOngoPIhi0A: folds
y9vGciYuJ4+4Z79YDgtBLg: calls $10
dywrHhCI+xO1Q+U4dfdVaQ: raises $30 to $40
3mTlg4g0FJN2bo939h/0Wg: folds
ZaYCGtNHUeItoUEheoYDMw: folds
BbirlZJeYiPjSFVvLtEDVw: folds
y9vGciYuJ4+4Z79YDgtBLg: folds
dywrHhCI+xO1Q+U4dfdVaQ collected $35 from pot
dywrHhCI+xO1Q+U4dfdVaQ: doesn't show hand
*** SUMMARY ***
Total pot $35 | Rake $0
Seat 1: ZaYCGtNHUeItoUEheoYDMw (small blind) folded before Flop
Seat 2: BbirlZJeYiPjSFVvLtEDVw (big blind) folded before Flop
Seat 3: 33XJu1CVnl9YOngoPIhi0A folded before Flop (didn't bet)
Seat 4: y9vGciYuJ4+4Z79YDgtBLg folded before Flop
Seat 5: dywrHhCI+xO1Q+U4dfdVaQ collected ($35)
Seat 6: 3mTlg4g0FJN2bo939h/0Wg (button) folded before Flop (didn't bet)



PokerStars Game #59955907412:  Hold'em No Limit ($5/$10) - 2009/07/01 9:15:25 ET
Table '2a86NK3xhs21kwGZmbj0QA' 6-max Seat #2 is the button
Seat 1: BbirlZJeYiPjSFVvLtEDVw ($1153 in chips)
Seat 2: z/zDzN9GsrGWKD4D635nKA ($1000 in chips)
Seat 3: 7nu3NHCN2s0uUleNuVaGww ($990 in chips)
Seat 4: 33XJu1CVnl9YOngoPIhi0A ($2545 in chips)
Seat 5: AP3ihgkR8SLQyf0O1jly0g ($487 in chips)
Seat 6: 3mTlg4g0FJN2bo939h/0Wg ($947 in chips)
7nu3NHCN2s0uUleNuVaGww: posts small blind $5
33XJu1CVnl9YOngoPIhi0A: posts big blind $10
*** HOLE CARDS ***
AP3ihgkR8SLQyf0O1jly0g: folds
3mTlg4g0FJN2bo939h/0Wg: raises $10 to $20
BbirlZJeYiPjSFVvLtEDVw: folds
z/zDzN9GsrGWKD4D635nKA: folds
7nu3NHCN2s0uUleNuVaGww: folds
33XJu1CVnl9YOngoPIhi0A: folds
3mTlg4g0FJN2bo939h/0Wg collected $25 from pot
*** SUMMARY ***
Total pot $25 | Rake $0
Seat 1: BbirlZJeYiPjSFVvLtEDVw folded before Flop (didn't bet)
Seat 2: z/zDzN9GsrGWKD4D635nKA (button) folded before Flop (didn't bet)
Seat 3: 7nu3NHCN2s0uUleNuVaGww (small blind) folded before Flop
Seat 4: 33XJu1CVnl9YOngoPIhi0A (big blind) folded before Flop
Seat 5: AP3ihgkR8SLQyf0O1jly0g folded before Flop (didn't bet)
Seat 6: 3mTlg4g0FJN2bo939h/0Wg collected ($25)



PokerStars Game #59955920624:  Hold'em No Limit ($5/$10) - 2009/07/01 9:15:44 ET
Table 'agogFDSQKF+U0NUTbR6ZlA' 6-max Seat #1 is the button
Seat 1: ZaYCGtNHUeItoUEheoYDMw ($129 in chips)
Seat 2: BbirlZJeYiPjSFVvLtEDVw ($1040 in chips)
Seat 3: 33XJu1CVnl9YOngoPIhi0A ($978 in chips)
Seat 4: y9vGciYuJ4+4Z79YDgtBLg ($487 in chips)
Seat 5: dywrHhCI+xO1Q+U4dfdVaQ ($1067 in chips)
Seat 6: 3mTlg4g0FJN2bo939h/0Wg ($206 in chips)
BbirlZJeYiPjSFVvLtEDVw: posts small blind $5
33XJu1CVnl9YOngoPIhi0A: posts big blind $10
*** HOLE CARDS ***
y9vGciYuJ4+4Z79YDgtBLg: calls $10
dywrHhCI+xO1Q+U4dfdVaQ: folds
3mTlg4g0FJN2bo939h/0Wg: folds
ZaYCGtNHUeItoUEheoYDMw: folds
BbirlZJeYiPjSFVvLtEDVw: folds
33XJu1CVnl9YOngoPIhi0A: checks
*** FLOP *** [7d Qh Tc]
33XJu1CVnl9YOngoPIhi0A: checks
y9vGciYuJ4+4Z79YDgtBLg: checks
*** TURN *** [7d Qh Tc] [Jd]
33XJu1CVnl9YOngoPIhi0A: checks
y9vGciYuJ4+4Z79YDgtBLg: checks
*** RIVER *** [7d Qh Tc Jd] [7s]
33XJu1CVnl9YOngoPIhi0A: checks
y9vGciYuJ4+4Z79YDgtBLg: bets $10
33XJu1CVnl9YOngoPIhi0A: folds
y9vGciYuJ4+4Z79YDgtBLg collected $23.75 from pot
*** SUMMARY ***
Total pot $25 | Rake $1.25
Board [7d Qh Tc Jd 7s]
Seat 1: ZaYCGtNHUeItoUEheoYDMw (button) folded before Flop (didn't bet)
Seat 2: BbirlZJeYiPjSFVvLtEDVw (small blind) folded before Flop
Seat 3: 33XJu1CVnl9YOngoPIhi0A (big blind) folded on the River
Seat 4: y9vGciYuJ4+4Z79YDgtBLg collected ($23.75)
Seat 5: dywrHhCI+xO1Q+U4dfdVaQ folded before Flop (didn't bet)
Seat 6: 3mTlg4g0FJN2bo939h/0Wg folded before Flop (didn't bet)



PokerStars Game #59955921874:  Hold'em No Limit ($5/$10) - 2009/07/01 9:15:46 ET
Table '2a86NK3xhs21kwGZmbj0QA' 6-max Seat #3 is the button
Seat 1: BbirlZJeYiPjSFVvLtEDVw ($1153 in chips)
Seat 2: z/zDzN9GsrGWKD4D635nKA ($1000 in chips)
Seat 3: 7nu3NHCN2s0uUleNuVaGww ($985 in chips)
Seat 4: 33XJu1CVnl9YOngoPIhi0A ($2535 in chips)
Seat 5: AP3ihgkR8SLQyf0O1jly0g ($487 in chips)
Seat 6: 3mTlg4g0FJN2bo939h/0Wg ($962 in chips)
33XJu1CVnl9YOngoPIhi0A: posts small blind $5
AP3ihgkR8SLQyf0O1jly0g: posts big blind $10
*** HOLE CARDS ***
3mTlg4g0FJN2bo939h/0Wg: folds
BbirlZJeYiPjSFVvLtEDVw: folds
z/zDzN9GsrGWKD4D635nKA: folds
7nu3NHCN2s0uUleNuVaGww: folds
33XJu1CVnl9YOngoPIhi0A: raises $20 to $30
AP3ihgkR8SLQyf0O1jly0g: calls $20
*** FLOP *** [4d 3h 6h]
33XJu1CVnl9YOngoPIhi0A: bets $40
AP3ihgkR8SLQyf0O1jly0g: folds
33XJu1CVnl9YOngoPIhi0A collected $57 from pot
33XJu1CVnl9YOngoPIhi0A: doesn't show hand
*** SUMMARY ***
Total pot $60 | Rake $3
Board [4d 3h 6h]
Seat 1: BbirlZJeYiPjSFVvLtEDVw folded before Flop (didn't bet)
Seat 2: z/zDzN9GsrGWKD4D635nKA folded before Flop (didn't bet)
Seat 3: 7nu3NHCN2s0uUleNuVaGww (button) folded before Flop (didn't bet)
Seat 4: 33XJu1CVnl9YOngoPIhi0A (small blind) collected ($57)
Seat 5: AP3ihgkR8SLQyf0O1jly0g (big blind) folded on the Flop
Seat 6: 3mTlg4g0FJN2bo939h/0Wg folded before Flop (didn't bet)



PokerStars Game #59955943482:  Hold'em No Limit ($5/$10) - 2009/07/01 9:16:17 ET
Table 'agogFDSQKF+U0NUTbR6ZlA' 6-max Seat #2 is the button
Seat 1: ZaYCGtNHUeItoUEheoYDMw ($129 in chips)
Seat 2: BbirlZJeYiPjSFVvLtEDVw ($1035 in chips)
Seat 3: 33XJu1CVnl9YOngoPIhi0A ($968 in chips)
Seat 4: y9vGciYuJ4+4Z79YDgtBLg ($500.75 in chips)
Seat 5: dywrHhCI+xO1Q+U4dfdVaQ ($1067 in chips)
Seat 6: 3mTlg4g0FJN2bo939h/0Wg ($206 in chips)
33XJu1CVnl9YOngoPIhi0A: posts small blind $5
y9vGciYuJ4+4Z79YDgtBLg: posts big blind $10
*** HOLE CARDS ***
dywrHhCI+xO1Q+U4dfdVaQ: folds
3mTlg4g0FJN2bo939h/0Wg: raises $10 to $20
ZaYCGtNHUeItoUEheoYDMw: folds
BbirlZJeYiPjSFVvLtEDVw: folds
33XJu1CVnl9YOngoPIhi0A: folds
y9vGciYuJ4+4Z79YDgtBLg: calls $10
*** FLOP *** [3d 3h 5h]
y9vGciYuJ4+4Z79YDgtBLg: checks
3mTlg4g0FJN2bo939h/0Wg: checks
*** TURN *** [3d 3h 5h] [Td]
y9vGciYuJ4+4Z79YDgtBLg: checks
3mTlg4g0FJN2bo939h/0Wg: checks
*** RIVER *** [3d 3h 5h Td] [2h]
y9vGciYuJ4+4Z79YDgtBLg: checks
3mTlg4g0FJN2bo939h/0Wg: bets $30
y9vGciYuJ4+4Z79YDgtBLg: calls $30
*** SHOW DOWN ***
3mTlg4g0FJN2bo939h/0Wg: shows [Ac 7h] (a pair of Threes)
y9vGciYuJ4+4Z79YDgtBLg: shows [Qh 2s] (two pair, Threes and Deuces)
y9vGciYuJ4+4Z79YDgtBLg collected $102 from pot
*** SUMMARY ***
Total pot $105 | Rake $3
Board [3d 3h 5h Td 2h]
Seat 1: ZaYCGtNHUeItoUEheoYDMw folded before Flop (didn't bet)
Seat 2: BbirlZJeYiPjSFVvLtEDVw (button) folded before Flop (didn't bet)
Seat 3: 33XJu1CVnl9YOngoPIhi0A (small blind) folded before Flop
Seat 4: y9vGciYuJ4+4Z79YDgtBLg (big blind) showed [Qh 2s] and won ($102) with two pair, Threes and Deuces
Seat 5: dywrHhCI+xO1Q+U4dfdVaQ folded before Flop (didn't bet)
Seat 6: 3mTlg4g0FJN2bo939h/0Wg showed [Ac 7h] and lost with a pair of Threes



PokerStars Game #59955945614:  Hold'em No Limit ($5/$10) - 2009/07/01 9:16:20 ET
Table '2a86NK3xhs21kwGZmbj0QA' 6-max Seat #4 is the button
Seat 1: BbirlZJeYiPjSFVvLtEDVw ($1153 in chips)
Seat 2: z/zDzN9GsrGWKD4D635nKA ($1000 in chips)
Seat 3: 7nu3NHCN2s0uUleNuVaGww ($985 in chips)
Seat 4: 33XJu1CVnl9YOngoPIhi0A ($2562 in chips)
Seat 5: AP3ihgkR8SLQyf0O1jly0g ($457 in chips)
Seat 6: 3mTlg4g0FJN2bo939h/0Wg ($962 in chips)
AP3ihgkR8SLQyf0O1jly0g: posts small blind $5
3mTlg4g0FJN2bo939h/0Wg: posts big blind $10
*** HOLE CARDS ***
BbirlZJeYiPjSFVvLtEDVw: folds
z/zDzN9GsrGWKD4D635nKA: folds
7nu3NHCN2s0uUleNuVaGww: folds
33XJu1CVnl9YOngoPIhi0A: folds
AP3ihgkR8SLQyf0O1jly0g: calls $5
3mTlg4g0FJN2bo939h/0Wg: raises $20 to $30
AP3ihgkR8SLQyf0O1jly0g: calls $20
*** FLOP *** [Jc 2s Kh]
AP3ihgkR8SLQyf0O1jly0g: bets $35
3mTlg4g0FJN2bo939h/0Wg: calls $35
*** TURN *** [Jc 2s Kh] [Ac]
AP3ihgkR8SLQyf0O1jly0g: checks
3mTlg4g0FJN2bo939h/0Wg: checks
*** RIVER *** [Jc 2s Kh Ac] [3d]
AP3ihgkR8SLQyf0O1jly0g: bets $100
3mTlg4g0FJN2bo939h/0Wg: calls $100
*** SHOW DOWN ***
AP3ihgkR8SLQyf0O1jly0g: shows [5s 4s] (a straight, Ace to Five)
3mTlg4g0FJN2bo939h/0Wg: mucks hand
AP3ihgkR8SLQyf0O1jly0g collected $327 from pot
*** SUMMARY ***
Total pot $330 | Rake $3
Board [Jc 2s Kh Ac 3d]
Seat 1: BbirlZJeYiPjSFVvLtEDVw folded before Flop (didn't bet)
Seat 2: z/zDzN9GsrGWKD4D635nKA folded before Flop (didn't bet)
Seat 3: 7nu3NHCN2s0uUleNuVaGww folded before Flop (didn't bet)
Seat 4: 33XJu1CVnl9YOngoPIhi0A (button) folded before Flop (didn't bet)
Seat 5: AP3ihgkR8SLQyf0O1jly0g (small blind) showed [5s 4s] and won ($327) with a straight, Ace to Five
Seat 6: 3mTlg4g0FJN2bo939h/0Wg (big blind) mucked



PokerStars Game #59955972020:  Hold'em No Limit ($5/$10) - 2009/07/01 9:16:59 ET
Table '2a86NK3xhs21kwGZmbj0QA' 6-max Seat #5 is the button
Seat 1: BbirlZJeYiPjSFVvLtEDVw ($1153 in chips)
Seat 2: z/zDzN9GsrGWKD4D635nKA ($1000 in chips)
Seat 3: 7nu3NHCN2s0uUleNuVaGww ($985 in chips)
Seat 4: 33XJu1CVnl9YOngoPIhi0A ($2562 in chips)
Seat 5: AP3ihgkR8SLQyf0O1jly0g ($619 in chips)
Seat 6: 3mTlg4g0FJN2bo939h/0Wg ($797 in chips)
3mTlg4g0FJN2bo939h/0Wg: posts small blind $5
BbirlZJeYiPjSFVvLtEDVw: posts big blind $10
*** HOLE CARDS ***
z/zDzN9GsrGWKD4D635nKA: raises $20 to $30
7nu3NHCN2s0uUleNuVaGww: calls $30
33XJu1CVnl9YOngoPIhi0A: folds
AP3ihgkR8SLQyf0O1jly0g: folds
3mTlg4g0FJN2bo939h/0Wg said, "****ing joke"
3mTlg4g0FJN2bo939h/0Wg: folds
AP3ihgkR8SLQyf0O1jly0g said, "haha"
BbirlZJeYiPjSFVvLtEDVw: folds
*** FLOP *** [8h 7d Kc]
AP3ihgkR8SLQyf0O1jly0g said, "lol"
z/zDzN9GsrGWKD4D635nKA: bets $40
7nu3NHCN2s0uUleNuVaGww: calls $40
*** TURN *** [8h 7d Kc] [9h]
z/zDzN9GsrGWKD4D635nKA: bets $100
7nu3NHCN2s0uUleNuVaGww: calls $100
*** RIVER *** [8h 7d Kc 9h] [4c]
z/zDzN9GsrGWKD4D635nKA: checks
AP3ihgkR8SLQyf0O1jly0g said, "playing 1000 NL can't take a beat?"
7nu3NHCN2s0uUleNuVaGww: checks
*** SHOW DOWN ***
z/zDzN9GsrGWKD4D635nKA: shows [Ks Qs] (a pair of Kings)
7nu3NHCN2s0uUleNuVaGww: mucks hand
z/zDzN9GsrGWKD4D635nKA collected $352 from pot
*** SUMMARY ***
Total pot $355 | Rake $3
Board [8h 7d Kc 9h 4c]
Seat 1: BbirlZJeYiPjSFVvLtEDVw (big blind) folded before Flop
Seat 2: z/zDzN9GsrGWKD4D635nKA showed [Ks Qs] and won ($352) with a pair of Kings
Seat 3: 7nu3NHCN2s0uUleNuVaGww mucked
Seat 4: 33XJu1CVnl9YOngoPIhi0A folded before Flop (didn't bet)
Seat 5: AP3ihgkR8SLQyf0O1jly0g (button) folded before Flop (didn't bet)
Seat 6: 3mTlg4g0FJN2bo939h/0Wg (small blind) folded before Flop



PokerStars Game #59956001528:  Hold'em No Limit ($5/$10) - 2009/07/01 9:17:43 ET
Table 'agogFDSQKF+U0NUTbR6ZlA' 6-max Seat #3 is the button
Seat 1: ZaYCGtNHUeItoUEheoYDMw ($129 in chips)
Seat 2: BbirlZJeYiPjSFVvLtEDVw ($1035 in chips)
Seat 3: 33XJu1CVnl9YOngoPIhi0A ($963 in chips)
Seat 4: y9vGciYuJ4+4Z79YDgtBLg ($552.75 in chips)
Seat 5: dywrHhCI+xO1Q+U4dfdVaQ ($1067 in chips)
Seat 6: 3mTlg4g0FJN2bo939h/0Wg ($156 in chips)
y9vGciYuJ4+4Z79YDgtBLg: posts small blind $5
dywrHhCI+xO1Q+U4dfdVaQ: posts big blind $10
*** HOLE CARDS ***
3mTlg4g0FJN2bo939h/0Wg: folds
ZaYCGtNHUeItoUEheoYDMw: folds
BbirlZJeYiPjSFVvLtEDVw: folds
33XJu1CVnl9YOngoPIhi0A: folds
y9vGciYuJ4+4Z79YDgtBLg: calls $5
dywrHhCI+xO1Q+U4dfdVaQ: raises $30 to $40
y9vGciYuJ4+4Z79YDgtBLg: raises $512.75 to $552.75 and is all-in
dywrHhCI+xO1Q+U4dfdVaQ: folds
y9vGciYuJ4+4Z79YDgtBLg collected $80 from pot
*** SUMMARY ***
Total pot $80 | Rake $0
Seat 1: ZaYCGtNHUeItoUEheoYDMw folded before Flop (didn't bet)
Seat 2: BbirlZJeYiPjSFVvLtEDVw folded before Flop (didn't bet)
Seat 3: 33XJu1CVnl9YOngoPIhi0A (button) folded before Flop (didn't bet)
Seat 4: y9vGciYuJ4+4Z79YDgtBLg (small blind) collected ($80)
Seat 5: dywrHhCI+xO1Q+U4dfdVaQ (big blind) folded before Flop
Seat 6: 3mTlg4g0FJN2bo939h/0Wg folded before Flop (didn't bet)



PokerStars Game #59956013862:  Hold'em No Limit ($5/$10) - 2009/07/01 9:18:01 ET
Table '2a86NK3xhs21kwGZmbj0QA' 6-max Seat #6 is the button
Seat 1: BbirlZJeYiPjSFVvLtEDVw ($1143 in chips)
Seat 2: z/zDzN9GsrGWKD4D635nKA ($1182 in chips)
Seat 3: 7nu3NHCN2s0uUleNuVaGww ($1000 in chips)
Seat 4: 33XJu1CVnl9YOngoPIhi0A ($2562 in chips)
Seat 5: AP3ihgkR8SLQyf0O1jly0g ($619 in chips)
Seat 6: 3mTlg4g0FJN2bo939h/0Wg ($792 in chips)
BbirlZJeYiPjSFVvLtEDVw: posts small blind $5
z/zDzN9GsrGWKD4D635nKA: posts big blind $10
*** HOLE CARDS ***
7nu3NHCN2s0uUleNuVaGww: folds
33XJu1CVnl9YOngoPIhi0A: folds
AP3ihgkR8SLQyf0O1jly0g: raises $20 to $30
3mTlg4g0FJN2bo939h/0Wg: calls $30
BbirlZJeYiPjSFVvLtEDVw: folds
z/zDzN9GsrGWKD4D635nKA: folds
*** FLOP *** [2h 8d 7d]
AP3ihgkR8SLQyf0O1jly0g: checks
3mTlg4g0FJN2bo939h/0Wg: checks
*** TURN *** [2h 8d 7d] [Jc]
AP3ihgkR8SLQyf0O1jly0g: bets $30
3mTlg4g0FJN2bo939h/0Wg: calls $30
*** RIVER *** [2h 8d 7d Jc] [3d]
AP3ihgkR8SLQyf0O1jly0g: checks
3mTlg4g0FJN2bo939h/0Wg: bets $80
AP3ihgkR8SLQyf0O1jly0g: calls $80
*** SHOW DOWN ***
3mTlg4g0FJN2bo939h/0Wg: shows [9c Ac] (high card Ace)
AP3ihgkR8SLQyf0O1jly0g: shows [Ts Jd] (a pair of Jacks)
AP3ihgkR8SLQyf0O1jly0g collected $292 from pot
*** SUMMARY ***
Total pot $295 | Rake $3
Board [2h 8d 7d Jc 3d]
Seat 1: BbirlZJeYiPjSFVvLtEDVw (small blind) folded before Flop
Seat 2: z/zDzN9GsrGWKD4D635nKA (big blind) folded before Flop
Seat 3: 7nu3NHCN2s0uUleNuVaGww folded before Flop (didn't bet)
Seat 4: 33XJu1CVnl9YOngoPIhi0A folded before Flop (didn't bet)
Seat 5: AP3ihgkR8SLQyf0O1jly0g showed [Ts Jd] and won ($292) with a pair of Jacks
Seat 6: 3mTlg4g0FJN2bo939h/0Wg (button) showed [9c Ac] and lost with high card Ace



PokerStars Game #59956032334:  Hold'em No Limit ($5/$10) - 2009/07/01 9:18:27 ET
Table 'agogFDSQKF+U0NUTbR6ZlA' 6-max Seat #4 is the button
Seat 1: ZaYCGtNHUeItoUEheoYDMw ($129 in chips)
Seat 2: BbirlZJeYiPjSFVvLtEDVw ($1035 in chips)
Seat 3: 33XJu1CVnl9YOngoPIhi0A ($963 in chips)
Seat 4: y9vGciYuJ4+4Z79YDgtBLg ($592.75 in chips)
Seat 5: dywrHhCI+xO1Q+U4dfdVaQ ($1027 in chips)
Seat 6: 3mTlg4g0FJN2bo939h/0Wg ($156 in chips)
dywrHhCI+xO1Q+U4dfdVaQ: posts small blind $5
3mTlg4g0FJN2bo939h/0Wg: posts big blind $10
*** HOLE CARDS ***
ZaYCGtNHUeItoUEheoYDMw: folds
BbirlZJeYiPjSFVvLtEDVw: folds
33XJu1CVnl9YOngoPIhi0A: folds
y9vGciYuJ4+4Z79YDgtBLg: folds
dywrHhCI+xO1Q+U4dfdVaQ: folds
3mTlg4g0FJN2bo939h/0Wg collected $10 from pot
*** SUMMARY ***
Total pot $10 | Rake $0
Seat 1: ZaYCGtNHUeItoUEheoYDMw folded before Flop (didn't bet)
Seat 2: BbirlZJeYiPjSFVvLtEDVw folded before Flop (didn't bet)
Seat 3: 33XJu1CVnl9YOngoPIhi0A folded before Flop (didn't bet)
Seat 4: y9vGciYuJ4+4Z79YDgtBLg (button) folded before Flop (didn't bet)
Seat 5: dywrHhCI+xO1Q+U4dfdVaQ (small blind) folded before Flop
Seat 6: 3mTlg4g0FJN2bo939h/0Wg (big blind) collected ($10)



PokerStars Game #59956046626:  Hold'em No Limit ($5/$10) - 2009/07/01 9:18:47 ET
Table 'agogFDSQKF+U0NUTbR6ZlA' 6-max Seat #5 is the button
Seat 1: ZaYCGtNHUeItoUEheoYDMw ($129 in chips)
Seat 2: BbirlZJeYiPjSFVvLtEDVw ($1035 in chips)
Seat 3: 33XJu1CVnl9YOngoPIhi0A ($963 in chips)
Seat 4: y9vGciYuJ4+4Z79YDgtBLg ($592.75 in chips)
Seat 5: dywrHhCI+xO1Q+U4dfdVaQ ($1022 in chips)
Seat 6: 3mTlg4g0FJN2bo939h/0Wg ($161 in chips)
3mTlg4g0FJN2bo939h/0Wg: posts small blind $5
ZaYCGtNHUeItoUEheoYDMw: posts big blind $10
*** HOLE CARDS ***
BbirlZJeYiPjSFVvLtEDVw: folds
33XJu1CVnl9YOngoPIhi0A: folds
y9vGciYuJ4+4Z79YDgtBLg: folds
dywrHhCI+xO1Q+U4dfdVaQ: folds
3mTlg4g0FJN2bo939h/0Wg: raises $10 to $20
ZaYCGtNHUeItoUEheoYDMw: raises $109 to $129 and is all-in
3mTlg4g0FJN2bo939h/0Wg: calls $109
*** FLOP *** [Td Qd 7c]
*** TURN *** [Td Qd 7c] [Qh]
*** RIVER *** [Td Qd 7c Qh] [As]
*** SHOW DOWN ***
3mTlg4g0FJN2bo939h/0Wg: shows [Kd Tc] (two pair, Queens and Tens)
ZaYCGtNHUeItoUEheoYDMw: shows [Th Ac] (two pair, Aces and Queens)
ZaYCGtNHUeItoUEheoYDMw collected $255 from pot
*** SUMMARY ***
Total pot $258 | Rake $3
Board [Td Qd 7c Qh As]
Seat 1: ZaYCGtNHUeItoUEheoYDMw (big blind) showed [Th Ac] and won ($255) with two pair, Aces and Queens
Seat 2: BbirlZJeYiPjSFVvLtEDVw folded before Flop (didn't bet)
Seat 3: 33XJu1CVnl9YOngoPIhi0A folded before Flop (didn't bet)
Seat 4: y9vGciYuJ4+4Z79YDgtBLg folded before Flop (didn't bet)
Seat 5: dywrHhCI+xO1Q+U4dfdVaQ (button) folded before Flop (didn't bet)
Seat 6: 3mTlg4g0FJN2bo939h/0Wg (small blind) showed [Kd Tc] and lost with two pair, Queens and Tens



PokerStars Game #59956046594:  Hold'em No Limit ($5/$10) - 2009/07/01 9:18:47 ET
Table '2a86NK3xhs21kwGZmbj0QA' 6-max Seat #1 is the button
Seat 1: BbirlZJeYiPjSFVvLtEDVw ($1138 in chips)
Seat 2: z/zDzN9GsrGWKD4D635nKA ($1172 in chips)
Seat 3: 7nu3NHCN2s0uUleNuVaGww ($1000 in chips)
Seat 4: 33XJu1CVnl9YOngoPIhi0A ($2562 in chips)
Seat 5: AP3ihgkR8SLQyf0O1jly0g ($771 in chips)
Seat 6: 3mTlg4g0FJN2bo939h/0Wg ($652 in chips)
z/zDzN9GsrGWKD4D635nKA: posts small blind $5
7nu3NHCN2s0uUleNuVaGww: posts big blind $10
*** HOLE CARDS ***
33XJu1CVnl9YOngoPIhi0A: folds
AP3ihgkR8SLQyf0O1jly0g: folds
3mTlg4g0FJN2bo939h/0Wg: raises $10 to $20
BbirlZJeYiPjSFVvLtEDVw: folds
z/zDzN9GsrGWKD4D635nKA: folds
7nu3NHCN2s0uUleNuVaGww: folds
3mTlg4g0FJN2bo939h/0Wg collected $25 from pot
*** SUMMARY ***
Total pot $25 | Rake $0
Seat 1: BbirlZJeYiPjSFVvLtEDVw (button) folded before Flop (didn't bet)
Seat 2: z/zDzN9GsrGWKD4D635nKA (small blind) folded before Flop
Seat 3: 7nu3NHCN2s0uUleNuVaGww (big blind) folded before Flop
Seat 4: 33XJu1CVnl9YOngoPIhi0A folded before Flop (didn't bet)
Seat 5: AP3ihgkR8SLQyf0O1jly0g folded before Flop (didn't bet)
Seat 6: 3mTlg4g0FJN2bo939h/0Wg collected ($25)



PokerStars Game #59956069356:  Hold'em No Limit ($5/$10) - 2009/07/01 9:19:17 ET
Table '2a86NK3xhs21kwGZmbj0QA' 6-max Seat #2 is the button
Seat 1: BbirlZJeYiPjSFVvLtEDVw ($1138 in chips)
Seat 2: z/zDzN9GsrGWKD4D635nKA ($1167 in chips)
Seat 3: 7nu3NHCN2s0uUleNuVaGww ($990 in chips)
Seat 4: 33XJu1CVnl9YOngoPIhi0A ($2562 in chips)
Seat 5: AP3ihgkR8SLQyf0O1jly0g ($771 in chips)
Seat 6: 3mTlg4g0FJN2bo939h/0Wg ($667 in chips)
7nu3NHCN2s0uUleNuVaGww: posts small blind $5
33XJu1CVnl9YOngoPIhi0A: posts big blind $10
*** HOLE CARDS ***
AP3ihgkR8SLQyf0O1jly0g: folds
3mTlg4g0FJN2bo939h/0Wg: raises $10 to $20
BbirlZJeYiPjSFVvLtEDVw: folds
z/zDzN9GsrGWKD4D635nKA: folds
7nu3NHCN2s0uUleNuVaGww: folds
33XJu1CVnl9YOngoPIhi0A: folds
3mTlg4g0FJN2bo939h/0Wg collected $25 from pot
*** SUMMARY ***
Total pot $25 | Rake $0
Seat 1: BbirlZJeYiPjSFVvLtEDVw folded before Flop (didn't bet)
Seat 2: z/zDzN9GsrGWKD4D635nKA (button) folded before Flop (didn't bet)
Seat 3: 7nu3NHCN2s0uUleNuVaGww (small blind) folded before Flop
Seat 4: 33XJu1CVnl9YOngoPIhi0A (big blind) folded before Flop
Seat 5: AP3ihgkR8SLQyf0O1jly0g folded before Flop (didn't bet)
Seat 6: 3mTlg4g0FJN2bo939h/0Wg collected ($25)



PokerStars Game #59956073380:  Hold'em No Limit ($5/$10) - 2009/07/01 9:19:23 ET
Table 'agogFDSQKF+U0NUTbR6ZlA' 6-max Seat #6 is the button
Seat 1: ZaYCGtNHUeItoUEheoYDMw ($255 in chips)
Seat 2: BbirlZJeYiPjSFVvLtEDVw ($1035 in chips)
Seat 3: 33XJu1CVnl9YOngoPIhi0A ($963 in chips)
Seat 4: y9vGciYuJ4+4Z79YDgtBLg ($592.75 in chips)
Seat 5: dywrHhCI+xO1Q+U4dfdVaQ ($1022 in chips)
Seat 6: 3mTlg4g0FJN2bo939h/0Wg ($32 in chips)
ZaYCGtNHUeItoUEheoYDMw: posts small blind $5
BbirlZJeYiPjSFVvLtEDVw: posts big blind $10
*** HOLE CARDS ***
33XJu1CVnl9YOngoPIhi0A: raises $25 to $35
y9vGciYuJ4+4Z79YDgtBLg: folds
dywrHhCI+xO1Q+U4dfdVaQ: folds
3mTlg4g0FJN2bo939h/0Wg: calls $32 and is all-in
ZaYCGtNHUeItoUEheoYDMw: folds
BbirlZJeYiPjSFVvLtEDVw: folds
*** FLOP *** [Kh Qc Tc]
*** TURN *** [Kh Qc Tc] [Td]
*** RIVER *** [Kh Qc Tc Td] [5c]
*** SHOW DOWN ***
33XJu1CVnl9YOngoPIhi0A: shows [Qs Qh] (a full house, Queens full of Tens)
3mTlg4g0FJN2bo939h/0Wg: mucks hand
33XJu1CVnl9YOngoPIhi0A collected $76 from pot
*** SUMMARY ***
Total pot $79 | Rake $3
Board [Kh Qc Tc Td 5c]
Seat 1: ZaYCGtNHUeItoUEheoYDMw (small blind) folded before Flop
Seat 2: BbirlZJeYiPjSFVvLtEDVw (big blind) folded before Flop
Seat 3: 33XJu1CVnl9YOngoPIhi0A showed [Qs Qh] and won ($76) with a full house, Queens full of Tens
Seat 4: y9vGciYuJ4+4Z79YDgtBLg folded before Flop (didn't bet)
Seat 5: dywrHhCI+xO1Q+U4dfdVaQ folded before Flop (didn't bet)
Seat 6: 3mTlg4g0FJN2bo939h/0Wg (button) mucked



PokerStars Game #59956094372:  Hold'em No Limit ($5/$10) - 2009/07/01 9:19:50 ET
Table '2a86NK3xhs21kwGZmbj0QA' 6-max Seat #3 is the button
Seat 1: BbirlZJeYiPjSFVvLtEDVw ($1138 in chips)
Seat 2: z/zDzN9GsrGWKD4D635nKA ($1167 in chips)
Seat 3: 7nu3NHCN2s0uUleNuVaGww ($985 in chips)
Seat 4: 33XJu1CVnl9YOngoPIhi0A ($2552 in chips)
Seat 5: AP3ihgkR8SLQyf0O1jly0g ($771 in chips)
Seat 6: 3mTlg4g0FJN2bo939h/0Wg ($682 in chips)
33XJu1CVnl9YOngoPIhi0A: posts small blind $5
AP3ihgkR8SLQyf0O1jly0g: posts big blind $10
*** HOLE CARDS ***
3mTlg4g0FJN2bo939h/0Wg: folds
BbirlZJeYiPjSFVvLtEDVw: raises $20 to $30
z/zDzN9GsrGWKD4D635nKA: folds
7nu3NHCN2s0uUleNuVaGww: raises $85 to $115
33XJu1CVnl9YOngoPIhi0A: folds
AP3ihgkR8SLQyf0O1jly0g: folds
BbirlZJeYiPjSFVvLtEDVw: folds
7nu3NHCN2s0uUleNuVaGww collected $75 from pot
*** SUMMARY ***
Total pot $75 | Rake $0
Seat 1: BbirlZJeYiPjSFVvLtEDVw folded before Flop
Seat 2: z/zDzN9GsrGWKD4D635nKA folded before Flop (didn't bet)
Seat 3: 7nu3NHCN2s0uUleNuVaGww (button) collected ($75)
Seat 4: 33XJu1CVnl9YOngoPIhi0A (small blind) folded before Flop
Seat 5: AP3ihgkR8SLQyf0O1jly0g (big blind) folded before Flop
Seat 6: 3mTlg4g0FJN2bo939h/0Wg folded before Flop (didn't bet)



PokerStars Game #59956096004:  Hold'em No Limit ($5/$10) - 2009/07/01 9:19:52 ET
Table 'agogFDSQKF+U0NUTbR6ZlA' 6-max Seat #1 is the button
Seat 1: ZaYCGtNHUeItoUEheoYDMw ($250 in chips)
Seat 2: BbirlZJeYiPjSFVvLtEDVw ($1025 in chips)
Seat 3: 33XJu1CVnl9YOngoPIhi0A ($1007 in chips)
Seat 4: y9vGciYuJ4+4Z79YDgtBLg ($592.75 in chips)
Seat 5: dywrHhCI+xO1Q+U4dfdVaQ ($1022 in chips)
BbirlZJeYiPjSFVvLtEDVw: posts small blind $5
33XJu1CVnl9YOngoPIhi0A: posts big blind $10
*** HOLE CARDS ***
y9vGciYuJ4+4Z79YDgtBLg: folds
dywrHhCI+xO1Q+U4dfdVaQ: folds
ZaYCGtNHUeItoUEheoYDMw: folds
BbirlZJeYiPjSFVvLtEDVw: raises $20 to $30
jkH6qYMpn8JA/IyBOhQPMw joins the table at seat #6
33XJu1CVnl9YOngoPIhi0A: calls $20
*** FLOP *** [Qs 9c 9s]
BbirlZJeYiPjSFVvLtEDVw: bets $40
33XJu1CVnl9YOngoPIhi0A: folds
BbirlZJeYiPjSFVvLtEDVw collected $58 from pot
*** SUMMARY ***
Total pot $60 | Rake $2
Board [Qs 9c 9s]
Seat 1: ZaYCGtNHUeItoUEheoYDMw (button) folded before Flop (didn't bet)
Seat 2: BbirlZJeYiPjSFVvLtEDVw (small blind) collected ($58)
Seat 3: 33XJu1CVnl9YOngoPIhi0A (big blind) folded on the Flop
Seat 4: y9vGciYuJ4+4Z79YDgtBLg folded before Flop (didn't bet)
Seat 5: dywrHhCI+xO1Q+U4dfdVaQ folded before Flop (didn't bet)



PokerStars Game #59956116038:  Hold'em No Limit ($5/$10) - 2009/07/01 9:20:18 ET
Table 'agogFDSQKF+U0NUTbR6ZlA' 6-max Seat #2 is the button
Seat 1: ZaYCGtNHUeItoUEheoYDMw ($250 in chips)
Seat 2: BbirlZJeYiPjSFVvLtEDVw ($1053 in chips)
Seat 3: 33XJu1CVnl9YOngoPIhi0A ($977 in chips)
Seat 4: y9vGciYuJ4+4Z79YDgtBLg ($592.75 in chips)
Seat 5: dywrHhCI+xO1Q+U4dfdVaQ ($1022 in chips)
33XJu1CVnl9YOngoPIhi0A: posts small blind $5
y9vGciYuJ4+4Z79YDgtBLg: posts big blind $10
jkH6qYMpn8JA/IyBOhQPMw: sits out
*** HOLE CARDS ***
dywrHhCI+xO1Q+U4dfdVaQ: folds
ZaYCGtNHUeItoUEheoYDMw: raises $10 to $20
BbirlZJeYiPjSFVvLtEDVw: folds
33XJu1CVnl9YOngoPIhi0A: folds
y9vGciYuJ4+4Z79YDgtBLg: folds
ZaYCGtNHUeItoUEheoYDMw collected $25 from pot
*** SUMMARY ***
Total pot $25 | Rake $0
Seat 1: ZaYCGtNHUeItoUEheoYDMw collected ($25)
Seat 2: BbirlZJeYiPjSFVvLtEDVw (button) folded before Flop (didn't bet)
Seat 3: 33XJu1CVnl9YOngoPIhi0A (small blind) folded before Flop
Seat 4: y9vGciYuJ4+4Z79YDgtBLg (big blind) folded before Flop
Seat 5: dywrHhCI+xO1Q+U4dfdVaQ folded before Flop (didn't bet)



PokerStars Game #59956118918:  Hold'em No Limit ($5/$10) - 2009/07/01 9:20:22 ET
Table '2a86NK3xhs21kwGZmbj0QA' 6-max Seat #4 is the button
Seat 1: BbirlZJeYiPjSFVvLtEDVw ($1108 in chips)
Seat 2: z/zDzN9GsrGWKD4D635nKA ($1167 in chips)
Seat 3: 7nu3NHCN2s0uUleNuVaGww ($1030 in chips)
Seat 4: 33XJu1CVnl9YOngoPIhi0A ($2547 in chips)
Seat 5: AP3ihgkR8SLQyf0O1jly0g ($761 in chips)
Seat 6: 3mTlg4g0FJN2bo939h/0Wg ($682 in chips)
AP3ihgkR8SLQyf0O1jly0g: posts small blind $5
3mTlg4g0FJN2bo939h/0Wg: posts big blind $10
*** HOLE CARDS ***
BbirlZJeYiPjSFVvLtEDVw: folds
z/zDzN9GsrGWKD4D635nKA: folds
7nu3NHCN2s0uUleNuVaGww: folds
33XJu1CVnl9YOngoPIhi0A: folds
AP3ihgkR8SLQyf0O1jly0g: raises $20 to $30
3mTlg4g0FJN2bo939h/0Wg: calls $20
*** FLOP *** [9s 4d Kd]
AP3ihgkR8SLQyf0O1jly0g: checks
3mTlg4g0FJN2bo939h/0Wg: checks
*** TURN *** [9s 4d Kd] [2c]
AP3ihgkR8SLQyf0O1jly0g: checks
AP3ihgkR8SLQyf0O1jly0g said, "dont steal"
3mTlg4g0FJN2bo939h/0Wg said, "steal machine"
3mTlg4g0FJN2bo939h/0Wg: bets $30
AP3ihgkR8SLQyf0O1jly0g: calls $30
*** RIVER *** [9s 4d Kd 2c] [7s]
AP3ihgkR8SLQyf0O1jly0g: checks
3mTlg4g0FJN2bo939h/0Wg said, "you steal"
AP3ihgkR8SLQyf0O1jly0g said, "i check"
3mTlg4g0FJN2bo939h/0Wg: bets $120
AP3ihgkR8SLQyf0O1jly0g said, "lol set of 2?"
AP3ihgkR8SLQyf0O1jly0g said, "show me"
AP3ihgkR8SLQyf0O1jly0g: folds
3mTlg4g0FJN2bo939h/0Wg said, "no"
3mTlg4g0FJN2bo939h/0Wg collected $117 from pot
3mTlg4g0FJN2bo939h/0Wg: doesn't show hand
*** SUMMARY ***
Total pot $120 | Rake $3
Board [9s 4d Kd 2c 7s]
Seat 1: BbirlZJeYiPjSFVvLtEDVw folded before Flop (didn't bet)
Seat 2: z/zDzN9GsrGWKD4D635nKA folded before Flop (didn't bet)
Seat 3: 7nu3NHCN2s0uUleNuVaGww folded before Flop (didn't bet)
Seat 4: 33XJu1CVnl9YOngoPIhi0A (button) folded before Flop (didn't bet)
Seat 5: AP3ihgkR8SLQyf0O1jly0g (small blind) folded on the River
Seat 6: 3mTlg4g0FJN2bo939h/0Wg (big blind) collected ($117)



PokerStars Game #59956130232:  Hold'em No Limit ($5/$10) - 2009/07/01 9:20:37 ET
Table 'agogFDSQKF+U0NUTbR6ZlA' 6-max Seat #3 is the button
Seat 1: ZaYCGtNHUeItoUEheoYDMw ($265 in chips)
Seat 2: BbirlZJeYiPjSFVvLtEDVw ($1053 in chips)
Seat 3: 33XJu1CVnl9YOngoPIhi0A ($972 in chips)
Seat 4: y9vGciYuJ4+4Z79YDgtBLg ($582.75 in chips)
Seat 5: dywrHhCI+xO1Q+U4dfdVaQ ($1022 in chips)
y9vGciYuJ4+4Z79YDgtBLg: posts small blind $5
dywrHhCI+xO1Q+U4dfdVaQ: posts big blind $10
jkH6qYMpn8JA/IyBOhQPMw: sits out
*** HOLE CARDS ***
ZaYCGtNHUeItoUEheoYDMw: folds
BbirlZJeYiPjSFVvLtEDVw: folds
33XJu1CVnl9YOngoPIhi0A: folds
y9vGciYuJ4+4Z79YDgtBLg: folds
dywrHhCI+xO1Q+U4dfdVaQ collected $10 from pot
*** SUMMARY ***
Total pot $10 | Rake $0
Seat 1: ZaYCGtNHUeItoUEheoYDMw folded before Flop (didn't bet)
Seat 2: BbirlZJeYiPjSFVvLtEDVw folded before Flop (didn't bet)
Seat 3: 33XJu1CVnl9YOngoPIhi0A (button) folded before Flop (didn't bet)
Seat 4: y9vGciYuJ4+4Z79YDgtBLg (small blind) folded before Flop
Seat 5: dywrHhCI+xO1Q+U4dfdVaQ (big blind) collected ($10)



PokerStars Game #59956144832:  Hold'em No Limit ($5/$10) - 2009/07/01 9:20:57 ET
Table 'agogFDSQKF+U0NUTbR6ZlA' 6-max Seat #4 is the button
Seat 1: ZaYCGtNHUeItoUEheoYDMw ($265 in chips)
Seat 2: BbirlZJeYiPjSFVvLtEDVw ($1053 in chips)
Seat 3: 33XJu1CVnl9YOngoPIhi0A ($972 in chips)
Seat 4: y9vGciYuJ4+4Z79YDgtBLg ($577.75 in chips)
Seat 5: dywrHhCI+xO1Q+U4dfdVaQ ($1027 in chips)
Seat 6: jkH6qYMpn8JA/IyBOhQPMw ($1000 in chips)
dywrHhCI+xO1Q+U4dfdVaQ: posts small blind $5
jkH6qYMpn8JA/IyBOhQPMw: posts big blind $10
*** HOLE CARDS ***
ZaYCGtNHUeItoUEheoYDMw: raises $10 to $20
BbirlZJeYiPjSFVvLtEDVw: folds
33XJu1CVnl9YOngoPIhi0A: folds
y9vGciYuJ4+4Z79YDgtBLg: calls $20
dywrHhCI+xO1Q+U4dfdVaQ: calls $15
jkH6qYMpn8JA/IyBOhQPMw: calls $10
*** FLOP *** [6s Js 3c]
dywrHhCI+xO1Q+U4dfdVaQ: checks
jkH6qYMpn8JA/IyBOhQPMw: checks
ZaYCGtNHUeItoUEheoYDMw: checks
y9vGciYuJ4+4Z79YDgtBLg: checks
*** TURN *** [6s Js 3c] [2d]
dywrHhCI+xO1Q+U4dfdVaQ: checks
jkH6qYMpn8JA/IyBOhQPMw: bets $52
ZaYCGtNHUeItoUEheoYDMw: folds
y9vGciYuJ4+4Z79YDgtBLg: folds
dywrHhCI+xO1Q+U4dfdVaQ: folds
jkH6qYMpn8JA/IyBOhQPMw collected $77 from pot
*** SUMMARY ***
Total pot $80 | Rake $3
Board [6s Js 3c 2d]
Seat 1: ZaYCGtNHUeItoUEheoYDMw folded on the Turn
Seat 2: BbirlZJeYiPjSFVvLtEDVw folded before Flop (didn't bet)
Seat 3: 33XJu1CVnl9YOngoPIhi0A folded before Flop (didn't bet)
Seat 4: y9vGciYuJ4+4Z79YDgtBLg (button) folded on the Turn
Seat 5: dywrHhCI+xO1Q+U4dfdVaQ (small blind) folded on the Turn
Seat 6: jkH6qYMpn8JA/IyBOhQPMw (big blind) collected ($77)



PokerStars Game #59956172920:  Hold'em No Limit ($5/$10) - 2009/07/01 9:21:34 ET
Table '2a86NK3xhs21kwGZmbj0QA' 6-max Seat #5 is the button
Seat 2: z/zDzN9GsrGWKD4D635nKA ($1167 in chips)
Seat 3: 7nu3NHCN2s0uUleNuVaGww ($1030 in chips)
Seat 4: 33XJu1CVnl9YOngoPIhi0A ($2547 in chips)
Seat 5: AP3ihgkR8SLQyf0O1jly0g ($701 in chips)
Seat 6: 3mTlg4g0FJN2bo939h/0Wg ($739 in chips)
3mTlg4g0FJN2bo939h/0Wg: posts small blind $5
BbirlZJeYiPjSFVvLtEDVw: is sitting out
z/zDzN9GsrGWKD4D635nKA: posts big blind $10
*** HOLE CARDS ***
BbirlZJeYiPjSFVvLtEDVw has returned
7nu3NHCN2s0uUleNuVaGww: folds
33XJu1CVnl9YOngoPIhi0A: folds
AP3ihgkR8SLQyf0O1jly0g: folds
3mTlg4g0FJN2bo939h/0Wg: raises $10 to $20
z/zDzN9GsrGWKD4D635nKA: folds
3mTlg4g0FJN2bo939h/0Wg collected $20 from pot
3mTlg4g0FJN2bo939h/0Wg: doesn't show hand
*** SUMMARY ***
Total pot $20 | Rake $0
Seat 2: z/zDzN9GsrGWKD4D635nKA (big blind) folded before Flop
Seat 3: 7nu3NHCN2s0uUleNuVaGww folded before Flop (didn't bet)
Seat 4: 33XJu1CVnl9YOngoPIhi0A folded before Flop (didn't bet)
Seat 5: AP3ihgkR8SLQyf0O1jly0g (button) folded before Flop (didn't bet)
Seat 6: 3mTlg4g0FJN2bo939h/0Wg (small blind) collected ($20)



PokerStars Game #59956181364:  Hold'em No Limit ($5/$10) - 2009/07/01 9:21:45 ET
Table '2a86NK3xhs21kwGZmbj0QA' 6-max Seat #6 is the button
Seat 2: z/zDzN9GsrGWKD4D635nKA ($1157 in chips)
Seat 3: 7nu3NHCN2s0uUleNuVaGww ($1030 in chips)
Seat 4: 33XJu1CVnl9YOngoPIhi0A ($2547 in chips)
Seat 5: AP3ihgkR8SLQyf0O1jly0g ($701 in chips)
Seat 6: 3mTlg4g0FJN2bo939h/0Wg ($749 in chips)
BbirlZJeYiPjSFVvLtEDVw will be allowed to play after the button
z/zDzN9GsrGWKD4D635nKA: posts small blind $5
7nu3NHCN2s0uUleNuVaGww: posts big blind $10
*** HOLE CARDS ***
33XJu1CVnl9YOngoPIhi0A: raises $20 to $30
AP3ihgkR8SLQyf0O1jly0g: folds
3mTlg4g0FJN2bo939h/0Wg: calls $30
z/zDzN9GsrGWKD4D635nKA: folds
7nu3NHCN2s0uUleNuVaGww: folds
*** FLOP *** [Jc Ad 6c]
33XJu1CVnl9YOngoPIhi0A: bets $40
3mTlg4g0FJN2bo939h/0Wg: calls $40
*** TURN *** [Jc Ad 6c] [5d]
33XJu1CVnl9YOngoPIhi0A: checks
3mTlg4g0FJN2bo939h/0Wg: checks
*** RIVER *** [Jc Ad 6c 5d] [4s]
33XJu1CVnl9YOngoPIhi0A: checks
3mTlg4g0FJN2bo939h/0Wg: bets $80
33XJu1CVnl9YOngoPIhi0A: calls $80
*** SHOW DOWN ***
3mTlg4g0FJN2bo939h/0Wg: shows [Kc Qs] (high card Ace)
33XJu1CVnl9YOngoPIhi0A: shows [Kd Jh] (a pair of Jacks)
33XJu1CVnl9YOngoPIhi0A collected $313 from pot
*** SUMMARY ***
Total pot $315 | Rake $2
Board [Jc Ad 6c 5d 4s]
Seat 2: z/zDzN9GsrGWKD4D635nKA (small blind) folded before Flop
Seat 3: 7nu3NHCN2s0uUleNuVaGww (big blind) folded before Flop
Seat 4: 33XJu1CVnl9YOngoPIhi0A showed [Kd Jh] and won ($313) with a pair of Jacks
Seat 5: AP3ihgkR8SLQyf0O1jly0g folded before Flop (didn't bet)
Seat 6: 3mTlg4g0FJN2bo939h/0Wg (button) showed [Kc Qs] and lost with high card Ace



PokerStars Game #59956200636:  Hold'em No Limit ($5/$10) - 2009/07/01 9:22:09 ET
Table 'agogFDSQKF+U0NUTbR6ZlA' 6-max Seat #5 is the button
Seat 1: ZaYCGtNHUeItoUEheoYDMw ($245 in chips)
Seat 2: BbirlZJeYiPjSFVvLtEDVw ($1053 in chips)
Seat 3: 33XJu1CVnl9YOngoPIhi0A ($972 in chips)
Seat 4: y9vGciYuJ4+4Z79YDgtBLg ($557.75 in chips)
Seat 5: dywrHhCI+xO1Q+U4dfdVaQ ($1007 in chips)
Seat 6: jkH6qYMpn8JA/IyBOhQPMw ($1057 in chips)
jkH6qYMpn8JA/IyBOhQPMw: posts small blind $5
ZaYCGtNHUeItoUEheoYDMw: posts big blind $10
*** HOLE CARDS ***
BbirlZJeYiPjSFVvLtEDVw: folds
33XJu1CVnl9YOngoPIhi0A: folds
y9vGciYuJ4+4Z79YDgtBLg: folds
dywrHhCI+xO1Q+U4dfdVaQ: raises $20 to $30
jkH6qYMpn8JA/IyBOhQPMw: folds
ZaYCGtNHUeItoUEheoYDMw: folds
dywrHhCI+xO1Q+U4dfdVaQ collected $25 from pot
*** SUMMARY ***
Total pot $25 | Rake $0
Seat 1: ZaYCGtNHUeItoUEheoYDMw (big blind) folded before Flop
Seat 2: BbirlZJeYiPjSFVvLtEDVw folded before Flop (didn't bet)
Seat 3: 33XJu1CVnl9YOngoPIhi0A folded before Flop (didn't bet)
Seat 4: y9vGciYuJ4+4Z79YDgtBLg folded before Flop (didn't bet)
Seat 5: dywrHhCI+xO1Q+U4dfdVaQ (button) collected ($25)
Seat 6: jkH6qYMpn8JA/IyBOhQPMw (small blind) folded before Flop



PokerStars Game #59956212384:  Hold'em No Limit ($5/$10) - 2009/07/01 9:22:24 ET
Table '2a86NK3xhs21kwGZmbj0QA' 6-max Seat #2 is the button
Seat 2: z/zDzN9GsrGWKD4D635nKA ($1152 in chips)
Seat 3: 7nu3NHCN2s0uUleNuVaGww ($1020 in chips)
Seat 4: 33XJu1CVnl9YOngoPIhi0A ($2710 in chips)
Seat 5: AP3ihgkR8SLQyf0O1jly0g ($701 in chips)
Seat 6: 3mTlg4g0FJN2bo939h/0Wg ($599 in chips)
7nu3NHCN2s0uUleNuVaGww: posts small blind $5
33XJu1CVnl9YOngoPIhi0A: posts big blind $10
BbirlZJeYiPjSFVvLtEDVw: sits out
*** HOLE CARDS ***
AP3ihgkR8SLQyf0O1jly0g: folds
3mTlg4g0FJN2bo939h/0Wg: folds
z/zDzN9GsrGWKD4D635nKA: raises $20 to $30
7nu3NHCN2s0uUleNuVaGww: folds
33XJu1CVnl9YOngoPIhi0A: folds
z/zDzN9GsrGWKD4D635nKA collected $25 from pot
z/zDzN9GsrGWKD4D635nKA: doesn't show hand
*** SUMMARY ***
Total pot $25 | Rake $0
Seat 2: z/zDzN9GsrGWKD4D635nKA (button) collected ($25)
Seat 3: 7nu3NHCN2s0uUleNuVaGww (small blind) folded before Flop
Seat 4: 33XJu1CVnl9YOngoPIhi0A (big blind) folded before Flop
Seat 5: AP3ihgkR8SLQyf0O1jly0g folded before Flop (didn't bet)
Seat 6: 3mTlg4g0FJN2bo939h/0Wg folded before Flop (didn't bet)



PokerStars Game #59956221776:  Hold'em No Limit ($5/$10) - 2009/07/01 9:22:37 ET
Table 'agogFDSQKF+U0NUTbR6ZlA' 6-max Seat #6 is the button
Seat 1: ZaYCGtNHUeItoUEheoYDMw ($235 in chips)
Seat 2: BbirlZJeYiPjSFVvLtEDVw ($1053 in chips)
Seat 3: 33XJu1CVnl9YOngoPIhi0A ($972 in chips)
Seat 4: y9vGciYuJ4+4Z79YDgtBLg ($557.75 in chips)
Seat 5: dywrHhCI+xO1Q+U4dfdVaQ ($1022 in chips)
Seat 6: jkH6qYMpn8JA/IyBOhQPMw ($1052 in chips)
ZaYCGtNHUeItoUEheoYDMw: posts small blind $5
BbirlZJeYiPjSFVvLtEDVw: posts big blind $10
*** HOLE CARDS ***
33XJu1CVnl9YOngoPIhi0A: folds
y9vGciYuJ4+4Z79YDgtBLg: folds
dywrHhCI+xO1Q+U4dfdVaQ: folds
jkH6qYMpn8JA/IyBOhQPMw: raises $20 to $30
ZaYCGtNHUeItoUEheoYDMw: folds
BbirlZJeYiPjSFVvLtEDVw: folds
jkH6qYMpn8JA/IyBOhQPMw collected $25 from pot
*** SUMMARY ***
Total pot $25 | Rake $0
Seat 1: ZaYCGtNHUeItoUEheoYDMw (small blind) folded before Flop
Seat 2: BbirlZJeYiPjSFVvLtEDVw (big blind) folded before Flop
Seat 3: 33XJu1CVnl9YOngoPIhi0A folded before Flop (didn't bet)
Seat 4: y9vGciYuJ4+4Z79YDgtBLg folded before Flop (didn't bet)
Seat 5: dywrHhCI+xO1Q+U4dfdVaQ folded before Flop (didn't bet)
Seat 6: jkH6qYMpn8JA/IyBOhQPMw (button) collected ($25)



PokerStars Game #59956223414:  Hold'em No Limit ($5/$10) - 2009/07/01 9:22:39 ET
Table '2a86NK3xhs21kwGZmbj0QA' 6-max Seat #3 is the button
Seat 2: z/zDzN9GsrGWKD4D635nKA ($1167 in chips)
Seat 3: 7nu3NHCN2s0uUleNuVaGww ($1015 in chips)
Seat 4: 33XJu1CVnl9YOngoPIhi0A ($2700 in chips)
Seat 5: AP3ihgkR8SLQyf0O1jly0g ($701 in chips)
Seat 6: 3mTlg4g0FJN2bo939h/0Wg ($599 in chips)
33XJu1CVnl9YOngoPIhi0A: posts small blind $5
AP3ihgkR8SLQyf0O1jly0g: posts big blind $10
BbirlZJeYiPjSFVvLtEDVw: sits out
*** HOLE CARDS ***
3mTlg4g0FJN2bo939h/0Wg: folds
z/zDzN9GsrGWKD4D635nKA: raises $20 to $30
7nu3NHCN2s0uUleNuVaGww: folds
33XJu1CVnl9YOngoPIhi0A: calls $25
AP3ihgkR8SLQyf0O1jly0g: calls $20
*** FLOP *** [4c Qc 8c]
33XJu1CVnl9YOngoPIhi0A: checks
AP3ihgkR8SLQyf0O1jly0g: checks
z/zDzN9GsrGWKD4D635nKA: checks
*** TURN *** [4c Qc 8c] [6c]
33XJu1CVnl9YOngoPIhi0A: checks
AP3ihgkR8SLQyf0O1jly0g: bets $70
z/zDzN9GsrGWKD4D635nKA: folds
33XJu1CVnl9YOngoPIhi0A: calls $70
*** RIVER *** [4c Qc 8c 6c] [6h]
33XJu1CVnl9YOngoPIhi0A: checks
AP3ihgkR8SLQyf0O1jly0g: checks
*** SHOW DOWN ***
33XJu1CVnl9YOngoPIhi0A: shows [9s 9c] (a flush, Queen high)
AP3ihgkR8SLQyf0O1jly0g: mucks hand
33XJu1CVnl9YOngoPIhi0A collected $228 from pot
*** SUMMARY ***
Total pot $230 | Rake $2
Board [4c Qc 8c 6c 6h]
Seat 2: z/zDzN9GsrGWKD4D635nKA folded on the Turn
Seat 3: 7nu3NHCN2s0uUleNuVaGww (button) folded before Flop (didn't bet)
Seat 4: 33XJu1CVnl9YOngoPIhi0A (small blind) showed [9s 9c] and won ($228) with a flush, Queen high
Seat 5: AP3ihgkR8SLQyf0O1jly0g (big blind) mucked
Seat 6: 3mTlg4g0FJN2bo939h/0Wg folded before Flop (didn't bet)



PokerStars Game #59956238162:  Hold'em No Limit ($5/$10) - 2009/07/01 9:22:58 ET
Table 'agogFDSQKF+U0NUTbR6ZlA' 6-max Seat #1 is the button
Seat 1: ZaYCGtNHUeItoUEheoYDMw ($230 in chips)
Seat 2: BbirlZJeYiPjSFVvLtEDVw ($1043 in chips)
Seat 3: 33XJu1CVnl9YOngoPIhi0A ($972 in chips)
Seat 4: y9vGciYuJ4+4Z79YDgtBLg ($557.75 in chips)
Seat 5: dywrHhCI+xO1Q+U4dfdVaQ ($1022 in chips)
Seat 6: jkH6qYMpn8JA/IyBOhQPMw ($1067 in chips)
BbirlZJeYiPjSFVvLtEDVw: posts small blind $5
33XJu1CVnl9YOngoPIhi0A: posts big blind $10
*** HOLE CARDS ***
y9vGciYuJ4+4Z79YDgtBLg: raises $20 to $30
dywrHhCI+xO1Q+U4dfdVaQ: folds
jkH6qYMpn8JA/IyBOhQPMw: calls $30
ZaYCGtNHUeItoUEheoYDMw: folds
BbirlZJeYiPjSFVvLtEDVw: folds
33XJu1CVnl9YOngoPIhi0A: folds
*** FLOP *** [8h 5s 4h]
y9vGciYuJ4+4Z79YDgtBLg: bets $40
jkH6qYMpn8JA/IyBOhQPMw: calls $40
*** TURN *** [8h 5s 4h] [Qh]
y9vGciYuJ4+4Z79YDgtBLg: bets $80
jkH6qYMpn8JA/IyBOhQPMw: raises $340 to $420
y9vGciYuJ4+4Z79YDgtBLg: calls $340
*** RIVER *** [8h 5s 4h Qh] [8d]
y9vGciYuJ4+4Z79YDgtBLg: checks
jkH6qYMpn8JA/IyBOhQPMw: checks
*** SHOW DOWN ***
y9vGciYuJ4+4Z79YDgtBLg: shows [9h Th] (a flush, Queen high)
jkH6qYMpn8JA/IyBOhQPMw: mucks hand
y9vGciYuJ4+4Z79YDgtBLg collected $992 from pot
*** SUMMARY ***
Total pot $995 | Rake $3
Board [8h 5s 4h Qh 8d]
Seat 1: ZaYCGtNHUeItoUEheoYDMw (button) folded before Flop (didn't bet)
Seat 2: BbirlZJeYiPjSFVvLtEDVw (small blind) folded before Flop
Seat 3: 33XJu1CVnl9YOngoPIhi0A (big blind) folded before Flop
Seat 4: y9vGciYuJ4+4Z79YDgtBLg showed [9h Th] and won ($992) with a flush, Queen high
Seat 5: dywrHhCI+xO1Q+U4dfdVaQ folded before Flop (didn't bet)
Seat 6: jkH6qYMpn8JA/IyBOhQPMw mucked



PokerStars Game #59956266904:  Hold'em No Limit ($5/$10) - 2009/07/01 9:23:36 ET
Table '2a86NK3xhs21kwGZmbj0QA' 6-max Seat #4 is the button
Seat 2: z/zDzN9GsrGWKD4D635nKA ($1137 in chips)
Seat 3: 7nu3NHCN2s0uUleNuVaGww ($1015 in chips)
Seat 4: 33XJu1CVnl9YOngoPIhi0A ($2828 in chips)
Seat 5: AP3ihgkR8SLQyf0O1jly0g ($601 in chips)
Seat 6: 3mTlg4g0FJN2bo939h/0Wg ($599 in chips)
AP3ihgkR8SLQyf0O1jly0g: posts small blind $5
3mTlg4g0FJN2bo939h/0Wg: posts big blind $10
BbirlZJeYiPjSFVvLtEDVw: sits out
*** HOLE CARDS ***
z/zDzN9GsrGWKD4D635nKA: folds
7nu3NHCN2s0uUleNuVaGww: raises $20 to $30
33XJu1CVnl9YOngoPIhi0A: folds
AP3ihgkR8SLQyf0O1jly0g: folds
3mTlg4g0FJN2bo939h/0Wg: calls $20
*** FLOP *** [Ts 2h 7h]
3mTlg4g0FJN2bo939h/0Wg: checks
7nu3NHCN2s0uUleNuVaGww: checks
*** TURN *** [Ts 2h 7h] [2s]
3mTlg4g0FJN2bo939h/0Wg: bets $30
7nu3NHCN2s0uUleNuVaGww: calls $30
*** RIVER *** [Ts 2h 7h 2s] [6h]
3mTlg4g0FJN2bo939h/0Wg: bets $70
7nu3NHCN2s0uUleNuVaGww: folds
3mTlg4g0FJN2bo939h/0Wg collected $123 from pot
*** SUMMARY ***
Total pot $125 | Rake $2
Board [Ts 2h 7h 2s 6h]
Seat 2: z/zDzN9GsrGWKD4D635nKA folded before Flop (didn't bet)
Seat 3: 7nu3NHCN2s0uUleNuVaGww folded on the River
Seat 4: 33XJu1CVnl9YOngoPIhi0A (button) folded before Flop (didn't bet)
Seat 5: AP3ihgkR8SLQyf0O1jly0g (small blind) folded before Flop
Seat 6: 3mTlg4g0FJN2bo939h/0Wg (big blind) collected ($123)



PokerStars Game #59956284904:  Hold'em No Limit ($5/$10) - 2009/07/01 9:24:00 ET
Table 'agogFDSQKF+U0NUTbR6ZlA' 6-max Seat #2 is the button
Seat 1: ZaYCGtNHUeItoUEheoYDMw ($230 in chips)
Seat 2: BbirlZJeYiPjSFVvLtEDVw ($1038 in chips)
Seat 3: 33XJu1CVnl9YOngoPIhi0A ($962 in chips)
Seat 4: y9vGciYuJ4+4Z79YDgtBLg ($1059.75 in chips)
Seat 5: dywrHhCI+xO1Q+U4dfdVaQ ($1022 in chips)
Seat 6: jkH6qYMpn8JA/IyBOhQPMw ($1000 in chips)
33XJu1CVnl9YOngoPIhi0A: posts small blind $5
y9vGciYuJ4+4Z79YDgtBLg: posts big blind $10
*** HOLE CARDS ***
dywrHhCI+xO1Q+U4dfdVaQ: folds
jkH6qYMpn8JA/IyBOhQPMw: folds
ZaYCGtNHUeItoUEheoYDMw: folds
BbirlZJeYiPjSFVvLtEDVw: folds
33XJu1CVnl9YOngoPIhi0A: raises $20 to $30
y9vGciYuJ4+4Z79YDgtBLg: folds
33XJu1CVnl9YOngoPIhi0A collected $20 from pot
33XJu1CVnl9YOngoPIhi0A: doesn't show hand
*** SUMMARY ***
Total pot $20 | Rake $0
Seat 1: ZaYCGtNHUeItoUEheoYDMw folded before Flop (didn't bet)
Seat 2: BbirlZJeYiPjSFVvLtEDVw (button) folded before Flop (didn't bet)
Seat 3: 33XJu1CVnl9YOngoPIhi0A (small blind) collected ($20)
Seat 4: y9vGciYuJ4+4Z79YDgtBLg (big blind) folded before Flop
Seat 5: dywrHhCI+xO1Q+U4dfdVaQ folded before Flop (didn't bet)
Seat 6: jkH6qYMpn8JA/IyBOhQPMw folded before Flop (didn't bet)



PokerStars Game #59956304984:  Hold'em No Limit ($5/$10) - 2009/07/01 9:24:27 ET
Table '2a86NK3xhs21kwGZmbj0QA' 6-max Seat #5 is the button
Seat 1: BbirlZJeYiPjSFVvLtEDVw ($1108 in chips)
Seat 2: z/zDzN9GsrGWKD4D635nKA ($1137 in chips)
Seat 3: 7nu3NHCN2s0uUleNuVaGww ($1000 in chips)
Seat 4: 33XJu1CVnl9YOngoPIhi0A ($2828 in chips)
Seat 5: AP3ihgkR8SLQyf0O1jly0g ($596 in chips)
Seat 6: 3mTlg4g0FJN2bo939h/0Wg ($662 in chips)
3mTlg4g0FJN2bo939h/0Wg: posts small blind $5
BbirlZJeYiPjSFVvLtEDVw: posts big blind $10
*** HOLE CARDS ***
z/zDzN9GsrGWKD4D635nKA: folds
7nu3NHCN2s0uUleNuVaGww: folds
33XJu1CVnl9YOngoPIhi0A: folds
AP3ihgkR8SLQyf0O1jly0g: folds
3mTlg4g0FJN2bo939h/0Wg: raises $10 to $20
BbirlZJeYiPjSFVvLtEDVw: calls $10
*** FLOP *** [8d 6h Jd]
3mTlg4g0FJN2bo939h/0Wg: bets $20
BbirlZJeYiPjSFVvLtEDVw: calls $20
*** TURN *** [8d 6h Jd] [2h]
3mTlg4g0FJN2bo939h/0Wg: checks
BbirlZJeYiPjSFVvLtEDVw: checks
*** RIVER *** [8d 6h Jd 2h] [Ks]
3mTlg4g0FJN2bo939h/0Wg: checks
BbirlZJeYiPjSFVvLtEDVw: bets $50
3mTlg4g0FJN2bo939h/0Wg: calls $50
*** SHOW DOWN ***
BbirlZJeYiPjSFVvLtEDVw: shows [9s 7s] (high card King)
3mTlg4g0FJN2bo939h/0Wg: shows [7d 7h] (a pair of Sevens)
3mTlg4g0FJN2bo939h/0Wg collected $177 from pot
*** SUMMARY ***
Total pot $180 | Rake $3
Board [8d 6h Jd 2h Ks]
Seat 1: BbirlZJeYiPjSFVvLtEDVw (big blind) showed [9s 7s] and lost with high card King
Seat 2: z/zDzN9GsrGWKD4D635nKA folded before Flop (didn't bet)
Seat 3: 7nu3NHCN2s0uUleNuVaGww folded before Flop (didn't bet)
Seat 4: 33XJu1CVnl9YOngoPIhi0A folded before Flop (didn't bet)
Seat 5: AP3ihgkR8SLQyf0O1jly0g (button) folded before Flop (didn't bet)
Seat 6: 3mTlg4g0FJN2bo939h/0Wg (small blind) showed [7d 7h] and won ($177) with a pair of Sevens



PokerStars Game #59956313510:  Hold'em No Limit ($5/$10) - 2009/07/01 9:24:38 ET
Table 'agogFDSQKF+U0NUTbR6ZlA' 6-max Seat #3 is the button
Seat 1: ZaYCGtNHUeItoUEheoYDMw ($230 in chips)
Seat 2: BbirlZJeYiPjSFVvLtEDVw ($1038 in chips)
Seat 3: 33XJu1CVnl9YOngoPIhi0A ($972 in chips)
Seat 4: y9vGciYuJ4+4Z79YDgtBLg ($1049.75 in chips)
Seat 5: dywrHhCI+xO1Q+U4dfdVaQ ($1022 in chips)
Seat 6: jkH6qYMpn8JA/IyBOhQPMw ($1000 in chips)
y9vGciYuJ4+4Z79YDgtBLg: posts small blind $5
dywrHhCI+xO1Q+U4dfdVaQ: posts big blind $10
*** HOLE CARDS ***
jkH6qYMpn8JA/IyBOhQPMw: folds
ZaYCGtNHUeItoUEheoYDMw: raises $10 to $20
BbirlZJeYiPjSFVvLtEDVw: folds
33XJu1CVnl9YOngoPIhi0A: calls $20
y9vGciYuJ4+4Z79YDgtBLg: folds
dywrHhCI+xO1Q+U4dfdVaQ: folds
*** FLOP *** [3s 7d Ac]
ZaYCGtNHUeItoUEheoYDMw: bets $20
33XJu1CVnl9YOngoPIhi0A: folds
ZaYCGtNHUeItoUEheoYDMw collected $52.25 from pot
*** SUMMARY ***
Total pot $55 | Rake $2.75
Board [3s 7d Ac]
Seat 1: ZaYCGtNHUeItoUEheoYDMw collected ($52.25)
Seat 2: BbirlZJeYiPjSFVvLtEDVw folded before Flop (didn't bet)
Seat 3: 33XJu1CVnl9YOngoPIhi0A (button) folded on the Flop
Seat 4: y9vGciYuJ4+4Z79YDgtBLg (small blind) folded before Flop
Seat 5: dywrHhCI+xO1Q+U4dfdVaQ (big blind) folded before Flop
Seat 6: jkH6qYMpn8JA/IyBOhQPMw folded before Flop (didn't bet)



PokerStars Game #59956342772:  Hold'em No Limit ($5/$10) - 2009/07/01 9:25:17 ET
Table 'agogFDSQKF+U0NUTbR6ZlA' 6-max Seat #4 is the button
Seat 1: ZaYCGtNHUeItoUEheoYDMw ($262.25 in chips)
Seat 2: BbirlZJeYiPjSFVvLtEDVw ($1038 in chips)
Seat 3: 33XJu1CVnl9YOngoPIhi0A ($952 in chips)
Seat 4: y9vGciYuJ4+4Z79YDgtBLg ($1044.75 in chips)
Seat 5: dywrHhCI+xO1Q+U4dfdVaQ ($1012 in chips)
Seat 6: jkH6qYMpn8JA/IyBOhQPMw ($1000 in chips)
dywrHhCI+xO1Q+U4dfdVaQ: posts small blind $5
jkH6qYMpn8JA/IyBOhQPMw: posts big blind $10
*** HOLE CARDS ***
ZaYCGtNHUeItoUEheoYDMw: folds
ZaYCGtNHUeItoUEheoYDMw leaves the table
BbirlZJeYiPjSFVvLtEDVw: raises $20 to $30
33XJu1CVnl9YOngoPIhi0A: folds
y9vGciYuJ4+4Z79YDgtBLg: folds
dywrHhCI+xO1Q+U4dfdVaQ: folds
jkH6qYMpn8JA/IyBOhQPMw: folds
BbirlZJeYiPjSFVvLtEDVw collected $25 from pot
*** SUMMARY ***
Total pot $25 | Rake $0
Seat 1: ZaYCGtNHUeItoUEheoYDMw folded before Flop (didn't bet)
Seat 2: BbirlZJeYiPjSFVvLtEDVw collected ($25)
Seat 3: 33XJu1CVnl9YOngoPIhi0A folded before Flop (didn't bet)
Seat 4: y9vGciYuJ4+4Z79YDgtBLg (button) folded before Flop (didn't bet)
Seat 5: dywrHhCI+xO1Q+U4dfdVaQ (small blind) folded before Flop
Seat 6: jkH6qYMpn8JA/IyBOhQPMw (big blind) folded before Flop



PokerStars Game #59956352766:  Hold'em No Limit ($5/$10) - 2009/07/01 9:25:30 ET
Table '2a86NK3xhs21kwGZmbj0QA' 6-max Seat #6 is the button
Seat 1: BbirlZJeYiPjSFVvLtEDVw ($1018 in chips)
Seat 2: z/zDzN9GsrGWKD4D635nKA ($1137 in chips)
Seat 3: 7nu3NHCN2s0uUleNuVaGww ($1000 in chips)
Seat 4: 33XJu1CVnl9YOngoPIhi0A ($2828 in chips)
Seat 5: AP3ihgkR8SLQyf0O1jly0g ($596 in chips)
Seat 6: 3mTlg4g0FJN2bo939h/0Wg ($749 in chips)
BbirlZJeYiPjSFVvLtEDVw: posts small blind $5
z/zDzN9GsrGWKD4D635nKA: posts big blind $10
*** HOLE CARDS ***
7nu3NHCN2s0uUleNuVaGww: folds
33XJu1CVnl9YOngoPIhi0A: folds
AP3ihgkR8SLQyf0O1jly0g: folds
3mTlg4g0FJN2bo939h/0Wg: raises $10 to $20
BbirlZJeYiPjSFVvLtEDVw: folds
z/zDzN9GsrGWKD4D635nKA: folds
3mTlg4g0FJN2bo939h/0Wg collected $25 from pot
3mTlg4g0FJN2bo939h/0Wg: doesn't show hand
*** SUMMARY ***
Total pot $25 | Rake $0
Seat 1: BbirlZJeYiPjSFVvLtEDVw (small blind) folded before Flop
Seat 2: z/zDzN9GsrGWKD4D635nKA (big blind) folded before Flop
Seat 3: 7nu3NHCN2s0uUleNuVaGww folded before Flop (didn't bet)
Seat 4: 33XJu1CVnl9YOngoPIhi0A folded before Flop (didn't bet)
Seat 5: AP3ihgkR8SLQyf0O1jly0g folded before Flop (didn't bet)
Seat 6: 3mTlg4g0FJN2bo939h/0Wg (button) collected ($25)



PokerStars Game #59956358546:  Hold'em No Limit ($5/$10) - 2009/07/01 9:25:38 ET
Table 'agogFDSQKF+U0NUTbR6ZlA' 6-max Seat #5 is the button
Seat 2: BbirlZJeYiPjSFVvLtEDVw ($1053 in chips)
Seat 3: 33XJu1CVnl9YOngoPIhi0A ($952 in chips)
Seat 4: y9vGciYuJ4+4Z79YDgtBLg ($1044.75 in chips)
Seat 5: dywrHhCI+xO1Q+U4dfdVaQ ($1007 in chips)
Seat 6: jkH6qYMpn8JA/IyBOhQPMw ($1000 in chips)
jkH6qYMpn8JA/IyBOhQPMw: posts small blind $5
BbirlZJeYiPjSFVvLtEDVw: posts big blind $10
*** HOLE CARDS ***
9N2plUp64x0CQSt1tu6thw joins the table at seat #1
33XJu1CVnl9YOngoPIhi0A: folds
y9vGciYuJ4+4Z79YDgtBLg: raises $10 to $20
dywrHhCI+xO1Q+U4dfdVaQ: folds
jkH6qYMpn8JA/IyBOhQPMw: folds
BbirlZJeYiPjSFVvLtEDVw: folds
y9vGciYuJ4+4Z79YDgtBLg collected $25 from pot
*** SUMMARY ***
Total pot $25 | Rake $0
Seat 2: BbirlZJeYiPjSFVvLtEDVw (big blind) folded before Flop
Seat 3: 33XJu1CVnl9YOngoPIhi0A folded before Flop (didn't bet)
Seat 4: y9vGciYuJ4+4Z79YDgtBLg collected ($25)
Seat 5: dywrHhCI+xO1Q+U4dfdVaQ (button) folded before Flop (didn't bet)
Seat 6: jkH6qYMpn8JA/IyBOhQPMw (small blind) folded before Flop



PokerStars Game #59956365600:  Hold'em No Limit ($5/$10) - 2009/07/01 9:25:48 ET
Table '2a86NK3xhs21kwGZmbj0QA' 6-max Seat #1 is the button
Seat 1: BbirlZJeYiPjSFVvLtEDVw ($1013 in chips)
Seat 2: z/zDzN9GsrGWKD4D635nKA ($1127 in chips)
Seat 3: 7nu3NHCN2s0uUleNuVaGww ($1000 in chips)
Seat 4: 33XJu1CVnl9YOngoPIhi0A ($2828 in chips)
Seat 5: AP3ihgkR8SLQyf0O1jly0g ($596 in chips)
Seat 6: 3mTlg4g0FJN2bo939h/0Wg ($764 in chips)
z/zDzN9GsrGWKD4D635nKA: posts small blind $5
7nu3NHCN2s0uUleNuVaGww: posts big blind $10
*** HOLE CARDS ***
33XJu1CVnl9YOngoPIhi0A: folds
AP3ihgkR8SLQyf0O1jly0g has timed out
AP3ihgkR8SLQyf0O1jly0g: folds
AP3ihgkR8SLQyf0O1jly0g is sitting out
AP3ihgkR8SLQyf0O1jly0g has returned
3mTlg4g0FJN2bo939h/0Wg: folds
BbirlZJeYiPjSFVvLtEDVw: raises $20 to $30
z/zDzN9GsrGWKD4D635nKA: folds
7nu3NHCN2s0uUleNuVaGww: folds
BbirlZJeYiPjSFVvLtEDVw collected $25 from pot
BbirlZJeYiPjSFVvLtEDVw: doesn't show hand
*** SUMMARY ***
Total pot $25 | Rake $0
Seat 1: BbirlZJeYiPjSFVvLtEDVw (button) collected ($25)
Seat 2: z/zDzN9GsrGWKD4D635nKA (small blind) folded before Flop
Seat 3: 7nu3NHCN2s0uUleNuVaGww (big blind) folded before Flop
Seat 4: 33XJu1CVnl9YOngoPIhi0A folded before Flop (didn't bet)
Seat 5: AP3ihgkR8SLQyf0O1jly0g folded before Flop (didn't bet)
Seat 6: 3mTlg4g0FJN2bo939h/0Wg folded before Flop (didn't bet)



PokerStars Game #59956375064:  Hold'em No Limit ($5/$10) - 2009/07/01 9:26:00 ET
Table 'agogFDSQKF+U0NUTbR6ZlA' 6-max Seat #6 is the button
Seat 2: BbirlZJeYiPjSFVvLtEDVw ($1043 in chips)
Seat 3: 33XJu1CVnl9YOngoPIhi0A ($952 in chips)
Seat 4: y9vGciYuJ4+4Z79YDgtBLg ($1059.75 in chips)
Seat 5: dywrHhCI+xO1Q+U4dfdVaQ ($1007 in chips)
Seat 6: jkH6qYMpn8JA/IyBOhQPMw ($1000 in chips)
9N2plUp64x0CQSt1tu6thw will be allowed to play after the button
BbirlZJeYiPjSFVvLtEDVw: posts small blind $5
33XJu1CVnl9YOngoPIhi0A: posts big blind $10
*** HOLE CARDS ***
y9vGciYuJ4+4Z79YDgtBLg: folds
dywrHhCI+xO1Q+U4dfdVaQ: folds
jkH6qYMpn8JA/IyBOhQPMw: folds
BbirlZJeYiPjSFVvLtEDVw: raises $20 to $30
33XJu1CVnl9YOngoPIhi0A: folds
BbirlZJeYiPjSFVvLtEDVw collected $20 from pot
*** SUMMARY ***
Total pot $20 | Rake $0
Seat 2: BbirlZJeYiPjSFVvLtEDVw (small blind) collected ($20)
Seat 3: 33XJu1CVnl9YOngoPIhi0A (big blind) folded before Flop
Seat 4: y9vGciYuJ4+4Z79YDgtBLg folded before Flop (didn't bet)
Seat 5: dywrHhCI+xO1Q+U4dfdVaQ folded before Flop (didn't bet)
Seat 6: jkH6qYMpn8JA/IyBOhQPMw (button) folded before Flop (didn't bet)



PokerStars Game #59956393146:  Hold'em No Limit ($5/$10) - 2009/07/01 9:26:24 ET
Table 'agogFDSQKF+U0NUTbR6ZlA' 6-max Seat #2 is the button
Seat 2: BbirlZJeYiPjSFVvLtEDVw ($1053 in chips)
Seat 3: 33XJu1CVnl9YOngoPIhi0A ($942 in chips)
Seat 4: y9vGciYuJ4+4Z79YDgtBLg ($1059.75 in chips)
Seat 5: dywrHhCI+xO1Q+U4dfdVaQ ($1007 in chips)
Seat 6: jkH6qYMpn8JA/IyBOhQPMw ($1000 in chips)
33XJu1CVnl9YOngoPIhi0A: posts small blind $5
y9vGciYuJ4+4Z79YDgtBLg: posts big blind $10
9N2plUp64x0CQSt1tu6thw: sits out
*** HOLE CARDS ***
dywrHhCI+xO1Q+U4dfdVaQ: folds
jkH6qYMpn8JA/IyBOhQPMw: folds
BbirlZJeYiPjSFVvLtEDVw: folds
33XJu1CVnl9YOngoPIhi0A: calls $5
y9vGciYuJ4+4Z79YDgtBLg: checks
*** FLOP *** [5s Tc Js]
33XJu1CVnl9YOngoPIhi0A: checks
y9vGciYuJ4+4Z79YDgtBLg: checks
*** TURN *** [5s Tc Js] [9c]
33XJu1CVnl9YOngoPIhi0A: checks
y9vGciYuJ4+4Z79YDgtBLg: checks
*** RIVER *** [5s Tc Js 9c] [4h]
33XJu1CVnl9YOngoPIhi0A: checks
y9vGciYuJ4+4Z79YDgtBLg: checks
*** SHOW DOWN ***
33XJu1CVnl9YOngoPIhi0A: shows [Kh Ts] (a pair of Tens)
y9vGciYuJ4+4Z79YDgtBLg: mucks hand
33XJu1CVnl9YOngoPIhi0A collected $19 from pot
*** SUMMARY ***
Total pot $20 | Rake $1
Board [5s Tc Js 9c 4h]
Seat 2: BbirlZJeYiPjSFVvLtEDVw (button) folded before Flop (didn't bet)
Seat 3: 33XJu1CVnl9YOngoPIhi0A (small blind) showed [Kh Ts] and won ($19) with a pair of Tens
Seat 4: y9vGciYuJ4+4Z79YDgtBLg (big blind) mucked
Seat 5: dywrHhCI+xO1Q+U4dfdVaQ folded before Flop (didn't bet)
Seat 6: jkH6qYMpn8JA/IyBOhQPMw folded before Flop (didn't bet)



PokerStars Game #59956394022:  Hold'em No Limit ($5/$10) - 2009/07/01 9:26:25 ET
Table '2a86NK3xhs21kwGZmbj0QA' 6-max Seat #2 is the button
Seat 1: BbirlZJeYiPjSFVvLtEDVw ($1028 in chips)
Seat 2: z/zDzN9GsrGWKD4D635nKA ($1122 in chips)
Seat 3: 7nu3NHCN2s0uUleNuVaGww ($990 in chips)
Seat 4: 33XJu1CVnl9YOngoPIhi0A ($2828 in chips)
Seat 5: AP3ihgkR8SLQyf0O1jly0g ($596 in chips)
Seat 6: 3mTlg4g0FJN2bo939h/0Wg ($764 in chips)
7nu3NHCN2s0uUleNuVaGww: posts small blind $5
33XJu1CVnl9YOngoPIhi0A: posts big blind $10
*** HOLE CARDS ***
AP3ihgkR8SLQyf0O1jly0g: folds
3mTlg4g0FJN2bo939h/0Wg: raises $10 to $20
BbirlZJeYiPjSFVvLtEDVw: folds
z/zDzN9GsrGWKD4D635nKA: calls $20
7nu3NHCN2s0uUleNuVaGww: folds
33XJu1CVnl9YOngoPIhi0A: folds
*** FLOP *** [6d 3d 4d]
3mTlg4g0FJN2bo939h/0Wg: bets $20
z/zDzN9GsrGWKD4D635nKA: calls $20
*** TURN *** [6d 3d 4d] [3h]
3mTlg4g0FJN2bo939h/0Wg: bets $30
z/zDzN9GsrGWKD4D635nKA: calls $30
*** RIVER *** [6d 3d 4d 3h] [6s]
3mTlg4g0FJN2bo939h/0Wg: checks
z/zDzN9GsrGWKD4D635nKA: checks
*** SHOW DOWN ***
3mTlg4g0FJN2bo939h/0Wg: shows [Jd Ts] (two pair, Sixes and Threes)
z/zDzN9GsrGWKD4D635nKA: shows [8h 8s] (two pair, Eights and Sixes)
z/zDzN9GsrGWKD4D635nKA collected $152 from pot
*** SUMMARY ***
Total pot $155 | Rake $3
Board [6d 3d 4d 3h 6s]
Seat 1: BbirlZJeYiPjSFVvLtEDVw folded before Flop (didn't bet)
Seat 2: z/zDzN9GsrGWKD4D635nKA (button) showed [8h 8s] and won ($152) with two pair, Eights and Sixes
Seat 3: 7nu3NHCN2s0uUleNuVaGww (small blind) folded before Flop
Seat 4: 33XJu1CVnl9YOngoPIhi0A (big blind) folded before Flop
Seat 5: AP3ihgkR8SLQyf0O1jly0g folded before Flop (didn't bet)
Seat 6: 3mTlg4g0FJN2bo939h/0Wg showed [Jd Ts] and lost with two pair, Sixes and Threes



PokerStars Game #59956422878:  Hold'em No Limit ($5/$10) - 2009/07/01 9:27:04 ET
Table 'agogFDSQKF+U0NUTbR6ZlA' 6-max Seat #3 is the button
Seat 2: BbirlZJeYiPjSFVvLtEDVw ($1053 in chips)
Seat 3: 33XJu1CVnl9YOngoPIhi0A ($951 in chips)
Seat 4: y9vGciYuJ4+4Z79YDgtBLg ($1049.75 in chips)
Seat 5: dywrHhCI+xO1Q+U4dfdVaQ ($1007 in chips)
Seat 6: jkH6qYMpn8JA/IyBOhQPMw ($1000 in chips)
y9vGciYuJ4+4Z79YDgtBLg: posts small blind $5
dywrHhCI+xO1Q+U4dfdVaQ: posts big blind $10
9N2plUp64x0CQSt1tu6thw: sits out
*** HOLE CARDS ***
jkH6qYMpn8JA/IyBOhQPMw: folds
BbirlZJeYiPjSFVvLtEDVw: folds
33XJu1CVnl9YOngoPIhi0A: folds
y9vGciYuJ4+4Z79YDgtBLg: raises $10 to $20
dywrHhCI+xO1Q+U4dfdVaQ: folds
y9vGciYuJ4+4Z79YDgtBLg collected $20 from pot
*** SUMMARY ***
Total pot $20 | Rake $0
Seat 2: BbirlZJeYiPjSFVvLtEDVw folded before Flop (didn't bet)
Seat 3: 33XJu1CVnl9YOngoPIhi0A (button) folded before Flop (didn't bet)
Seat 4: y9vGciYuJ4+4Z79YDgtBLg (small blind) collected ($20)
Seat 5: dywrHhCI+xO1Q+U4dfdVaQ (big blind) folded before Flop
Seat 6: jkH6qYMpn8JA/IyBOhQPMw folded before Flop (didn't bet)



PokerStars Game #59956438066:  Hold'em No Limit ($5/$10) - 2009/07/01 9:27:24 ET
Table 'agogFDSQKF+U0NUTbR6ZlA' 6-max Seat #4 is the button
Seat 2: BbirlZJeYiPjSFVvLtEDVw ($1053 in chips)
Seat 3: 33XJu1CVnl9YOngoPIhi0A ($951 in chips)
Seat 4: y9vGciYuJ4+4Z79YDgtBLg ($1059.75 in chips)
Seat 5: dywrHhCI+xO1Q+U4dfdVaQ ($1000 in chips)
Seat 6: jkH6qYMpn8JA/IyBOhQPMw ($1000 in chips)
dywrHhCI+xO1Q+U4dfdVaQ: posts small blind $5
jkH6qYMpn8JA/IyBOhQPMw: posts big blind $10
9N2plUp64x0CQSt1tu6thw: sits out
*** HOLE CARDS ***
BbirlZJeYiPjSFVvLtEDVw: raises $20 to $30
33XJu1CVnl9YOngoPIhi0A: folds
y9vGciYuJ4+4Z79YDgtBLg: folds
dywrHhCI+xO1Q+U4dfdVaQ: folds
jkH6qYMpn8JA/IyBOhQPMw: folds
BbirlZJeYiPjSFVvLtEDVw collected $25 from pot
*** SUMMARY ***
Total pot $25 | Rake $0
Seat 2: BbirlZJeYiPjSFVvLtEDVw collected ($25)
Seat 3: 33XJu1CVnl9YOngoPIhi0A folded before Flop (didn't bet)
Seat 4: y9vGciYuJ4+4Z79YDgtBLg (button) folded before Flop (didn't bet)
Seat 5: dywrHhCI+xO1Q+U4dfdVaQ (small blind) folded before Flop
Seat 6: jkH6qYMpn8JA/IyBOhQPMw (big blind) folded before Flop



PokerStars Game #59956446784:  Hold'em No Limit ($5/$10) - 2009/07/01 9:27:36 ET
Table '2a86NK3xhs21kwGZmbj0QA' 6-max Seat #3 is the button
Seat 1: BbirlZJeYiPjSFVvLtEDVw ($1028 in chips)
Seat 2: z/zDzN9GsrGWKD4D635nKA ($1204 in chips)
Seat 3: 7nu3NHCN2s0uUleNuVaGww ($985 in chips)
Seat 4: 33XJu1CVnl9YOngoPIhi0A ($2818 in chips)
Seat 5: AP3ihgkR8SLQyf0O1jly0g ($596.75 in chips)
Seat 6: 3mTlg4g0FJN2bo939h/0Wg ($694 in chips)
33XJu1CVnl9YOngoPIhi0A: posts small blind $5
AP3ihgkR8SLQyf0O1jly0g: posts big blind $10
*** HOLE CARDS ***
3mTlg4g0FJN2bo939h/0Wg: folds
BbirlZJeYiPjSFVvLtEDVw: folds
z/zDzN9GsrGWKD4D635nKA: folds
7nu3NHCN2s0uUleNuVaGww: raises $20 to $30
33XJu1CVnl9YOngoPIhi0A: folds
AP3ihgkR8SLQyf0O1jly0g: calls $20
*** FLOP *** [5d Jh Kc]
AP3ihgkR8SLQyf0O1jly0g: checks
7nu3NHCN2s0uUleNuVaGww: checks
*** TURN *** [5d Jh Kc] [Kh]
AP3ihgkR8SLQyf0O1jly0g: bets $30
7nu3NHCN2s0uUleNuVaGww: folds
AP3ihgkR8SLQyf0O1jly0g collected $62 from pot
AP3ihgkR8SLQyf0O1jly0g: doesn't show hand
*** SUMMARY ***
Total pot $65 | Rake $3
Board [5d Jh Kc Kh]
Seat 1: BbirlZJeYiPjSFVvLtEDVw folded before Flop (didn't bet)
Seat 2: z/zDzN9GsrGWKD4D635nKA folded before Flop (didn't bet)
Seat 3: 7nu3NHCN2s0uUleNuVaGww (button) folded on the Turn
Seat 4: 33XJu1CVnl9YOngoPIhi0A (small blind) folded before Flop
Seat 5: AP3ihgkR8SLQyf0O1jly0g (big blind) collected ($62)
Seat 6: 3mTlg4g0FJN2bo939h/0Wg folded before Flop (didn't bet)



PokerStars Game #59956453600:  Hold'em No Limit ($5/$10) - 2009/07/01 9:27:45 ET
Table 'agogFDSQKF+U0NUTbR6ZlA' 6-max Seat #5 is the button
Seat 1: 9N2plUp64x0CQSt1tu6thw ($200 in chips)
Seat 2: BbirlZJeYiPjSFVvLtEDVw ($1068 in chips)
Seat 3: 33XJu1CVnl9YOngoPIhi0A ($951 in chips)
Seat 4: y9vGciYuJ4+4Z79YDgtBLg ($1059.75 in chips)
Seat 5: dywrHhCI+xO1Q+U4dfdVaQ ($1000 in chips)
Seat 6: jkH6qYMpn8JA/IyBOhQPMw ($1000 in chips)
jkH6qYMpn8JA/IyBOhQPMw: posts small blind $5
9N2plUp64x0CQSt1tu6thw: posts big blind $10
*** HOLE CARDS ***
BbirlZJeYiPjSFVvLtEDVw: folds
33XJu1CVnl9YOngoPIhi0A: folds
y9vGciYuJ4+4Z79YDgtBLg: folds
dywrHhCI+xO1Q+U4dfdVaQ: folds
jkH6qYMpn8JA/IyBOhQPMw: folds
9N2plUp64x0CQSt1tu6thw collected $10 from pot
*** SUMMARY ***
Total pot $10 | Rake $0
Seat 1: 9N2plUp64x0CQSt1tu6thw (big blind) collected ($10)
Seat 2: BbirlZJeYiPjSFVvLtEDVw folded before Flop (didn't bet)
Seat 3: 33XJu1CVnl9YOngoPIhi0A folded before Flop (didn't bet)
Seat 4: y9vGciYuJ4+4Z79YDgtBLg folded before Flop (didn't bet)
Seat 5: dywrHhCI+xO1Q+U4dfdVaQ (button) folded before Flop (didn't bet)
Seat 6: jkH6qYMpn8JA/IyBOhQPMw (small blind) folded before Flop



PokerStars Game #59956465094:  Hold'em No Limit ($5/$10) - 2009/07/01 9:28:01 ET
Table '2a86NK3xhs21kwGZmbj0QA' 6-max Seat #4 is the button
Seat 1: BbirlZJeYiPjSFVvLtEDVw ($1028 in chips)
Seat 2: z/zDzN9GsrGWKD4D635nKA ($1204 in chips)
Seat 3: 7nu3NHCN2s0uUleNuVaGww ($955 in chips)
Seat 4: 33XJu1CVnl9YOngoPIhi0A ($2813 in chips)
Seat 5: AP3ihgkR8SLQyf0O1jly0g ($628.75 in chips)
Seat 6: 3mTlg4g0FJN2bo939h/0Wg ($694 in chips)
AP3ihgkR8SLQyf0O1jly0g: posts small blind $5
3mTlg4g0FJN2bo939h/0Wg: posts big blind $10
*** HOLE CARDS ***
BbirlZJeYiPjSFVvLtEDVw: folds
z/zDzN9GsrGWKD4D635nKA: raises $20 to $30
7nu3NHCN2s0uUleNuVaGww: folds
33XJu1CVnl9YOngoPIhi0A: folds
AP3ihgkR8SLQyf0O1jly0g: folds
3mTlg4g0FJN2bo939h/0Wg: folds
z/zDzN9GsrGWKD4D635nKA collected $25 from pot
z/zDzN9GsrGWKD4D635nKA: doesn't show hand
*** SUMMARY ***
Total pot $25 | Rake $0
Seat 1: BbirlZJeYiPjSFVvLtEDVw folded before Flop (didn't bet)
Seat 2: z/zDzN9GsrGWKD4D635nKA collected ($25)
Seat 3: 7nu3NHCN2s0uUleNuVaGww folded before Flop (didn't bet)
Seat 4: 33XJu1CVnl9YOngoPIhi0A (button) folded before Flop (didn't bet)
Seat 5: AP3ihgkR8SLQyf0O1jly0g (small blind) folded before Flop
Seat 6: 3mTlg4g0FJN2bo939h/0Wg (big blind) folded before Flop



PokerStars Game #59956471428:  Hold'em No Limit ($5/$10) - 2009/07/01 9:28:09 ET
Table 'agogFDSQKF+U0NUTbR6ZlA' 6-max Seat #6 is the button
Seat 1: 9N2plUp64x0CQSt1tu6thw ($205 in chips)
Seat 2: BbirlZJeYiPjSFVvLtEDVw ($1068 in chips)
Seat 3: 33XJu1CVnl9YOngoPIhi0A ($951 in chips)
Seat 4: y9vGciYuJ4+4Z79YDgtBLg ($1059.75 in chips)
Seat 5: dywrHhCI+xO1Q+U4dfdVaQ ($1000 in chips)
Seat 6: jkH6qYMpn8JA/IyBOhQPMw ($1000 in chips)
9N2plUp64x0CQSt1tu6thw: posts small blind $5
BbirlZJeYiPjSFVvLtEDVw: posts big blind $10
*** HOLE CARDS ***
33XJu1CVnl9YOngoPIhi0A: folds
y9vGciYuJ4+4Z79YDgtBLg: folds
dywrHhCI+xO1Q+U4dfdVaQ: folds
jkH6qYMpn8JA/IyBOhQPMw: raises $20 to $30
9N2plUp64x0CQSt1tu6thw: folds
BbirlZJeYiPjSFVvLtEDVw: folds
jkH6qYMpn8JA/IyBOhQPMw collected $25 from pot
*** SUMMARY ***
Total pot $25 | Rake $0
Seat 1: 9N2plUp64x0CQSt1tu6thw (small blind) folded before Flop
Seat 2: BbirlZJeYiPjSFVvLtEDVw (big blind) folded before Flop
Seat 3: 33XJu1CVnl9YOngoPIhi0A folded before Flop (didn't bet)
Seat 4: y9vGciYuJ4+4Z79YDgtBLg folded before Flop (didn't bet)
Seat 5: dywrHhCI+xO1Q+U4dfdVaQ folded before Flop (didn't bet)
Seat 6: jkH6qYMpn8JA/IyBOhQPMw (button) collected ($25)



PokerStars Game #59956475298:  Hold'em No Limit ($5/$10) - 2009/07/01 9:28:15 ET
Table '2a86NK3xhs21kwGZmbj0QA' 6-max Seat #5 is the button
Seat 1: BbirlZJeYiPjSFVvLtEDVw ($1028 in chips)
Seat 2: z/zDzN9GsrGWKD4D635nKA ($1219 in chips)
Seat 3: 7nu3NHCN2s0uUleNuVaGww ($955 in chips)
Seat 4: 33XJu1CVnl9YOngoPIhi0A ($2813 in chips)
Seat 5: AP3ihgkR8SLQyf0O1jly0g ($623.75 in chips)
Seat 6: 3mTlg4g0FJN2bo939h/0Wg ($684 in chips)
3mTlg4g0FJN2bo939h/0Wg: posts small blind $5
BbirlZJeYiPjSFVvLtEDVw: posts big blind $10
*** HOLE CARDS ***
z/zDzN9GsrGWKD4D635nKA: folds
7nu3NHCN2s0uUleNuVaGww: raises $20 to $30
33XJu1CVnl9YOngoPIhi0A: calls $30
AP3ihgkR8SLQyf0O1jly0g: folds
3mTlg4g0FJN2bo939h/0Wg: folds
BbirlZJeYiPjSFVvLtEDVw: calls $20
*** FLOP *** [Th As Tc]
BbirlZJeYiPjSFVvLtEDVw: checks
7nu3NHCN2s0uUleNuVaGww: checks
33XJu1CVnl9YOngoPIhi0A: checks
*** TURN *** [Th As Tc] [Jd]
BbirlZJeYiPjSFVvLtEDVw: checks
7nu3NHCN2s0uUleNuVaGww: checks
33XJu1CVnl9YOngoPIhi0A: checks
*** RIVER *** [Th As Tc Jd] [6h]
BbirlZJeYiPjSFVvLtEDVw: checks
7nu3NHCN2s0uUleNuVaGww: checks
33XJu1CVnl9YOngoPIhi0A: checks
*** SHOW DOWN ***
BbirlZJeYiPjSFVvLtEDVw: shows [4s 4h] (two pair, Tens and Fours)
7nu3NHCN2s0uUleNuVaGww: shows [9h 9d] (two pair, Tens and Nines)
33XJu1CVnl9YOngoPIhi0A: mucks hand
7nu3NHCN2s0uUleNuVaGww collected $92 from pot
*** SUMMARY ***
Total pot $95 | Rake $3
Board [Th As Tc Jd 6h]
Seat 1: BbirlZJeYiPjSFVvLtEDVw (big blind) showed [4s 4h] and lost with two pair, Tens and Fours
Seat 2: z/zDzN9GsrGWKD4D635nKA folded before Flop (didn't bet)
Seat 3: 7nu3NHCN2s0uUleNuVaGww showed [9h 9d] and won ($92) with two pair, Tens and Nines
Seat 4: 33XJu1CVnl9YOngoPIhi0A mucked
Seat 5: AP3ihgkR8SLQyf0O1jly0g (button) folded before Flop (didn't bet)
Seat 6: 3mTlg4g0FJN2bo939h/0Wg (small blind) folded before Flop



PokerStars Game #59956490072:  Hold'em No Limit ($5/$10) - 2009/07/01 9:28:35 ET
Table 'agogFDSQKF+U0NUTbR6ZlA' 6-max Seat #1 is the button
Seat 1: 9N2plUp64x0CQSt1tu6thw ($200 in chips)
Seat 2: BbirlZJeYiPjSFVvLtEDVw ($1058 in chips)
Seat 3: 33XJu1CVnl9YOngoPIhi0A ($951 in chips)
Seat 4: y9vGciYuJ4+4Z79YDgtBLg ($1059.75 in chips)
Seat 5: dywrHhCI+xO1Q+U4dfdVaQ ($1000 in chips)
Seat 6: jkH6qYMpn8JA/IyBOhQPMw ($1015 in chips)
BbirlZJeYiPjSFVvLtEDVw: posts small blind $5
33XJu1CVnl9YOngoPIhi0A: posts big blind $10
*** HOLE CARDS ***
y9vGciYuJ4+4Z79YDgtBLg: folds
y9vGciYuJ4+4Z79YDgtBLg is sitting out
dywrHhCI+xO1Q+U4dfdVaQ: folds
jkH6qYMpn8JA/IyBOhQPMw: folds
9N2plUp64x0CQSt1tu6thw: folds
y9vGciYuJ4+4Z79YDgtBLg leaves the table
BbirlZJeYiPjSFVvLtEDVw: folds
33XJu1CVnl9YOngoPIhi0A collected $10 from pot
*** SUMMARY ***
Total pot $10 | Rake $0
Seat 1: 9N2plUp64x0CQSt1tu6thw (button) folded before Flop (didn't bet)
Seat 2: BbirlZJeYiPjSFVvLtEDVw (small blind) folded before Flop
Seat 3: 33XJu1CVnl9YOngoPIhi0A (big blind) collected ($10)
Seat 4: y9vGciYuJ4+4Z79YDgtBLg folded before Flop (didn't bet)
Seat 5: dywrHhCI+xO1Q+U4dfdVaQ folded before Flop (didn't bet)
Seat 6: jkH6qYMpn8JA/IyBOhQPMw folded before Flop (didn't bet)



PokerStars Game #59956507108:  Hold'em No Limit ($5/$10) - 2009/07/01 9:28:59 ET
Table 'agogFDSQKF+U0NUTbR6ZlA' 6-max Seat #2 is the button
Seat 1: 9N2plUp64x0CQSt1tu6thw ($200 in chips)
Seat 2: BbirlZJeYiPjSFVvLtEDVw ($1053 in chips)
Seat 3: 33XJu1CVnl9YOngoPIhi0A ($956 in chips)
Seat 5: dywrHhCI+xO1Q+U4dfdVaQ ($1000 in chips)
Seat 6: jkH6qYMpn8JA/IyBOhQPMw ($1015 in chips)
33XJu1CVnl9YOngoPIhi0A: posts small blind $5
dywrHhCI+xO1Q+U4dfdVaQ: posts big blind $10
*** HOLE CARDS ***
jkH6qYMpn8JA/IyBOhQPMw: folds
9N2plUp64x0CQSt1tu6thw: raises $10 to $20
BbirlZJeYiPjSFVvLtEDVw: folds
33XJu1CVnl9YOngoPIhi0A: folds
dywrHhCI+xO1Q+U4dfdVaQ: folds
9N2plUp64x0CQSt1tu6thw collected $25 from pot
*** SUMMARY ***
Total pot $25 | Rake $0
Seat 1: 9N2plUp64x0CQSt1tu6thw collected ($25)
Seat 2: BbirlZJeYiPjSFVvLtEDVw (button) folded before Flop (didn't bet)
Seat 3: 33XJu1CVnl9YOngoPIhi0A (small blind) folded before Flop
Seat 5: dywrHhCI+xO1Q+U4dfdVaQ (big blind) folded before Flop
Seat 6: jkH6qYMpn8JA/IyBOhQPMw folded before Flop (didn't bet)



PokerStars Game #59956520998:  Hold'em No Limit ($5/$10) - 2009/07/01 9:29:18 ET
Table 'agogFDSQKF+U0NUTbR6ZlA' 6-max Seat #3 is the button
Seat 1: 9N2plUp64x0CQSt1tu6thw ($215 in chips)
Seat 2: BbirlZJeYiPjSFVvLtEDVw ($1053 in chips)
Seat 3: 33XJu1CVnl9YOngoPIhi0A ($951 in chips)
Seat 5: dywrHhCI+xO1Q+U4dfdVaQ ($1000 in chips)
Seat 6: jkH6qYMpn8JA/IyBOhQPMw ($1015 in chips)
dywrHhCI+xO1Q+U4dfdVaQ: posts small blind $5
jkH6qYMpn8JA/IyBOhQPMw: posts big blind $10
*** HOLE CARDS ***
9N2plUp64x0CQSt1tu6thw: folds
BbirlZJeYiPjSFVvLtEDVw: folds
33XJu1CVnl9YOngoPIhi0A: folds
dywrHhCI+xO1Q+U4dfdVaQ: folds
jkH6qYMpn8JA/IyBOhQPMw collected $10 from pot
*** SUMMARY ***
Total pot $10 | Rake $0
Seat 1: 9N2plUp64x0CQSt1tu6thw folded before Flop (didn't bet)
Seat 2: BbirlZJeYiPjSFVvLtEDVw folded before Flop (didn't bet)
Seat 3: 33XJu1CVnl9YOngoPIhi0A (button) folded before Flop (didn't bet)
Seat 5: dywrHhCI+xO1Q+U4dfdVaQ (small blind) folded before Flop
Seat 6: jkH6qYMpn8JA/IyBOhQPMw (big blind) collected ($10)



PokerStars Game #59956526836:  Hold'em No Limit ($5/$10) - 2009/07/01 9:29:27 ET
Table '2a86NK3xhs21kwGZmbj0QA' 6-max Seat #6 is the button
Seat 1: BbirlZJeYiPjSFVvLtEDVw ($1000 in chips)
Seat 2: z/zDzN9GsrGWKD4D635nKA ($1219 in chips)
Seat 3: 7nu3NHCN2s0uUleNuVaGww ($1017 in chips)
Seat 4: 33XJu1CVnl9YOngoPIhi0A ($2783 in chips)
Seat 5: AP3ihgkR8SLQyf0O1jly0g ($623.75 in chips)
Seat 6: 3mTlg4g0FJN2bo939h/0Wg ($679 in chips)
BbirlZJeYiPjSFVvLtEDVw: posts small blind $5
z/zDzN9GsrGWKD4D635nKA: posts big blind $10
*** HOLE CARDS ***
7nu3NHCN2s0uUleNuVaGww: folds
33XJu1CVnl9YOngoPIhi0A: raises $20 to $30
AP3ihgkR8SLQyf0O1jly0g: folds
3mTlg4g0FJN2bo939h/0Wg: folds
BbirlZJeYiPjSFVvLtEDVw: folds
z/zDzN9GsrGWKD4D635nKA: folds
33XJu1CVnl9YOngoPIhi0A collected $25 from pot
33XJu1CVnl9YOngoPIhi0A: doesn't show hand
*** SUMMARY ***
Total pot $25 | Rake $0
Seat 1: BbirlZJeYiPjSFVvLtEDVw (small blind) folded before Flop
Seat 2: z/zDzN9GsrGWKD4D635nKA (big blind) folded before Flop
Seat 3: 7nu3NHCN2s0uUleNuVaGww folded before Flop (didn't bet)
Seat 4: 33XJu1CVnl9YOngoPIhi0A collected ($25)
Seat 5: AP3ihgkR8SLQyf0O1jly0g folded before Flop (didn't bet)
Seat 6: 3mTlg4g0FJN2bo939h/0Wg (button) folded before Flop (didn't bet)



PokerStars Game #59956539328:  Hold'em No Limit ($5/$10) - 2009/07/01 9:29:44 ET
Table '2a86NK3xhs21kwGZmbj0QA' 6-max Seat #1 is the button
Seat 1: BbirlZJeYiPjSFVvLtEDVw ($1000 in chips)
Seat 2: z/zDzN9GsrGWKD4D635nKA ($1209 in chips)
Seat 3: 7nu3NHCN2s0uUleNuVaGww ($1017 in chips)
Seat 4: 33XJu1CVnl9YOngoPIhi0A ($2798 in chips)
Seat 5: AP3ihgkR8SLQyf0O1jly0g ($623.75 in chips)
Seat 6: 3mTlg4g0FJN2bo939h/0Wg ($679 in chips)
z/zDzN9GsrGWKD4D635nKA: posts small blind $5
7nu3NHCN2s0uUleNuVaGww: posts big blind $10
*** HOLE CARDS ***
33XJu1CVnl9YOngoPIhi0A: folds
AP3ihgkR8SLQyf0O1jly0g: raises $20 to $30
3mTlg4g0FJN2bo939h/0Wg: folds
BbirlZJeYiPjSFVvLtEDVw: raises $80 to $110
z/zDzN9GsrGWKD4D635nKA: raises $160 to $270
7nu3NHCN2s0uUleNuVaGww: folds
AP3ihgkR8SLQyf0O1jly0g: folds
BbirlZJeYiPjSFVvLtEDVw: folds
AP3ihgkR8SLQyf0O1jly0g said, "qq"
z/zDzN9GsrGWKD4D635nKA collected $260 from pot
*** SUMMARY ***
Total pot $260 | Rake $0
Seat 1: BbirlZJeYiPjSFVvLtEDVw (button) folded before Flop
Seat 2: z/zDzN9GsrGWKD4D635nKA (small blind) collected ($260)
Seat 3: 7nu3NHCN2s0uUleNuVaGww (big blind) folded before Flop
Seat 4: 33XJu1CVnl9YOngoPIhi0A folded before Flop (didn't bet)
Seat 5: AP3ihgkR8SLQyf0O1jly0g folded before Flop
Seat 6: 3mTlg4g0FJN2bo939h/0Wg folded before Flop (didn't bet)



PokerStars Game #59956540714:  Hold'em No Limit ($5/$10) - 2009/07/01 9:29:46 ET
Table 'agogFDSQKF+U0NUTbR6ZlA' 6-max Seat #5 is the button
Seat 1: 9N2plUp64x0CQSt1tu6thw ($215 in chips)
Seat 2: BbirlZJeYiPjSFVvLtEDVw ($1053 in chips)
Seat 3: 33XJu1CVnl9YOngoPIhi0A ($951 in chips)
Seat 5: dywrHhCI+xO1Q+U4dfdVaQ ($1000 in chips)
Seat 6: jkH6qYMpn8JA/IyBOhQPMw ($1020 in chips)
jkH6qYMpn8JA/IyBOhQPMw: posts small blind $5
9N2plUp64x0CQSt1tu6thw: posts big blind $10
*** HOLE CARDS ***
BbirlZJeYiPjSFVvLtEDVw: folds
33XJu1CVnl9YOngoPIhi0A: folds
dywrHhCI+xO1Q+U4dfdVaQ: folds
jkH6qYMpn8JA/IyBOhQPMw: folds
9N2plUp64x0CQSt1tu6thw collected $10 from pot
*** SUMMARY ***
Total pot $10 | Rake $0
Seat 1: 9N2plUp64x0CQSt1tu6thw (big blind) collected ($10)
Seat 2: BbirlZJeYiPjSFVvLtEDVw folded before Flop (didn't bet)
Seat 3: 33XJu1CVnl9YOngoPIhi0A folded before Flop (didn't bet)
Seat 5: dywrHhCI+xO1Q+U4dfdVaQ (button) folded before Flop (didn't bet)
Seat 6: jkH6qYMpn8JA/IyBOhQPMw (small blind) folded before Flop



PokerStars Game #59956561202:  Hold'em No Limit ($5/$10) - 2009/07/01 9:30:15 ET
Table 'agogFDSQKF+U0NUTbR6ZlA' 6-max Seat #6 is the button
Seat 1: 9N2plUp64x0CQSt1tu6thw ($220 in chips)
Seat 2: BbirlZJeYiPjSFVvLtEDVw ($1053 in chips)
Seat 3: 33XJu1CVnl9YOngoPIhi0A ($951 in chips)
Seat 5: dywrHhCI+xO1Q+U4dfdVaQ ($1000 in chips)
Seat 6: jkH6qYMpn8JA/IyBOhQPMw ($1015 in chips)
9N2plUp64x0CQSt1tu6thw: posts small blind $5
BbirlZJeYiPjSFVvLtEDVw: posts big blind $10
*** HOLE CARDS ***
33XJu1CVnl9YOngoPIhi0A: folds
33XJu1CVnl9YOngoPIhi0A leaves the table
dywrHhCI+xO1Q+U4dfdVaQ: folds
jkH6qYMpn8JA/IyBOhQPMw: folds
9N2plUp64x0CQSt1tu6thw: folds
BbirlZJeYiPjSFVvLtEDVw collected $10 from pot
*** SUMMARY ***
Total pot $10 | Rake $0
Seat 1: 9N2plUp64x0CQSt1tu6thw (small blind) folded before Flop
Seat 2: BbirlZJeYiPjSFVvLtEDVw (big blind) collected ($10)
Seat 3: 33XJu1CVnl9YOngoPIhi0A folded before Flop (didn't bet)
Seat 5: dywrHhCI+xO1Q+U4dfdVaQ folded before Flop (didn't bet)
Seat 6: jkH6qYMpn8JA/IyBOhQPMw (button) folded before Flop (didn't bet)



PokerStars Game #59956569082:  Hold'em No Limit ($5/$10) - 2009/07/01 9:30:26 ET
Table '2a86NK3xhs21kwGZmbj0QA' 6-max Seat #2 is the button
Seat 1: BbirlZJeYiPjSFVvLtEDVw ($1000 in chips)
Seat 2: z/zDzN9GsrGWKD4D635nKA ($1359 in chips)
Seat 3: 7nu3NHCN2s0uUleNuVaGww ($1007 in chips)
Seat 4: 33XJu1CVnl9YOngoPIhi0A ($2798 in chips)
Seat 5: AP3ihgkR8SLQyf0O1jly0g ($593.75 in chips)
Seat 6: 3mTlg4g0FJN2bo939h/0Wg ($679 in chips)
7nu3NHCN2s0uUleNuVaGww: posts small blind $5
AP3ihgkR8SLQyf0O1jly0g said, "fold"
33XJu1CVnl9YOngoPIhi0A: posts big blind $10
*** HOLE CARDS ***
AP3ihgkR8SLQyf0O1jly0g: folds
3mTlg4g0FJN2bo939h/0Wg: raises $10 to $20
BbirlZJeYiPjSFVvLtEDVw: raises $60 to $80
z/zDzN9GsrGWKD4D635nKA: folds
7nu3NHCN2s0uUleNuVaGww: folds
AP3ihgkR8SLQyf0O1jly0g said, "what did you have?"
33XJu1CVnl9YOngoPIhi0A: folds
3mTlg4g0FJN2bo939h/0Wg: folds
BbirlZJeYiPjSFVvLtEDVw collected $55 from pot
BbirlZJeYiPjSFVvLtEDVw: doesn't show hand
*** SUMMARY ***
Total pot $55 | Rake $0
Seat 1: BbirlZJeYiPjSFVvLtEDVw collected ($55)
Seat 2: z/zDzN9GsrGWKD4D635nKA (button) folded before Flop (didn't bet)
Seat 3: 7nu3NHCN2s0uUleNuVaGww (small blind) folded before Flop
Seat 4: 33XJu1CVnl9YOngoPIhi0A (big blind) folded before Flop
Seat 5: AP3ihgkR8SLQyf0O1jly0g folded before Flop (didn't bet)
Seat 6: 3mTlg4g0FJN2bo939h/0Wg folded before Flop



PokerStars Game #59956577672:  Hold'em No Limit ($5/$10) - 2009/07/01 9:30:38 ET
Table 'agogFDSQKF+U0NUTbR6ZlA' 6-max Seat #1 is the button
Seat 1: 9N2plUp64x0CQSt1tu6thw ($215 in chips)
Seat 2: BbirlZJeYiPjSFVvLtEDVw ($1058 in chips)
Seat 5: dywrHhCI+xO1Q+U4dfdVaQ ($1000 in chips)
Seat 6: jkH6qYMpn8JA/IyBOhQPMw ($1015 in chips)
BbirlZJeYiPjSFVvLtEDVw: posts small blind $5
dywrHhCI+xO1Q+U4dfdVaQ: posts big blind $10
*** HOLE CARDS ***
jkH6qYMpn8JA/IyBOhQPMw: folds
9N2plUp64x0CQSt1tu6thw: folds
BbirlZJeYiPjSFVvLtEDVw: raises $20 to $30
dywrHhCI+xO1Q+U4dfdVaQ: calls $20
*** FLOP *** [9c Qh 5c]
BbirlZJeYiPjSFVvLtEDVw: checks
dywrHhCI+xO1Q+U4dfdVaQ: bets $45
BbirlZJeYiPjSFVvLtEDVw: calls $45
*** TURN *** [9c Qh 5c] [Js]
BbirlZJeYiPjSFVvLtEDVw: checks
dywrHhCI+xO1Q+U4dfdVaQ: bets $115
BbirlZJeYiPjSFVvLtEDVw: folds
dywrHhCI+xO1Q+U4dfdVaQ collected $148 from pot
*** SUMMARY ***
Total pot $150 | Rake $2
Board [9c Qh 5c Js]
Seat 1: 9N2plUp64x0CQSt1tu6thw (button) folded before Flop (didn't bet)
Seat 2: BbirlZJeYiPjSFVvLtEDVw (small blind) folded on the Turn
Seat 5: dywrHhCI+xO1Q+U4dfdVaQ (big blind) collected ($148)
Seat 6: jkH6qYMpn8JA/IyBOhQPMw folded before Flop (didn't bet)



PokerStars Game #59956581702:  Hold'em No Limit ($5/$10) - 2009/07/01 9:30:44 ET
Table '2a86NK3xhs21kwGZmbj0QA' 6-max Seat #3 is the button
Seat 1: BbirlZJeYiPjSFVvLtEDVw ($1035 in chips)
Seat 2: z/zDzN9GsrGWKD4D635nKA ($1359 in chips)
Seat 3: 7nu3NHCN2s0uUleNuVaGww ($1002 in chips)
Seat 4: 33XJu1CVnl9YOngoPIhi0A ($2788 in chips)
Seat 5: AP3ihgkR8SLQyf0O1jly0g ($593.75 in chips)
Seat 6: 3mTlg4g0FJN2bo939h/0Wg ($659 in chips)
33XJu1CVnl9YOngoPIhi0A: posts small blind $5
AP3ihgkR8SLQyf0O1jly0g: posts big blind $10
*** HOLE CARDS ***
AP3ihgkR8SLQyf0O1jly0g said, "Azor"
3mTlg4g0FJN2bo939h/0Wg: folds
BbirlZJeYiPjSFVvLtEDVw: folds
z/zDzN9GsrGWKD4D635nKA: raises $20 to $30
7nu3NHCN2s0uUleNuVaGww: folds
33XJu1CVnl9YOngoPIhi0A: folds
AP3ihgkR8SLQyf0O1jly0g: calls $20
*** FLOP *** [7h 6d Ac]
AP3ihgkR8SLQyf0O1jly0g: bets $45
z/zDzN9GsrGWKD4D635nKA: calls $45
*** TURN *** [7h 6d Ac] [Ts]
AP3ihgkR8SLQyf0O1jly0g: bets $95
z/zDzN9GsrGWKD4D635nKA: calls $95
*** RIVER *** [7h 6d Ac Ts] [3s]
AP3ihgkR8SLQyf0O1jly0g: bets $175
z/zDzN9GsrGWKD4D635nKA: folds
AP3ihgkR8SLQyf0O1jly0g collected $342 from pot
AP3ihgkR8SLQyf0O1jly0g: doesn't show hand
*** SUMMARY ***
Total pot $345 | Rake $3
Board [7h 6d Ac Ts 3s]
Seat 1: BbirlZJeYiPjSFVvLtEDVw folded before Flop (didn't bet)
Seat 2: z/zDzN9GsrGWKD4D635nKA folded on the River
Seat 3: 7nu3NHCN2s0uUleNuVaGww (button) folded before Flop (didn't bet)
Seat 4: 33XJu1CVnl9YOngoPIhi0A (small blind) folded before Flop
Seat 5: AP3ihgkR8SLQyf0O1jly0g (big blind) collected ($342)
Seat 6: 3mTlg4g0FJN2bo939h/0Wg folded before Flop (didn't bet)



PokerStars Game #59956666596:  Hold'em No Limit ($5/$10) - 2009/07/01 9:32:44 ET
Table '2a86NK3xhs21kwGZmbj0QA' 6-max Seat #4 is the button
Seat 1: BbirlZJeYiPjSFVvLtEDVw ($1035 in chips)
Seat 2: z/zDzN9GsrGWKD4D635nKA ($1189 in chips)
Seat 3: 7nu3NHCN2s0uUleNuVaGww ($1002 in chips)
Seat 4: 33XJu1CVnl9YOngoPIhi0A ($2783 in chips)
Seat 5: AP3ihgkR8SLQyf0O1jly0g ($765.75 in chips)
Seat 6: 3mTlg4g0FJN2bo939h/0Wg ($659 in chips)
AP3ihgkR8SLQyf0O1jly0g: posts small blind $5
3mTlg4g0FJN2bo939h/0Wg: posts big blind $10
*** HOLE CARDS ***
BbirlZJeYiPjSFVvLtEDVw: raises $20 to $30
z/zDzN9GsrGWKD4D635nKA: folds
7nu3NHCN2s0uUleNuVaGww: calls $30
33XJu1CVnl9YOngoPIhi0A: folds
AP3ihgkR8SLQyf0O1jly0g: folds
3mTlg4g0FJN2bo939h/0Wg: folds
*** FLOP *** [8c Tc 6h]
BbirlZJeYiPjSFVvLtEDVw: checks
7nu3NHCN2s0uUleNuVaGww: checks
*** TURN *** [8c Tc 6h] [Ad]
BbirlZJeYiPjSFVvLtEDVw: checks
7nu3NHCN2s0uUleNuVaGww: checks
*** RIVER *** [8c Tc 6h Ad] [6d]
BbirlZJeYiPjSFVvLtEDVw: checks
7nu3NHCN2s0uUleNuVaGww: bets $50
BbirlZJeYiPjSFVvLtEDVw: folds
7nu3NHCN2s0uUleNuVaGww collected $72 from pot
*** SUMMARY ***
Total pot $75 | Rake $3
Board [8c Tc 6h Ad 6d]
Seat 1: BbirlZJeYiPjSFVvLtEDVw folded on the River
Seat 2: z/zDzN9GsrGWKD4D635nKA folded before Flop (didn't bet)
Seat 3: 7nu3NHCN2s0uUleNuVaGww collected ($72)
Seat 4: 33XJu1CVnl9YOngoPIhi0A (button) folded before Flop (didn't bet)
Seat 5: AP3ihgkR8SLQyf0O1jly0g (small blind) folded before Flop
Seat 6: 3mTlg4g0FJN2bo939h/0Wg (big blind) folded before Flop



PokerStars Game #59956704460:  Hold'em No Limit ($5/$10) - 2009/07/01 9:33:38 ET
Table '2a86NK3xhs21kwGZmbj0QA' 6-max Seat #5 is the button
Seat 1: BbirlZJeYiPjSFVvLtEDVw ($1005 in chips)
Seat 2: z/zDzN9GsrGWKD4D635nKA ($1189 in chips)
Seat 3: 7nu3NHCN2s0uUleNuVaGww ($1044 in chips)
Seat 4: 33XJu1CVnl9YOngoPIhi0A ($2783 in chips)
Seat 5: AP3ihgkR8SLQyf0O1jly0g ($760.75 in chips)
Seat 6: 3mTlg4g0FJN2bo939h/0Wg ($649 in chips)
3mTlg4g0FJN2bo939h/0Wg: posts small blind $5
BbirlZJeYiPjSFVvLtEDVw: posts big blind $10
*** HOLE CARDS ***
z/zDzN9GsrGWKD4D635nKA: folds
7nu3NHCN2s0uUleNuVaGww: folds
33XJu1CVnl9YOngoPIhi0A: folds
AP3ihgkR8SLQyf0O1jly0g: folds
3mTlg4g0FJN2bo939h/0Wg: raises $20 to $30
BbirlZJeYiPjSFVvLtEDVw: folds
3mTlg4g0FJN2bo939h/0Wg collected $20 from pot
*** SUMMARY ***
Total pot $20 | Rake $0
Seat 1: BbirlZJeYiPjSFVvLtEDVw (big blind) folded before Flop
Seat 2: z/zDzN9GsrGWKD4D635nKA folded before Flop (didn't bet)
Seat 3: 7nu3NHCN2s0uUleNuVaGww folded before Flop (didn't bet)
Seat 4: 33XJu1CVnl9YOngoPIhi0A folded before Flop (didn't bet)
Seat 5: AP3ihgkR8SLQyf0O1jly0g (button) folded before Flop (didn't bet)
Seat 6: 3mTlg4g0FJN2bo939h/0Wg (small blind) collected ($20)



PokerStars Game #59956716812:  Hold'em No Limit ($5/$10) - 2009/07/01 9:33:55 ET
Table '2a86NK3xhs21kwGZmbj0QA' 6-max Seat #6 is the button
Seat 1: BbirlZJeYiPjSFVvLtEDVw ($1000 in chips)
Seat 2: z/zDzN9GsrGWKD4D635nKA ($1189 in chips)
Seat 3: 7nu3NHCN2s0uUleNuVaGww ($1044 in chips)
Seat 4: 33XJu1CVnl9YOngoPIhi0A ($2783 in chips)
Seat 5: AP3ihgkR8SLQyf0O1jly0g ($760.75 in chips)
Seat 6: 3mTlg4g0FJN2bo939h/0Wg ($659 in chips)
BbirlZJeYiPjSFVvLtEDVw: posts small blind $5
z/zDzN9GsrGWKD4D635nKA: posts big blind $10
*** HOLE CARDS ***
7nu3NHCN2s0uUleNuVaGww: folds
33XJu1CVnl9YOngoPIhi0A: folds
AP3ihgkR8SLQyf0O1jly0g: folds
3mTlg4g0FJN2bo939h/0Wg: folds
AP3ihgkR8SLQyf0O1jly0g leaves the table
BbirlZJeYiPjSFVvLtEDVw: raises $20 to $30
z/zDzN9GsrGWKD4D635nKA: folds
BbirlZJeYiPjSFVvLtEDVw collected $20 from pot
BbirlZJeYiPjSFVvLtEDVw: doesn't show hand
*** SUMMARY ***
Total pot $20 | Rake $0
Seat 1: BbirlZJeYiPjSFVvLtEDVw (small blind) collected ($20)
Seat 2: z/zDzN9GsrGWKD4D635nKA (big blind) folded before Flop
Seat 3: 7nu3NHCN2s0uUleNuVaGww folded before Flop (didn't bet)
Seat 4: 33XJu1CVnl9YOngoPIhi0A folded before Flop (didn't bet)
Seat 5: AP3ihgkR8SLQyf0O1jly0g folded before Flop (didn't bet)
Seat 6: 3mTlg4g0FJN2bo939h/0Wg (button) folded before Flop (didn't bet)



PokerStars Game #59956728516:  Hold'em No Limit ($5/$10) - 2009/07/01 9:34:12 ET
Table '2a86NK3xhs21kwGZmbj0QA' 6-max Seat #1 is the button
Seat 1: BbirlZJeYiPjSFVvLtEDVw ($1010 in chips)
Seat 2: z/zDzN9GsrGWKD4D635nKA ($1179 in chips)
Seat 3: 7nu3NHCN2s0uUleNuVaGww ($1044 in chips)
Seat 4: 33XJu1CVnl9YOngoPIhi0A ($2783 in chips)
Seat 6: 3mTlg4g0FJN2bo939h/0Wg ($659 in chips)
z/zDzN9GsrGWKD4D635nKA: posts small blind $5
7nu3NHCN2s0uUleNuVaGww: posts big blind $10
*** HOLE CARDS ***
33XJu1CVnl9YOngoPIhi0A: folds
3mTlg4g0FJN2bo939h/0Wg: folds
33XJu1CVnl9YOngoPIhi0A leaves the table
BbirlZJeYiPjSFVvLtEDVw: raises $20 to $30
z/zDzN9GsrGWKD4D635nKA: folds
7nu3NHCN2s0uUleNuVaGww: raises $70 to $100
jkH6qYMpn8JA/IyBOhQPMw joins the table at seat #5
BbirlZJeYiPjSFVvLtEDVw: calls $70
*** FLOP *** [Jd Kd Tc]
9N2plUp64x0CQSt1tu6thw joins the table at seat #4
7nu3NHCN2s0uUleNuVaGww: checks
BbirlZJeYiPjSFVvLtEDVw: checks
*** TURN *** [Jd Kd Tc] [4c]
7nu3NHCN2s0uUleNuVaGww: bets $120
BbirlZJeYiPjSFVvLtEDVw: calls $120
*** RIVER *** [Jd Kd Tc 4c] [Qd]
7nu3NHCN2s0uUleNuVaGww: checks
BbirlZJeYiPjSFVvLtEDVw: bets $220
7nu3NHCN2s0uUleNuVaGww: calls $220
*** SHOW DOWN ***
BbirlZJeYiPjSFVvLtEDVw: shows [7c 6c] (high card King)
7nu3NHCN2s0uUleNuVaGww: shows [Js 9s] (a straight, Nine to King)
7nu3NHCN2s0uUleNuVaGww collected $883 from pot
*** SUMMARY ***
Total pot $885 | Rake $2
Board [Jd Kd Tc 4c Qd]
Seat 1: BbirlZJeYiPjSFVvLtEDVw (button) showed [7c 6c] and lost with high card King
Seat 2: z/zDzN9GsrGWKD4D635nKA (small blind) folded before Flop
Seat 3: 7nu3NHCN2s0uUleNuVaGww (big blind) showed [Js 9s] and won ($883) with a straight, Nine to King
Seat 4: 33XJu1CVnl9YOngoPIhi0A folded before Flop (didn't bet)
Seat 6: 3mTlg4g0FJN2bo939h/0Wg folded before Flop (didn't bet)



PokerStars Game #59956781220:  Hold'em No Limit ($5/$10) - 2009/07/01 9:35:27 ET
Table '2a86NK3xhs21kwGZmbj0QA' 6-max Seat #2 is the button
Seat 1: BbirlZJeYiPjSFVvLtEDVw ($1000 in chips)
Seat 2: z/zDzN9GsrGWKD4D635nKA ($1174 in chips)
Seat 3: 7nu3NHCN2s0uUleNuVaGww ($1487 in chips)
Seat 4: 9N2plUp64x0CQSt1tu6thw ($200 in chips)
Seat 6: 3mTlg4g0FJN2bo939h/0Wg ($659 in chips)
7nu3NHCN2s0uUleNuVaGww: posts small blind $5
9N2plUp64x0CQSt1tu6thw: posts big blind $10
jkH6qYMpn8JA/IyBOhQPMw: sits out
*** HOLE CARDS ***
3mTlg4g0FJN2bo939h/0Wg: raises $20 to $30
BbirlZJeYiPjSFVvLtEDVw: calls $30
z/zDzN9GsrGWKD4D635nKA: folds
7nu3NHCN2s0uUleNuVaGww: calls $25
9N2plUp64x0CQSt1tu6thw: folds
*** FLOP *** [5c 6s Ks]
7nu3NHCN2s0uUleNuVaGww: checks
3mTlg4g0FJN2bo939h/0Wg: bets $40
BbirlZJeYiPjSFVvLtEDVw: calls $40
7nu3NHCN2s0uUleNuVaGww: folds
*** TURN *** [5c 6s Ks] [7c]
3mTlg4g0FJN2bo939h/0Wg: checks
BbirlZJeYiPjSFVvLtEDVw: bets $130
3mTlg4g0FJN2bo939h/0Wg: calls $130
*** RIVER *** [5c 6s Ks 7c] [2d]
3mTlg4g0FJN2bo939h/0Wg: checks
BbirlZJeYiPjSFVvLtEDVw: checks
*** SHOW DOWN ***
3mTlg4g0FJN2bo939h/0Wg: shows [8c 8d] (a pair of Eights)
BbirlZJeYiPjSFVvLtEDVw: mucks hand
3mTlg4g0FJN2bo939h/0Wg collected $438 from pot
*** SUMMARY ***
Total pot $440 | Rake $2
Board [5c 6s Ks 7c 2d]
Seat 1: BbirlZJeYiPjSFVvLtEDVw mucked
Seat 2: z/zDzN9GsrGWKD4D635nKA (button) folded before Flop (didn't bet)
Seat 3: 7nu3NHCN2s0uUleNuVaGww (small blind) folded on the Flop
Seat 4: 9N2plUp64x0CQSt1tu6thw (big blind) folded before Flop
Seat 6: 3mTlg4g0FJN2bo939h/0Wg showed [8c 8d] and won ($438) with a pair of Eights



PokerStars Game #59956845516:  Hold'em No Limit ($5/$10) - 2009/07/01 9:36:58 ET
Table '2a86NK3xhs21kwGZmbj0QA' 6-max Seat #3 is the button
Seat 1: BbirlZJeYiPjSFVvLtEDVw ($1000 in chips)
Seat 2: z/zDzN9GsrGWKD4D635nKA ($1174 in chips)
Seat 3: 7nu3NHCN2s0uUleNuVaGww ($1457 in chips)
Seat 4: 9N2plUp64x0CQSt1tu6thw ($190 in chips)
Seat 5: jkH6qYMpn8JA/IyBOhQPMw ($1000 in chips)
Seat 6: 3mTlg4g0FJN2bo939h/0Wg ($897 in chips)
9N2plUp64x0CQSt1tu6thw: posts small blind $5
jkH6qYMpn8JA/IyBOhQPMw: posts big blind $10
*** HOLE CARDS ***
3mTlg4g0FJN2bo939h/0Wg: raises $10 to $20
BbirlZJeYiPjSFVvLtEDVw: folds
z/zDzN9GsrGWKD4D635nKA: folds
7nu3NHCN2s0uUleNuVaGww: folds
9N2plUp64x0CQSt1tu6thw: folds
jkH6qYMpn8JA/IyBOhQPMw: folds
3mTlg4g0FJN2bo939h/0Wg collected $25 from pot
*** SUMMARY ***
Total pot $25 | Rake $0
Seat 1: BbirlZJeYiPjSFVvLtEDVw folded before Flop (didn't bet)
Seat 2: z/zDzN9GsrGWKD4D635nKA folded before Flop (didn't bet)
Seat 3: 7nu3NHCN2s0uUleNuVaGww (button) folded before Flop (didn't bet)
Seat 4: 9N2plUp64x0CQSt1tu6thw (small blind) folded before Flop
Seat 5: jkH6qYMpn8JA/IyBOhQPMw (big blind) folded before Flop
Seat 6: 3mTlg4g0FJN2bo939h/0Wg collected ($25)



PokerStars Game #59956874044:  Hold'em No Limit ($5/$10) - 2009/07/01 9:37:39 ET
Table '2a86NK3xhs21kwGZmbj0QA' 6-max Seat #4 is the button
Seat 1: BbirlZJeYiPjSFVvLtEDVw ($1000 in chips)
Seat 2: z/zDzN9GsrGWKD4D635nKA ($1174 in chips)
Seat 3: 7nu3NHCN2s0uUleNuVaGww ($1457 in chips)
Seat 4: 9N2plUp64x0CQSt1tu6thw ($185 in chips)
Seat 5: jkH6qYMpn8JA/IyBOhQPMw ($1000 in chips)
jkH6qYMpn8JA/IyBOhQPMw: posts small blind $5
3mTlg4g0FJN2bo939h/0Wg: is sitting out
BbirlZJeYiPjSFVvLtEDVw: posts big blind $10
*** HOLE CARDS ***
z/zDzN9GsrGWKD4D635nKA: raises $20 to $30
3mTlg4g0FJN2bo939h/0Wg leaves the table
7nu3NHCN2s0uUleNuVaGww: folds
9N2plUp64x0CQSt1tu6thw: folds
jkH6qYMpn8JA/IyBOhQPMw: folds
BbirlZJeYiPjSFVvLtEDVw: folds
z/zDzN9GsrGWKD4D635nKA collected $25 from pot
z/zDzN9GsrGWKD4D635nKA: doesn't show hand
*** SUMMARY ***
Total pot $25 | Rake $0
Seat 1: BbirlZJeYiPjSFVvLtEDVw (big blind) folded before Flop
Seat 2: z/zDzN9GsrGWKD4D635nKA collected ($25)
Seat 3: 7nu3NHCN2s0uUleNuVaGww folded before Flop (didn't bet)
Seat 4: 9N2plUp64x0CQSt1tu6thw (button) folded before Flop (didn't bet)
Seat 5: jkH6qYMpn8JA/IyBOhQPMw (small blind) folded before Flop



PokerStars Game #59957536970:  Hold'em No Limit ($5/$10) - 2009/07/01 9:53:19 ET
Table '2a86NK3xhs21kwGZmbj0QA' 6-max Seat #6 is the button
Seat 1: NczJqEIUdrpEc5Nbd7h1Ig ($469 in chips)
Seat 2: Xl+I49lxCJwPGRuegiaHoA ($1000 in chips)
Seat 3: 7SUIdtQak1SCtldWHjwnFA ($443 in chips)
Seat 5: jkH6qYMpn8JA/IyBOhQPMw ($1228 in chips)
Seat 6: ovpz8iX9p4XQ/6AFQrnDTw ($360.30 in chips)
NczJqEIUdrpEc5Nbd7h1Ig: posts small blind $5
Xl+I49lxCJwPGRuegiaHoA: posts big blind $10
*** HOLE CARDS ***
7SUIdtQak1SCtldWHjwnFA: folds
7SUIdtQak1SCtldWHjwnFA is sitting out
jkH6qYMpn8JA/IyBOhQPMw: folds
ovpz8iX9p4XQ/6AFQrnDTw: raises $20 to $30
NczJqEIUdrpEc5Nbd7h1Ig: calls $25
Xl+I49lxCJwPGRuegiaHoA: folds
*** FLOP *** [As Jd 7s]
NczJqEIUdrpEc5Nbd7h1Ig: checks
ovpz8iX9p4XQ/6AFQrnDTw: bets $40
NczJqEIUdrpEc5Nbd7h1Ig: calls $40
*** TURN *** [As Jd 7s] [Ks]
NczJqEIUdrpEc5Nbd7h1Ig: checks
ovpz8iX9p4XQ/6AFQrnDTw: checks
*** RIVER *** [As Jd 7s Ks] [9d]
NczJqEIUdrpEc5Nbd7h1Ig: checks
ovpz8iX9p4XQ/6AFQrnDTw: checks
*** SHOW DOWN ***
NczJqEIUdrpEc5Nbd7h1Ig: shows [Jc Ts] (a pair of Jacks)
ovpz8iX9p4XQ/6AFQrnDTw: shows [Kd 6s] (a pair of Kings)
ovpz8iX9p4XQ/6AFQrnDTw collected $148 from pot
*** SUMMARY ***
Total pot $150 | Rake $2
Board [As Jd 7s Ks 9d]
Seat 1: NczJqEIUdrpEc5Nbd7h1Ig (small blind) showed [Jc Ts] and lost with a pair of Jacks
Seat 2: Xl+I49lxCJwPGRuegiaHoA (big blind) folded before Flop
Seat 3: 7SUIdtQak1SCtldWHjwnFA folded before Flop (didn't bet)
Seat 5: jkH6qYMpn8JA/IyBOhQPMw folded before Flop (didn't bet)
Seat 6: ovpz8iX9p4XQ/6AFQrnDTw (button) showed [Kd 6s] and won ($148) with a pair of Kings



PokerStars Game #59957561934:  Hold'em No Limit ($5/$10) - 2009/07/01 9:53:53 ET
Table '2a86NK3xhs21kwGZmbj0QA' 6-max Seat #1 is the button
Seat 1: NczJqEIUdrpEc5Nbd7h1Ig ($399 in chips)
Seat 2: Xl+I49lxCJwPGRuegiaHoA ($1000 in chips)
Seat 5: jkH6qYMpn8JA/IyBOhQPMw ($1228 in chips)
Seat 6: ovpz8iX9p4XQ/6AFQrnDTw ($438.30 in chips)
Xl+I49lxCJwPGRuegiaHoA: posts small blind $5
jkH6qYMpn8JA/IyBOhQPMw: posts big blind $10
*** HOLE CARDS ***
ovpz8iX9p4XQ/6AFQrnDTw: folds
NczJqEIUdrpEc5Nbd7h1Ig: folds
7SUIdtQak1SCtldWHjwnFA leaves the table
Xl+I49lxCJwPGRuegiaHoA: raises $20 to $30
jkH6qYMpn8JA/IyBOhQPMw: calls $20
*** FLOP *** [Kh Qh 6d]
Xl+I49lxCJwPGRuegiaHoA: bets $50
jkH6qYMpn8JA/IyBOhQPMw: raises $126 to $176
Xl+I49lxCJwPGRuegiaHoA: folds
jkH6qYMpn8JA/IyBOhQPMw collected $158 from pot
jkH6qYMpn8JA/IyBOhQPMw: doesn't show hand
*** SUMMARY ***
Total pot $160 | Rake $2
Board [Kh Qh 6d]
Seat 1: NczJqEIUdrpEc5Nbd7h1Ig (button) folded before Flop (didn't bet)
Seat 2: Xl+I49lxCJwPGRuegiaHoA (small blind) folded on the Flop
Seat 5: jkH6qYMpn8JA/IyBOhQPMw (big blind) collected ($158)
Seat 6: ovpz8iX9p4XQ/6AFQrnDTw folded before Flop (didn't bet)



PokerStars Game #59957585044:  Hold'em No Limit ($5/$10) - 2009/07/01 9:54:25 ET
Table '2a86NK3xhs21kwGZmbj0QA' 6-max Seat #2 is the button
Seat 1: NczJqEIUdrpEc5Nbd7h1Ig ($399 in chips)
Seat 2: Xl+I49lxCJwPGRuegiaHoA ($1000 in chips)
Seat 5: jkH6qYMpn8JA/IyBOhQPMw ($1306 in chips)
Seat 6: ovpz8iX9p4XQ/6AFQrnDTw ($438.30 in chips)
jkH6qYMpn8JA/IyBOhQPMw: posts small blind $5
ovpz8iX9p4XQ/6AFQrnDTw: posts big blind $10
*** HOLE CARDS ***
NczJqEIUdrpEc5Nbd7h1Ig: folds
Xl+I49lxCJwPGRuegiaHoA: folds
jkH6qYMpn8JA/IyBOhQPMw: raises $20 to $30
ovpz8iX9p4XQ/6AFQrnDTw: folds
jkH6qYMpn8JA/IyBOhQPMw collected $20 from pot
jkH6qYMpn8JA/IyBOhQPMw: doesn't show hand
*** SUMMARY ***
Total pot $20 | Rake $0
Seat 1: NczJqEIUdrpEc5Nbd7h1Ig folded before Flop (didn't bet)
Seat 2: Xl+I49lxCJwPGRuegiaHoA (button) folded before Flop (didn't bet)
Seat 5: jkH6qYMpn8JA/IyBOhQPMw (small blind) collected ($20)
Seat 6: ovpz8iX9p4XQ/6AFQrnDTw (big blind) folded before Flop



PokerStars Game #59957594818:  Hold'em No Limit ($5/$10) - 2009/07/01 9:54:39 ET
Table '2a86NK3xhs21kwGZmbj0QA' 6-max Seat #5 is the button
Seat 1: NczJqEIUdrpEc5Nbd7h1Ig ($399 in chips)
Seat 2: Xl+I49lxCJwPGRuegiaHoA ($1000 in chips)
Seat 5: jkH6qYMpn8JA/IyBOhQPMw ($1316 in chips)
Seat 6: ovpz8iX9p4XQ/6AFQrnDTw ($428.30 in chips)
ovpz8iX9p4XQ/6AFQrnDTw: posts small blind $5
NczJqEIUdrpEc5Nbd7h1Ig: posts big blind $10
*** HOLE CARDS ***
Xl+I49lxCJwPGRuegiaHoA: raises $20 to $30
jkH6qYMpn8JA/IyBOhQPMw: calls $30
ovpz8iX9p4XQ/6AFQrnDTw: calls $25
NczJqEIUdrpEc5Nbd7h1Ig: calls $20
*** FLOP *** [6c 7h 9d]
ovpz8iX9p4XQ/6AFQrnDTw: checks
NczJqEIUdrpEc5Nbd7h1Ig: checks
Xl+I49lxCJwPGRuegiaHoA: checks
jkH6qYMpn8JA/IyBOhQPMw: bets $100
ovpz8iX9p4XQ/6AFQrnDTw: folds
NczJqEIUdrpEc5Nbd7h1Ig: calls $100
Xl+I49lxCJwPGRuegiaHoA: folds
*** TURN *** [6c 7h 9d] [Kc]
NczJqEIUdrpEc5Nbd7h1Ig: checks
jkH6qYMpn8JA/IyBOhQPMw: checks
*** RIVER *** [6c 7h 9d Kc] [5h]
NczJqEIUdrpEc5Nbd7h1Ig: checks
jkH6qYMpn8JA/IyBOhQPMw: bets $300
NczJqEIUdrpEc5Nbd7h1Ig: calls $269 and is all-in
*** SHOW DOWN ***
jkH6qYMpn8JA/IyBOhQPMw: shows [9c 8s] (a straight, Five to Nine)
NczJqEIUdrpEc5Nbd7h1Ig: mucks hand
jkH6qYMpn8JA/IyBOhQPMw collected $856 from pot
*** SUMMARY ***
Total pot $858 | Rake $2
Board [6c 7h 9d Kc 5h]
Seat 1: NczJqEIUdrpEc5Nbd7h1Ig (big blind) mucked
Seat 2: Xl+I49lxCJwPGRuegiaHoA folded on the Flop
Seat 5: jkH6qYMpn8JA/IyBOhQPMw (button) showed [9c 8s] and won ($856) with a straight, Five to Nine
Seat 6: ovpz8iX9p4XQ/6AFQrnDTw (small blind) folded on the Flop



PokerStars Game #59957625274:  Hold'em No Limit ($5/$10) - 2009/07/01 9:55:22 ET
Table 'IyraSBLp+yhyRE6/jd8spA' 2-max Seat #1 is the button
Seat 1: sVocLgrQLp4Ke1DJ2pbNKg ($1000 in chips)
Seat 2: 3nbnu02+Z7ZmECb/JLOUvg ($1000 in chips)
sVocLgrQLp4Ke1DJ2pbNKg: posts small blind $5
3nbnu02+Z7ZmECb/JLOUvg: posts big blind $10
*** HOLE CARDS ***
sVocLgrQLp4Ke1DJ2pbNKg: folds
3nbnu02+Z7ZmECb/JLOUvg collected $10 from pot
*** SUMMARY ***
Total pot $10 | Rake $0
Seat 1: sVocLgrQLp4Ke1DJ2pbNKg (button) (small blind) folded before Flop
Seat 2: 3nbnu02+Z7ZmECb/JLOUvg (big blind) collected ($10)



PokerStars Game #59957630584:  Hold'em No Limit ($5/$10) - 2009/07/01 9:55:29 ET
Table 'IyraSBLp+yhyRE6/jd8spA' 2-max Seat #2 is the button
Seat 1: sVocLgrQLp4Ke1DJ2pbNKg ($1000 in chips)
Seat 2: 3nbnu02+Z7ZmECb/JLOUvg ($1005 in chips)
3nbnu02+Z7ZmECb/JLOUvg: posts small blind $5
sVocLgrQLp4Ke1DJ2pbNKg: posts big blind $10
*** HOLE CARDS ***
3nbnu02+Z7ZmECb/JLOUvg: raises $20 to $30
sVocLgrQLp4Ke1DJ2pbNKg: folds
3nbnu02+Z7ZmECb/JLOUvg collected $20 from pot
*** SUMMARY ***
Total pot $20 | Rake $0
Seat 1: sVocLgrQLp4Ke1DJ2pbNKg (big blind) folded before Flop
Seat 2: 3nbnu02+Z7ZmECb/JLOUvg (button) (small blind) collected ($20)



PokerStars Game #59957638266:  Hold'em No Limit ($5/$10) - 2009/07/01 9:55:40 ET
Table 'IyraSBLp+yhyRE6/jd8spA' 2-max Seat #1 is the button
Seat 1: sVocLgrQLp4Ke1DJ2pbNKg ($1000 in chips)
Seat 2: 3nbnu02+Z7ZmECb/JLOUvg ($1015 in chips)
sVocLgrQLp4Ke1DJ2pbNKg: posts small blind $5
3nbnu02+Z7ZmECb/JLOUvg: posts big blind $10
*** HOLE CARDS ***
sVocLgrQLp4Ke1DJ2pbNKg: folds
3nbnu02+Z7ZmECb/JLOUvg collected $10 from pot
*** SUMMARY ***
Total pot $10 | Rake $0
Seat 1: sVocLgrQLp4Ke1DJ2pbNKg (button) (small blind) folded before Flop
Seat 2: 3nbnu02+Z7ZmECb/JLOUvg (big blind) collected ($10)



PokerStars Game #59957643210:  Hold'em No Limit ($5/$10) - 2009/07/01 9:55:46 ET
Table 'IyraSBLp+yhyRE6/jd8spA' 2-max Seat #2 is the button
Seat 1: sVocLgrQLp4Ke1DJ2pbNKg ($1000 in chips)
Seat 2: 3nbnu02+Z7ZmECb/JLOUvg ($1020 in chips)
3nbnu02+Z7ZmECb/JLOUvg: posts small blind $5
sVocLgrQLp4Ke1DJ2pbNKg: posts big blind $10
*** HOLE CARDS ***
3nbnu02+Z7ZmECb/JLOUvg: raises $20 to $30
sVocLgrQLp4Ke1DJ2pbNKg: folds
3nbnu02+Z7ZmECb/JLOUvg collected $20 from pot
*** SUMMARY ***
Total pot $20 | Rake $0
Seat 1: sVocLgrQLp4Ke1DJ2pbNKg (big blind) folded before Flop
Seat 2: 3nbnu02+Z7ZmECb/JLOUvg (button) (small blind) collected ($20)



PokerStars Game #59957651586:  Hold'em No Limit ($5/$10) - 2009/07/01 9:55:58 ET
Table 'IyraSBLp+yhyRE6/jd8spA' 2-max Seat #1 is the button
Seat 1: sVocLgrQLp4Ke1DJ2pbNKg ($1000 in chips)
Seat 2: 3nbnu02+Z7ZmECb/JLOUvg ($1030 in chips)
sVocLgrQLp4Ke1DJ2pbNKg: posts small blind $5
3nbnu02+Z7ZmECb/JLOUvg: posts big blind $10
*** HOLE CARDS ***
sVocLgrQLp4Ke1DJ2pbNKg: folds
3nbnu02+Z7ZmECb/JLOUvg collected $10 from pot
*** SUMMARY ***
Total pot $10 | Rake $0
Seat 1: sVocLgrQLp4Ke1DJ2pbNKg (button) (small blind) folded before Flop
Seat 2: 3nbnu02+Z7ZmECb/JLOUvg (big blind) collected ($10)



PokerStars Game #59957657010:  Hold'em No Limit ($5/$10) - 2009/07/01 9:56:06 ET
Table 'IyraSBLp+yhyRE6/jd8spA' 2-max Seat #2 is the button
Seat 1: sVocLgrQLp4Ke1DJ2pbNKg ($1000 in chips)
Seat 2: 3nbnu02+Z7ZmECb/JLOUvg ($1035 in chips)
3nbnu02+Z7ZmECb/JLOUvg: posts small blind $5
sVocLgrQLp4Ke1DJ2pbNKg: posts big blind $10
*** HOLE CARDS ***
3nbnu02+Z7ZmECb/JLOUvg: raises $20 to $30
sVocLgrQLp4Ke1DJ2pbNKg: folds
3nbnu02+Z7ZmECb/JLOUvg collected $20 from pot
*** SUMMARY ***
Total pot $20 | Rake $0
Seat 1: sVocLgrQLp4Ke1DJ2pbNKg (big blind) folded before Flop
Seat 2: 3nbnu02+Z7ZmECb/JLOUvg (button) (small blind) collected ($20)



PokerStars Game #59957668482:  Hold'em No Limit ($5/$10) - 2009/07/01 9:56:22 ET
Table 'IyraSBLp+yhyRE6/jd8spA' 2-max Seat #1 is the button
Seat 1: sVocLgrQLp4Ke1DJ2pbNKg ($1000 in chips)
Seat 2: 3nbnu02+Z7ZmECb/JLOUvg ($1045 in chips)
sVocLgrQLp4Ke1DJ2pbNKg: posts small blind $5
3nbnu02+Z7ZmECb/JLOUvg: posts big blind $10
*** HOLE CARDS ***
sVocLgrQLp4Ke1DJ2pbNKg: folds
3nbnu02+Z7ZmECb/JLOUvg collected $10 from pot
*** SUMMARY ***
Total pot $10 | Rake $0
Seat 1: sVocLgrQLp4Ke1DJ2pbNKg (button) (small blind) folded before Flop
Seat 2: 3nbnu02+Z7ZmECb/JLOUvg (big blind) collected ($10)



PokerStars Game #59957672934:  Hold'em No Limit ($5/$10) - 2009/07/01 9:56:28 ET
Table 'IyraSBLp+yhyRE6/jd8spA' 2-max Seat #2 is the button
Seat 1: sVocLgrQLp4Ke1DJ2pbNKg ($1000 in chips)
Seat 2: 3nbnu02+Z7ZmECb/JLOUvg ($1050 in chips)
3nbnu02+Z7ZmECb/JLOUvg: posts small blind $5
sVocLgrQLp4Ke1DJ2pbNKg: posts big blind $10
*** HOLE CARDS ***
3nbnu02+Z7ZmECb/JLOUvg: folds
sVocLgrQLp4Ke1DJ2pbNKg collected $10 from pot
*** SUMMARY ***
Total pot $10 | Rake $0
Seat 1: sVocLgrQLp4Ke1DJ2pbNKg (big blind) collected ($10)
Seat 2: 3nbnu02+Z7ZmECb/JLOUvg (button) (small blind) folded before Flop



PokerStars Game #59957679954:  Hold'em No Limit ($5/$10) - 2009/07/01 9:56:38 ET
Table 'IyraSBLp+yhyRE6/jd8spA' 2-max Seat #1 is the button
Seat 1: sVocLgrQLp4Ke1DJ2pbNKg ($1005 in chips)
Seat 2: 3nbnu02+Z7ZmECb/JLOUvg ($1045 in chips)
sVocLgrQLp4Ke1DJ2pbNKg: posts small blind $5
3nbnu02+Z7ZmECb/JLOUvg: posts big blind $10
*** HOLE CARDS ***
sVocLgrQLp4Ke1DJ2pbNKg: raises $10 to $20
3nbnu02+Z7ZmECb/JLOUvg: calls $10
*** FLOP *** [Ah Jd 6h]
3nbnu02+Z7ZmECb/JLOUvg: checks
sVocLgrQLp4Ke1DJ2pbNKg: checks
*** TURN *** [Ah Jd 6h] [4d]
3nbnu02+Z7ZmECb/JLOUvg: bets $20
sVocLgrQLp4Ke1DJ2pbNKg: folds
3nbnu02+Z7ZmECb/JLOUvg collected $39.50 from pot
*** SUMMARY ***
Total pot $40 | Rake $0.50
Board [Ah Jd 6h 4d]
Seat 1: sVocLgrQLp4Ke1DJ2pbNKg (button) (small blind) folded on the Turn
Seat 2: 3nbnu02+Z7ZmECb/JLOUvg (big blind) collected ($39.50)



PokerStars Game #59957694928:  Hold'em No Limit ($5/$10) - 2009/07/01 9:56:59 ET
Table 'IyraSBLp+yhyRE6/jd8spA' 2-max Seat #2 is the button
Seat 1: sVocLgrQLp4Ke1DJ2pbNKg ($1000 in chips)
Seat 2: 3nbnu02+Z7ZmECb/JLOUvg ($1064.50 in chips)
3nbnu02+Z7ZmECb/JLOUvg: posts small blind $5
sVocLgrQLp4Ke1DJ2pbNKg: posts big blind $10
*** HOLE CARDS ***
3nbnu02+Z7ZmECb/JLOUvg: raises $20 to $30
sVocLgrQLp4Ke1DJ2pbNKg: folds
3nbnu02+Z7ZmECb/JLOUvg collected $20 from pot
*** SUMMARY ***
Total pot $20 | Rake $0
Seat 1: sVocLgrQLp4Ke1DJ2pbNKg (big blind) folded before Flop
Seat 2: 3nbnu02+Z7ZmECb/JLOUvg (button) (small blind) collected ($20)



PokerStars Game #59957701762:  Hold'em No Limit ($5/$10) - 2009/07/01 9:57:08 ET
Table 'IyraSBLp+yhyRE6/jd8spA' 2-max Seat #1 is the button
Seat 1: sVocLgrQLp4Ke1DJ2pbNKg ($1000 in chips)
Seat 2: 3nbnu02+Z7ZmECb/JLOUvg ($1074.50 in chips)
sVocLgrQLp4Ke1DJ2pbNKg: posts small blind $5
3nbnu02+Z7ZmECb/JLOUvg: posts big blind $10
*** HOLE CARDS ***
sVocLgrQLp4Ke1DJ2pbNKg: raises $10 to $20
3nbnu02+Z7ZmECb/JLOUvg: folds
sVocLgrQLp4Ke1DJ2pbNKg collected $20 from pot
*** SUMMARY ***
Total pot $20 | Rake $0
Seat 1: sVocLgrQLp4Ke1DJ2pbNKg (button) (small blind) collected ($20)
Seat 2: 3nbnu02+Z7ZmECb/JLOUvg (big blind) folded before Flop



PokerStars Game #59957706288:  Hold'em No Limit ($5/$10) - 2009/07/01 9:57:14 ET
Table 'IyraSBLp+yhyRE6/jd8spA' 2-max Seat #2 is the button
Seat 1: sVocLgrQLp4Ke1DJ2pbNKg ($1010 in chips)
Seat 2: 3nbnu02+Z7ZmECb/JLOUvg ($1064.50 in chips)
3nbnu02+Z7ZmECb/JLOUvg: posts small blind $5
sVocLgrQLp4Ke1DJ2pbNKg: posts big blind $10
*** HOLE CARDS ***
3nbnu02+Z7ZmECb/JLOUvg: raises $20 to $30
sVocLgrQLp4Ke1DJ2pbNKg: folds
3nbnu02+Z7ZmECb/JLOUvg collected $20 from pot
*** SUMMARY ***
Total pot $20 | Rake $0
Seat 1: sVocLgrQLp4Ke1DJ2pbNKg (big blind) folded before Flop
Seat 2: 3nbnu02+Z7ZmECb/JLOUvg (button) (small blind) collected ($20)



PokerStars Game #59957712398:  Hold'em No Limit ($5/$10) - 2009/07/01 9:57:23 ET
Table 'IyraSBLp+yhyRE6/jd8spA' 2-max Seat #1 is the button
Seat 1: sVocLgrQLp4Ke1DJ2pbNKg ($1000 in chips)
Seat 2: 3nbnu02+Z7ZmECb/JLOUvg ($1074.50 in chips)
sVocLgrQLp4Ke1DJ2pbNKg: posts small blind $5
3nbnu02+Z7ZmECb/JLOUvg: posts big blind $10
*** HOLE CARDS ***
sVocLgrQLp4Ke1DJ2pbNKg: raises $10 to $20
3nbnu02+Z7ZmECb/JLOUvg: calls $10
*** FLOP *** [9h Js 4d]
3nbnu02+Z7ZmECb/JLOUvg: checks
sVocLgrQLp4Ke1DJ2pbNKg: checks
*** TURN *** [9h Js 4d] [7d]
3nbnu02+Z7ZmECb/JLOUvg: bets $10
sVocLgrQLp4Ke1DJ2pbNKg: calls $10
*** RIVER *** [9h Js 4d 7d] [Kd]
3nbnu02+Z7ZmECb/JLOUvg: bets $50
sVocLgrQLp4Ke1DJ2pbNKg: folds
3nbnu02+Z7ZmECb/JLOUvg collected $59.50 from pot
*** SUMMARY ***
Total pot $60 | Rake $0.50
Board [9h Js 4d 7d Kd]
Seat 1: sVocLgrQLp4Ke1DJ2pbNKg (button) (small blind) folded on the River
Seat 2: 3nbnu02+Z7ZmECb/JLOUvg (big blind) collected ($59.50)



PokerStars Game #59957733880:  Hold'em No Limit ($5/$10) - 2009/07/01 9:57:53 ET
Table 'IyraSBLp+yhyRE6/jd8spA' 2-max Seat #2 is the button
Seat 1: sVocLgrQLp4Ke1DJ2pbNKg ($1000 in chips)
Seat 2: 3nbnu02+Z7ZmECb/JLOUvg ($1104 in chips)
3nbnu02+Z7ZmECb/JLOUvg: posts small blind $5
sVocLgrQLp4Ke1DJ2pbNKg: posts big blind $10
*** HOLE CARDS ***
3nbnu02+Z7ZmECb/JLOUvg: raises $20 to $30
sVocLgrQLp4Ke1DJ2pbNKg: calls $20
*** FLOP *** [Kc Ks 8s]
sVocLgrQLp4Ke1DJ2pbNKg: checks
3nbnu02+Z7ZmECb/JLOUvg: bets $40
sVocLgrQLp4Ke1DJ2pbNKg: calls $40
*** TURN *** [Kc Ks 8s] [6h]
sVocLgrQLp4Ke1DJ2pbNKg: checks
3nbnu02+Z7ZmECb/JLOUvg: checks
*** RIVER *** [Kc Ks 8s 6h] [2c]
sVocLgrQLp4Ke1DJ2pbNKg: bets $120
3nbnu02+Z7ZmECb/JLOUvg: calls $120
*** SHOW DOWN ***
sVocLgrQLp4Ke1DJ2pbNKg: shows [6s 6c] (a full house, Sixes full of Kings)
3nbnu02+Z7ZmECb/JLOUvg: mucks hand
sVocLgrQLp4Ke1DJ2pbNKg collected $379.50 from pot
*** SUMMARY ***
Total pot $380 | Rake $0.50
Board [Kc Ks 8s 6h 2c]
Seat 1: sVocLgrQLp4Ke1DJ2pbNKg (big blind) showed [6s 6c] and won ($379.50) with a full house, Sixes full of Kings
Seat 2: 3nbnu02+Z7ZmECb/JLOUvg (button) (small blind) mucked



PokerStars Game #59957752060:  Hold'em No Limit ($5/$10) - 2009/07/01 9:58:19 ET
Table 'IyraSBLp+yhyRE6/jd8spA' 2-max Seat #1 is the button
Seat 1: sVocLgrQLp4Ke1DJ2pbNKg ($1189.50 in chips)
Seat 2: 3nbnu02+Z7ZmECb/JLOUvg ($914 in chips)
sVocLgrQLp4Ke1DJ2pbNKg: posts small blind $5
3nbnu02+Z7ZmECb/JLOUvg: posts big blind $10
*** HOLE CARDS ***
sVocLgrQLp4Ke1DJ2pbNKg: folds
3nbnu02+Z7ZmECb/JLOUvg collected $10 from pot
*** SUMMARY ***
Total pot $10 | Rake $0
Seat 1: sVocLgrQLp4Ke1DJ2pbNKg (button) (small blind) folded before Flop
Seat 2: 3nbnu02+Z7ZmECb/JLOUvg (big blind) collected ($10)



PokerStars Game #59957758302:  Hold'em No Limit ($5/$10) - 2009/07/01 9:58:27 ET
Table 'IyraSBLp+yhyRE6/jd8spA' 2-max Seat #2 is the button
Seat 1: sVocLgrQLp4Ke1DJ2pbNKg ($1184.50 in chips)
Seat 2: 3nbnu02+Z7ZmECb/JLOUvg ($919 in chips)
3nbnu02+Z7ZmECb/JLOUvg: posts small blind $5
sVocLgrQLp4Ke1DJ2pbNKg: posts big blind $10
*** HOLE CARDS ***
3nbnu02+Z7ZmECb/JLOUvg: folds
sVocLgrQLp4Ke1DJ2pbNKg collected $10 from pot
*** SUMMARY ***
Total pot $10 | Rake $0
Seat 1: sVocLgrQLp4Ke1DJ2pbNKg (big blind) collected ($10)
Seat 2: 3nbnu02+Z7ZmECb/JLOUvg (button) (small blind) folded before Flop



PokerStars Game #59957762694:  Hold'em No Limit ($5/$10) - 2009/07/01 9:58:34 ET
Table 'IyraSBLp+yhyRE6/jd8spA' 2-max Seat #1 is the button
Seat 1: sVocLgrQLp4Ke1DJ2pbNKg ($1189.50 in chips)
Seat 2: 3nbnu02+Z7ZmECb/JLOUvg ($914 in chips)
sVocLgrQLp4Ke1DJ2pbNKg: posts small blind $5
3nbnu02+Z7ZmECb/JLOUvg: posts big blind $10
*** HOLE CARDS ***
sVocLgrQLp4Ke1DJ2pbNKg: raises $10 to $20
3nbnu02+Z7ZmECb/JLOUvg: raises $50 to $70
sVocLgrQLp4Ke1DJ2pbNKg: folds
3nbnu02+Z7ZmECb/JLOUvg collected $40 from pot
*** SUMMARY ***
Total pot $40 | Rake $0
Seat 1: sVocLgrQLp4Ke1DJ2pbNKg (button) (small blind) folded before Flop
Seat 2: 3nbnu02+Z7ZmECb/JLOUvg (big blind) collected ($40)



PokerStars Game #59957771946:  Hold'em No Limit ($5/$10) - 2009/07/01 9:58:47 ET
Table 'IyraSBLp+yhyRE6/jd8spA' 2-max Seat #2 is the button
Seat 1: sVocLgrQLp4Ke1DJ2pbNKg ($1169.50 in chips)
Seat 2: 3nbnu02+Z7ZmECb/JLOUvg ($934 in chips)
3nbnu02+Z7ZmECb/JLOUvg: posts small blind $5
sVocLgrQLp4Ke1DJ2pbNKg: posts big blind $10
*** HOLE CARDS ***
3nbnu02+Z7ZmECb/JLOUvg: folds
sVocLgrQLp4Ke1DJ2pbNKg collected $10 from pot
sVocLgrQLp4Ke1DJ2pbNKg: doesn't show hand
*** SUMMARY ***
Total pot $10 | Rake $0
Seat 1: sVocLgrQLp4Ke1DJ2pbNKg (big blind) collected ($10)
Seat 2: 3nbnu02+Z7ZmECb/JLOUvg (button) (small blind) folded before Flop



PokerStars Game #59957776688:  Hold'em No Limit ($5/$10) - 2009/07/01 9:58:53 ET
Table 'IyraSBLp+yhyRE6/jd8spA' 2-max Seat #1 is the button
Seat 1: sVocLgrQLp4Ke1DJ2pbNKg ($1174.50 in chips)
Seat 2: 3nbnu02+Z7ZmECb/JLOUvg ($929 in chips)
sVocLgrQLp4Ke1DJ2pbNKg: posts small blind $5
3nbnu02+Z7ZmECb/JLOUvg: posts big blind $10
*** HOLE CARDS ***
sVocLgrQLp4Ke1DJ2pbNKg: folds
3nbnu02+Z7ZmECb/JLOUvg collected $10 from pot
*** SUMMARY ***
Total pot $10 | Rake $0
Seat 1: sVocLgrQLp4Ke1DJ2pbNKg (button) (small blind) folded before Flop
Seat 2: 3nbnu02+Z7ZmECb/JLOUvg (big blind) collected ($10)



PokerStars Game #59957781014:  Hold'em No Limit ($5/$10) - 2009/07/01 9:58:59 ET
Table 'IyraSBLp+yhyRE6/jd8spA' 2-max Seat #2 is the button
Seat 1: sVocLgrQLp4Ke1DJ2pbNKg ($1169.50 in chips)
Seat 2: 3nbnu02+Z7ZmECb/JLOUvg ($934 in chips)
3nbnu02+Z7ZmECb/JLOUvg: posts small blind $5
sVocLgrQLp4Ke1DJ2pbNKg: posts big blind $10
*** HOLE CARDS ***
3nbnu02+Z7ZmECb/JLOUvg: raises $20 to $30
sVocLgrQLp4Ke1DJ2pbNKg: calls $20
*** FLOP *** [3s 5c 4h]
sVocLgrQLp4Ke1DJ2pbNKg: checks
3nbnu02+Z7ZmECb/JLOUvg: bets $40
sVocLgrQLp4Ke1DJ2pbNKg: folds
3nbnu02+Z7ZmECb/JLOUvg collected $59.50 from pot
*** SUMMARY ***
Total pot $60 | Rake $0.50
Board [3s 5c 4h]
Seat 1: sVocLgrQLp4Ke1DJ2pbNKg (big blind) folded on the Flop
Seat 2: 3nbnu02+Z7ZmECb/JLOUvg (button) (small blind) collected ($59.50)



PokerStars Game #59957790624:  Hold'em No Limit ($5/$10) - 2009/07/01 9:59:12 ET
Table 'IyraSBLp+yhyRE6/jd8spA' 2-max Seat #1 is the button
Seat 1: sVocLgrQLp4Ke1DJ2pbNKg ($1139.50 in chips)
Seat 2: 3nbnu02+Z7ZmECb/JLOUvg ($963.50 in chips)
sVocLgrQLp4Ke1DJ2pbNKg: posts small blind $5
3nbnu02+Z7ZmECb/JLOUvg: posts big blind $10
*** HOLE CARDS ***
sVocLgrQLp4Ke1DJ2pbNKg: raises $10 to $20
3nbnu02+Z7ZmECb/JLOUvg: calls $10
*** FLOP *** [Kc Kd 2s]
3nbnu02+Z7ZmECb/JLOUvg: checks
sVocLgrQLp4Ke1DJ2pbNKg: bets $30
3nbnu02+Z7ZmECb/JLOUvg: calls $30
*** TURN *** [Kc Kd 2s] [Qs]
3nbnu02+Z7ZmECb/JLOUvg: checks
sVocLgrQLp4Ke1DJ2pbNKg: checks
*** RIVER *** [Kc Kd 2s Qs] [Tc]
3nbnu02+Z7ZmECb/JLOUvg: bets $30
sVocLgrQLp4Ke1DJ2pbNKg: folds
3nbnu02+Z7ZmECb/JLOUvg collected $99.50 from pot
*** SUMMARY ***
Total pot $100 | Rake $0.50
Board [Kc Kd 2s Qs Tc]
Seat 1: sVocLgrQLp4Ke1DJ2pbNKg (button) (small blind) folded on the River
Seat 2: 3nbnu02+Z7ZmECb/JLOUvg (big blind) collected ($99.50)



PokerStars Game #59957811624:  Hold'em No Limit ($5/$10) - 2009/07/01 9:59:42 ET
Table 'IyraSBLp+yhyRE6/jd8spA' 2-max Seat #2 is the button
Seat 1: sVocLgrQLp4Ke1DJ2pbNKg ($1089.50 in chips)
Seat 2: 3nbnu02+Z7ZmECb/JLOUvg ($1013 in chips)
3nbnu02+Z7ZmECb/JLOUvg: posts small blind $5
sVocLgrQLp4Ke1DJ2pbNKg: posts big blind $10
*** HOLE CARDS ***
3nbnu02+Z7ZmECb/JLOUvg: raises $20 to $30
sVocLgrQLp4Ke1DJ2pbNKg: folds
3nbnu02+Z7ZmECb/JLOUvg collected $20 from pot
*** SUMMARY ***
Total pot $20 | Rake $0
Seat 1: sVocLgrQLp4Ke1DJ2pbNKg (big blind) folded before Flop
Seat 2: 3nbnu02+Z7ZmECb/JLOUvg (button) (small blind) collected ($20)



PokerStars Game #59957818220:  Hold'em No Limit ($5/$10) - 2009/07/01 9:59:51 ET
Table 'IyraSBLp+yhyRE6/jd8spA' 2-max Seat #1 is the button
Seat 1: sVocLgrQLp4Ke1DJ2pbNKg ($1079.50 in chips)
Seat 2: 3nbnu02+Z7ZmECb/JLOUvg ($1023 in chips)
sVocLgrQLp4Ke1DJ2pbNKg: posts small blind $5
3nbnu02+Z7ZmECb/JLOUvg: posts big blind $10
*** HOLE CARDS ***
sVocLgrQLp4Ke1DJ2pbNKg: raises $10 to $20
3nbnu02+Z7ZmECb/JLOUvg: calls $10
*** FLOP *** [5h Ad 9d]
3nbnu02+Z7ZmECb/JLOUvg: checks
sVocLgrQLp4Ke1DJ2pbNKg: bets $30
3nbnu02+Z7ZmECb/JLOUvg: calls $30
*** TURN *** [5h Ad 9d] [8d]
3nbnu02+Z7ZmECb/JLOUvg: checks
sVocLgrQLp4Ke1DJ2pbNKg: bets $70
3nbnu02+Z7ZmECb/JLOUvg: folds
sVocLgrQLp4Ke1DJ2pbNKg collected $99.50 from pot
*** SUMMARY ***
Total pot $100 | Rake $0.50
Board [5h Ad 9d 8d]
Seat 1: sVocLgrQLp4Ke1DJ2pbNKg (button) (small blind) collected ($99.50)
Seat 2: 3nbnu02+Z7ZmECb/JLOUvg (big blind) folded on the Turn



PokerStars Game #59957839900:  Hold'em No Limit ($5/$10) - 2009/07/01 10:00:17 ET
Table 'IyraSBLp+yhyRE6/jd8spA' 2-max Seat #2 is the button
Seat 1: sVocLgrQLp4Ke1DJ2pbNKg ($1129 in chips)
Seat 2: 3nbnu02+Z7ZmECb/JLOUvg ($973 in chips)
3nbnu02+Z7ZmECb/JLOUvg: posts small blind $5
sVocLgrQLp4Ke1DJ2pbNKg: posts big blind $10
*** HOLE CARDS ***
3nbnu02+Z7ZmECb/JLOUvg: raises $20 to $30
sVocLgrQLp4Ke1DJ2pbNKg: folds
3nbnu02+Z7ZmECb/JLOUvg collected $20 from pot
*** SUMMARY ***
Total pot $20 | Rake $0
Seat 1: sVocLgrQLp4Ke1DJ2pbNKg (big blind) folded before Flop
Seat 2: 3nbnu02+Z7ZmECb/JLOUvg (button) (small blind) collected ($20)



PokerStars Game #59957847592:  Hold'em No Limit ($5/$10) - 2009/07/01 10:00:28 ET
Table 'IyraSBLp+yhyRE6/jd8spA' 2-max Seat #1 is the button
Seat 1: sVocLgrQLp4Ke1DJ2pbNKg ($1119 in chips)
Seat 2: 3nbnu02+Z7ZmECb/JLOUvg ($983 in chips)
sVocLgrQLp4Ke1DJ2pbNKg: posts small blind $5
3nbnu02+Z7ZmECb/JLOUvg: posts big blind $10
*** HOLE CARDS ***
sVocLgrQLp4Ke1DJ2pbNKg: raises $10 to $20
3nbnu02+Z7ZmECb/JLOUvg: raises $50 to $70
sVocLgrQLp4Ke1DJ2pbNKg: folds
3nbnu02+Z7ZmECb/JLOUvg collected $40 from pot
*** SUMMARY ***
Total pot $40 | Rake $0
Seat 1: sVocLgrQLp4Ke1DJ2pbNKg (button) (small blind) folded before Flop
Seat 2: 3nbnu02+Z7ZmECb/JLOUvg (big blind) collected ($40)



PokerStars Game #59957855848:  Hold'em No Limit ($5/$10) - 2009/07/01 10:00:39 ET
Table 'IyraSBLp+yhyRE6/jd8spA' 2-max Seat #2 is the button
Seat 1: sVocLgrQLp4Ke1DJ2pbNKg ($1099 in chips)
Seat 2: 3nbnu02+Z7ZmECb/JLOUvg ($1003 in chips)
3nbnu02+Z7ZmECb/JLOUvg: posts small blind $5
sVocLgrQLp4Ke1DJ2pbNKg: posts big blind $10
*** HOLE CARDS ***
3nbnu02+Z7ZmECb/JLOUvg: raises $20 to $30
sVocLgrQLp4Ke1DJ2pbNKg: calls $20
*** FLOP *** [3h 3c 6h]
sVocLgrQLp4Ke1DJ2pbNKg: checks
3nbnu02+Z7ZmECb/JLOUvg: checks
*** TURN *** [3h 3c 6h] [Tc]
sVocLgrQLp4Ke1DJ2pbNKg: checks
3nbnu02+Z7ZmECb/JLOUvg: bets $30
sVocLgrQLp4Ke1DJ2pbNKg: folds
3nbnu02+Z7ZmECb/JLOUvg collected $59.50 from pot
*** SUMMARY ***
Total pot $60 | Rake $0.50
Board [3h 3c 6h Tc]
Seat 1: sVocLgrQLp4Ke1DJ2pbNKg (big blind) folded on the Turn
Seat 2: 3nbnu02+Z7ZmECb/JLOUvg (button) (small blind) collected ($59.50)



PokerStars Game #59957870288:  Hold'em No Limit ($5/$10) - 2009/07/01 10:00:58 ET
Table 'IyraSBLp+yhyRE6/jd8spA' 2-max Seat #1 is the button
Seat 1: sVocLgrQLp4Ke1DJ2pbNKg ($1069 in chips)
Seat 2: 3nbnu02+Z7ZmECb/JLOUvg ($1032.50 in chips)
sVocLgrQLp4Ke1DJ2pbNKg: posts small blind $5
3nbnu02+Z7ZmECb/JLOUvg: posts big blind $10
*** HOLE CARDS ***
sVocLgrQLp4Ke1DJ2pbNKg: raises $10 to $20
3nbnu02+Z7ZmECb/JLOUvg: folds
sVocLgrQLp4Ke1DJ2pbNKg collected $20 from pot
sVocLgrQLp4Ke1DJ2pbNKg: doesn't show hand
*** SUMMARY ***
Total pot $20 | Rake $0
Seat 1: sVocLgrQLp4Ke1DJ2pbNKg (button) (small blind) collected ($20)
Seat 2: 3nbnu02+Z7ZmECb/JLOUvg (big blind) folded before Flop



PokerStars Game #59957876438:  Hold'em No Limit ($5/$10) - 2009/07/01 10:01:06 ET
Table 'IyraSBLp+yhyRE6/jd8spA' 2-max Seat #2 is the button
Seat 1: sVocLgrQLp4Ke1DJ2pbNKg ($1079 in chips)
Seat 2: 3nbnu02+Z7ZmECb/JLOUvg ($1022.50 in chips)
3nbnu02+Z7ZmECb/JLOUvg: posts small blind $5
sVocLgrQLp4Ke1DJ2pbNKg: posts big blind $10
*** HOLE CARDS ***
3nbnu02+Z7ZmECb/JLOUvg: raises $20 to $30
sVocLgrQLp4Ke1DJ2pbNKg: folds
3nbnu02+Z7ZmECb/JLOUvg collected $20 from pot
*** SUMMARY ***
Total pot $20 | Rake $0
Seat 1: sVocLgrQLp4Ke1DJ2pbNKg (big blind) folded before Flop
Seat 2: 3nbnu02+Z7ZmECb/JLOUvg (button) (small blind) collected ($20)



PokerStars Game #59957884854:  Hold'em No Limit ($5/$10) - 2009/07/01 10:01:17 ET
Table 'IyraSBLp+yhyRE6/jd8spA' 2-max Seat #1 is the button
Seat 1: sVocLgrQLp4Ke1DJ2pbNKg ($1069 in chips)
Seat 2: 3nbnu02+Z7ZmECb/JLOUvg ($1032.50 in chips)
sVocLgrQLp4Ke1DJ2pbNKg: posts small blind $5
3nbnu02+Z7ZmECb/JLOUvg: posts big blind $10
*** HOLE CARDS ***
sVocLgrQLp4Ke1DJ2pbNKg: raises $10 to $20
3nbnu02+Z7ZmECb/JLOUvg: folds
sVocLgrQLp4Ke1DJ2pbNKg collected $20 from pot
*** SUMMARY ***
Total pot $20 | Rake $0
Seat 1: sVocLgrQLp4Ke1DJ2pbNKg (button) (small blind) collected ($20)
Seat 2: 3nbnu02+Z7ZmECb/JLOUvg (big blind) folded before Flop



PokerStars Game #59957889746:  Hold'em No Limit ($5/$10) - 2009/07/01 10:01:24 ET
Table 'IyraSBLp+yhyRE6/jd8spA' 2-max Seat #2 is the button
Seat 1: sVocLgrQLp4Ke1DJ2pbNKg ($1079 in chips)
Seat 2: 3nbnu02+Z7ZmECb/JLOUvg ($1022.50 in chips)
3nbnu02+Z7ZmECb/JLOUvg: posts small blind $5
sVocLgrQLp4Ke1DJ2pbNKg: posts big blind $10
*** HOLE CARDS ***
3nbnu02+Z7ZmECb/JLOUvg: raises $20 to $30
sVocLgrQLp4Ke1DJ2pbNKg: calls $20
*** FLOP *** [Ah 8h 5s]
sVocLgrQLp4Ke1DJ2pbNKg: checks
3nbnu02+Z7ZmECb/JLOUvg: checks
*** TURN *** [Ah 8h 5s] [9c]
sVocLgrQLp4Ke1DJ2pbNKg: bets $50
3nbnu02+Z7ZmECb/JLOUvg: folds
sVocLgrQLp4Ke1DJ2pbNKg collected $59.50 from pot
*** SUMMARY ***
Total pot $60 | Rake $0.50
Board [Ah 8h 5s 9c]
Seat 1: sVocLgrQLp4Ke1DJ2pbNKg (big blind) collected ($59.50)
Seat 2: 3nbnu02+Z7ZmECb/JLOUvg (button) (small blind) folded on the Turn



PokerStars Game #59957904496:  Hold'em No Limit ($5/$10) - 2009/07/01 10:01:43 ET
Table 'IyraSBLp+yhyRE6/jd8spA' 2-max Seat #1 is the button
Seat 1: sVocLgrQLp4Ke1DJ2pbNKg ($1108.50 in chips)
Seat 2: 3nbnu02+Z7ZmECb/JLOUvg ($992.50 in chips)
sVocLgrQLp4Ke1DJ2pbNKg: posts small blind $5
3nbnu02+Z7ZmECb/JLOUvg: posts big blind $10
*** HOLE CARDS ***
sVocLgrQLp4Ke1DJ2pbNKg: raises $10 to $20
3nbnu02+Z7ZmECb/JLOUvg: raises $50 to $70
sVocLgrQLp4Ke1DJ2pbNKg: folds
3nbnu02+Z7ZmECb/JLOUvg collected $40 from pot
*** SUMMARY ***
Total pot $40 | Rake $0
Seat 1: sVocLgrQLp4Ke1DJ2pbNKg (button) (small blind) folded before Flop
Seat 2: 3nbnu02+Z7ZmECb/JLOUvg (big blind) collected ($40)



PokerStars Game #59957915298:  Hold'em No Limit ($5/$10) - 2009/07/01 10:01:57 ET
Table 'IyraSBLp+yhyRE6/jd8spA' 2-max Seat #2 is the button
Seat 1: sVocLgrQLp4Ke1DJ2pbNKg ($1088.50 in chips)
Seat 2: 3nbnu02+Z7ZmECb/JLOUvg ($1012.50 in chips)
3nbnu02+Z7ZmECb/JLOUvg: posts small blind $5
sVocLgrQLp4Ke1DJ2pbNKg: posts big blind $10
*** HOLE CARDS ***
3nbnu02+Z7ZmECb/JLOUvg: raises $20 to $30
sVocLgrQLp4Ke1DJ2pbNKg: folds
3nbnu02+Z7ZmECb/JLOUvg collected $20 from pot
*** SUMMARY ***
Total pot $20 | Rake $0
Seat 1: sVocLgrQLp4Ke1DJ2pbNKg (big blind) folded before Flop
Seat 2: 3nbnu02+Z7ZmECb/JLOUvg (button) (small blind) collected ($20)



PokerStars Game #59957924180:  Hold'em No Limit ($5/$10) - 2009/07/01 10:02:06 ET
Table 'IyraSBLp+yhyRE6/jd8spA' 2-max Seat #1 is the button
Seat 1: sVocLgrQLp4Ke1DJ2pbNKg ($1078.50 in chips)
Seat 2: 3nbnu02+Z7ZmECb/JLOUvg ($1022.50 in chips)
sVocLgrQLp4Ke1DJ2pbNKg: posts small blind $5
3nbnu02+Z7ZmECb/JLOUvg: posts big blind $10
*** HOLE CARDS ***
sVocLgrQLp4Ke1DJ2pbNKg: raises $10 to $20
3nbnu02+Z7ZmECb/JLOUvg: calls $10
*** FLOP *** [Qh 8h 5c]
3nbnu02+Z7ZmECb/JLOUvg: checks
sVocLgrQLp4Ke1DJ2pbNKg: checks
*** TURN *** [Qh 8h 5c] [4s]
3nbnu02+Z7ZmECb/JLOUvg: bets $30
sVocLgrQLp4Ke1DJ2pbNKg: folds
3nbnu02+Z7ZmECb/JLOUvg collected $39.50 from pot
*** SUMMARY ***
Total pot $40 | Rake $0.50
Board [Qh 8h 5c 4s]
Seat 1: sVocLgrQLp4Ke1DJ2pbNKg (button) (small blind) folded on the Turn
Seat 2: 3nbnu02+Z7ZmECb/JLOUvg (big blind) collected ($39.50)



PokerStars Game #59957939526:  Hold'em No Limit ($5/$10) - 2009/07/01 10:02:26 ET
Table 'IyraSBLp+yhyRE6/jd8spA' 2-max Seat #2 is the button
Seat 1: sVocLgrQLp4Ke1DJ2pbNKg ($1058.50 in chips)
Seat 2: 3nbnu02+Z7ZmECb/JLOUvg ($1042 in chips)
3nbnu02+Z7ZmECb/JLOUvg: posts small blind $5
sVocLgrQLp4Ke1DJ2pbNKg: posts big blind $10
*** HOLE CARDS ***
3nbnu02+Z7ZmECb/JLOUvg: raises $20 to $30
sVocLgrQLp4Ke1DJ2pbNKg: folds
3nbnu02+Z7ZmECb/JLOUvg collected $20 from pot
*** SUMMARY ***
Total pot $20 | Rake $0
Seat 1: sVocLgrQLp4Ke1DJ2pbNKg (big blind) folded before Flop
Seat 2: 3nbnu02+Z7ZmECb/JLOUvg (button) (small blind) collected ($20)



PokerStars Game #59957946534:  Hold'em No Limit ($5/$10) - 2009/07/01 10:02:35 ET
Table 'IyraSBLp+yhyRE6/jd8spA' 2-max Seat #1 is the button
Seat 1: sVocLgrQLp4Ke1DJ2pbNKg ($1048.50 in chips)
Seat 2: 3nbnu02+Z7ZmECb/JLOUvg ($1052 in chips)
sVocLgrQLp4Ke1DJ2pbNKg: posts small blind $5
3nbnu02+Z7ZmECb/JLOUvg: posts big blind $10
*** HOLE CARDS ***
sVocLgrQLp4Ke1DJ2pbNKg: raises $10 to $20
3nbnu02+Z7ZmECb/JLOUvg: calls $10
*** FLOP *** [As Ah 5h]
3nbnu02+Z7ZmECb/JLOUvg: checks
sVocLgrQLp4Ke1DJ2pbNKg: checks
*** TURN *** [As Ah 5h] [5s]
3nbnu02+Z7ZmECb/JLOUvg: bets $20
sVocLgrQLp4Ke1DJ2pbNKg: calls $20
*** RIVER *** [As Ah 5h 5s] [8c]
3nbnu02+Z7ZmECb/JLOUvg: checks
sVocLgrQLp4Ke1DJ2pbNKg: checks
*** SHOW DOWN ***
3nbnu02+Z7ZmECb/JLOUvg: shows [4h 7h] (two pair, Aces and Fives)
sVocLgrQLp4Ke1DJ2pbNKg: shows [Kh Qs] (two pair, Aces and Fives - King kicker)
sVocLgrQLp4Ke1DJ2pbNKg collected $79.50 from pot
*** SUMMARY ***
Total pot $80 | Rake $0.50
Board [As Ah 5h 5s 8c]
Seat 1: sVocLgrQLp4Ke1DJ2pbNKg (button) (small blind) showed [Kh Qs] and won ($79.50) with two pair, Aces and Fives
Seat 2: 3nbnu02+Z7ZmECb/JLOUvg (big blind) showed [4h 7h] and lost with two pair, Aces and Fives



PokerStars Game #59957968130:  Hold'em No Limit ($5/$10) - 2009/07/01 10:03:03 ET
Table 'IyraSBLp+yhyRE6/jd8spA' 2-max Seat #2 is the button
Seat 1: sVocLgrQLp4Ke1DJ2pbNKg ($1088 in chips)
Seat 2: 3nbnu02+Z7ZmECb/JLOUvg ($1012 in chips)
3nbnu02+Z7ZmECb/JLOUvg: posts small blind $5
sVocLgrQLp4Ke1DJ2pbNKg: posts big blind $10
*** HOLE CARDS ***
3nbnu02+Z7ZmECb/JLOUvg: raises $20 to $30
sVocLgrQLp4Ke1DJ2pbNKg: folds
3nbnu02+Z7ZmECb/JLOUvg collected $20 from pot
*** SUMMARY ***
Total pot $20 | Rake $0
Seat 1: sVocLgrQLp4Ke1DJ2pbNKg (big blind) folded before Flop
Seat 2: 3nbnu02+Z7ZmECb/JLOUvg (button) (small blind) collected ($20)



PokerStars Game #59957974460:  Hold'em No Limit ($5/$10) - 2009/07/01 10:03:11 ET
Table 'IyraSBLp+yhyRE6/jd8spA' 2-max Seat #1 is the button
Seat 1: sVocLgrQLp4Ke1DJ2pbNKg ($1078 in chips)
Seat 2: 3nbnu02+Z7ZmECb/JLOUvg ($1022 in chips)
sVocLgrQLp4Ke1DJ2pbNKg: posts small blind $5
3nbnu02+Z7ZmECb/JLOUvg: posts big blind $10
*** HOLE CARDS ***
sVocLgrQLp4Ke1DJ2pbNKg: folds
3nbnu02+Z7ZmECb/JLOUvg collected $10 from pot
*** SUMMARY ***
Total pot $10 | Rake $0
Seat 1: sVocLgrQLp4Ke1DJ2pbNKg (button) (small blind) folded before Flop
Seat 2: 3nbnu02+Z7ZmECb/JLOUvg (big blind) collected ($10)



PokerStars Game #59957978578:  Hold'em No Limit ($5/$10) - 2009/07/01 10:03:17 ET
Table 'IyraSBLp+yhyRE6/jd8spA' 2-max Seat #2 is the button
Seat 1: sVocLgrQLp4Ke1DJ2pbNKg ($1073 in chips)
Seat 2: 3nbnu02+Z7ZmECb/JLOUvg ($1027 in chips)
3nbnu02+Z7ZmECb/JLOUvg: posts small blind $5
sVocLgrQLp4Ke1DJ2pbNKg: posts big blind $10
*** HOLE CARDS ***
3nbnu02+Z7ZmECb/JLOUvg: raises $20 to $30
sVocLgrQLp4Ke1DJ2pbNKg: folds
3nbnu02+Z7ZmECb/JLOUvg collected $20 from pot
*** SUMMARY ***
Total pot $20 | Rake $0
Seat 1: sVocLgrQLp4Ke1DJ2pbNKg (big blind) folded before Flop
Seat 2: 3nbnu02+Z7ZmECb/JLOUvg (button) (small blind) collected ($20)



PokerStars Game #59957986804:  Hold'em No Limit ($5/$10) - 2009/07/01 10:03:27 ET
Table 'IyraSBLp+yhyRE6/jd8spA' 2-max Seat #1 is the button
Seat 1: sVocLgrQLp4Ke1DJ2pbNKg ($1063 in chips)
Seat 2: 3nbnu02+Z7ZmECb/JLOUvg ($1037 in chips)
sVocLgrQLp4Ke1DJ2pbNKg: posts small blind $5
3nbnu02+Z7ZmECb/JLOUvg: posts big blind $10
*** HOLE CARDS ***
sVocLgrQLp4Ke1DJ2pbNKg: folds
3nbnu02+Z7ZmECb/JLOUvg collected $10 from pot
*** SUMMARY ***
Total pot $10 | Rake $0
Seat 1: sVocLgrQLp4Ke1DJ2pbNKg (button) (small blind) folded before Flop
Seat 2: 3nbnu02+Z7ZmECb/JLOUvg (big blind) collected ($10)



PokerStars Game #59957991676:  Hold'em No Limit ($5/$10) - 2009/07/01 10:03:33 ET
Table 'IyraSBLp+yhyRE6/jd8spA' 2-max Seat #2 is the button
Seat 1: sVocLgrQLp4Ke1DJ2pbNKg ($1058 in chips)
Seat 2: 3nbnu02+Z7ZmECb/JLOUvg ($1042 in chips)
3nbnu02+Z7ZmECb/JLOUvg: posts small blind $5
sVocLgrQLp4Ke1DJ2pbNKg: posts big blind $10
*** HOLE CARDS ***
3nbnu02+Z7ZmECb/JLOUvg: folds
sVocLgrQLp4Ke1DJ2pbNKg collected $10 from pot
*** SUMMARY ***
Total pot $10 | Rake $0
Seat 1: sVocLgrQLp4Ke1DJ2pbNKg (big blind) collected ($10)
Seat 2: 3nbnu02+Z7ZmECb/JLOUvg (button) (small blind) folded before Flop



PokerStars Game #59957997016:  Hold'em No Limit ($5/$10) - 2009/07/01 10:03:40 ET
Table 'IyraSBLp+yhyRE6/jd8spA' 2-max Seat #1 is the button
Seat 1: sVocLgrQLp4Ke1DJ2pbNKg ($1063 in chips)
Seat 2: 3nbnu02+Z7ZmECb/JLOUvg ($1037 in chips)
sVocLgrQLp4Ke1DJ2pbNKg: posts small blind $5
3nbnu02+Z7ZmECb/JLOUvg: posts big blind $10
*** HOLE CARDS ***
sVocLgrQLp4Ke1DJ2pbNKg: folds
3nbnu02+Z7ZmECb/JLOUvg collected $10 from pot
*** SUMMARY ***
Total pot $10 | Rake $0
Seat 1: sVocLgrQLp4Ke1DJ2pbNKg (button) (small blind) folded before Flop
Seat 2: 3nbnu02+Z7ZmECb/JLOUvg (big blind) collected ($10)



PokerStars Game #59958001364:  Hold'em No Limit ($5/$10) - 2009/07/01 10:03:46 ET
Table 'IyraSBLp+yhyRE6/jd8spA' 2-max Seat #2 is the button
Seat 1: sVocLgrQLp4Ke1DJ2pbNKg ($1058 in chips)
Seat 2: 3nbnu02+Z7ZmECb/JLOUvg ($1042 in chips)
3nbnu02+Z7ZmECb/JLOUvg: posts small blind $5
sVocLgrQLp4Ke1DJ2pbNKg: posts big blind $10
*** HOLE CARDS ***
3nbnu02+Z7ZmECb/JLOUvg: folds
sVocLgrQLp4Ke1DJ2pbNKg collected $10 from pot
*** SUMMARY ***
Total pot $10 | Rake $0
Seat 1: sVocLgrQLp4Ke1DJ2pbNKg (big blind) collected ($10)
Seat 2: 3nbnu02+Z7ZmECb/JLOUvg (button) (small blind) folded before Flop



PokerStars Game #59958006236:  Hold'em No Limit ($5/$10) - 2009/07/01 10:03:52 ET
Table 'IyraSBLp+yhyRE6/jd8spA' 2-max Seat #1 is the button
Seat 1: sVocLgrQLp4Ke1DJ2pbNKg ($1063 in chips)
Seat 2: 3nbnu02+Z7ZmECb/JLOUvg ($1037 in chips)
sVocLgrQLp4Ke1DJ2pbNKg: posts small blind $5
3nbnu02+Z7ZmECb/JLOUvg: posts big blind $10
*** HOLE CARDS ***
sVocLgrQLp4Ke1DJ2pbNKg: folds
3nbnu02+Z7ZmECb/JLOUvg collected $10 from pot
*** SUMMARY ***
Total pot $10 | Rake $0
Seat 1: sVocLgrQLp4Ke1DJ2pbNKg (button) (small blind) folded before Flop
Seat 2: 3nbnu02+Z7ZmECb/JLOUvg (big blind) collected ($10)



PokerStars Game #59958010448:  Hold'em No Limit ($5/$10) - 2009/07/01 10:03:58 ET
Table 'IyraSBLp+yhyRE6/jd8spA' 2-max Seat #2 is the button
Seat 1: sVocLgrQLp4Ke1DJ2pbNKg ($1058 in chips)
Seat 2: 3nbnu02+Z7ZmECb/JLOUvg ($1042 in chips)
3nbnu02+Z7ZmECb/JLOUvg: posts small blind $5
sVocLgrQLp4Ke1DJ2pbNKg: posts big blind $10
*** HOLE CARDS ***
3nbnu02+Z7ZmECb/JLOUvg: folds
sVocLgrQLp4Ke1DJ2pbNKg collected $10 from pot
*** SUMMARY ***
Total pot $10 | Rake $0
Seat 1: sVocLgrQLp4Ke1DJ2pbNKg (big blind) collected ($10)
Seat 2: 3nbnu02+Z7ZmECb/JLOUvg (button) (small blind) folded before Flop



PokerStars Game #59958015720:  Hold'em No Limit ($5/$10) - 2009/07/01 10:04:04 ET
Table 'IyraSBLp+yhyRE6/jd8spA' 2-max Seat #1 is the button
Seat 1: sVocLgrQLp4Ke1DJ2pbNKg ($1063 in chips)
Seat 2: 3nbnu02+Z7ZmECb/JLOUvg ($1037 in chips)
sVocLgrQLp4Ke1DJ2pbNKg: posts small blind $5
3nbnu02+Z7ZmECb/JLOUvg: posts big blind $10
*** HOLE CARDS ***
sVocLgrQLp4Ke1DJ2pbNKg: folds
3nbnu02+Z7ZmECb/JLOUvg collected $10 from pot
*** SUMMARY ***
Total pot $10 | Rake $0
Seat 1: sVocLgrQLp4Ke1DJ2pbNKg (button) (small blind) folded before Flop
Seat 2: 3nbnu02+Z7ZmECb/JLOUvg (big blind) collected ($10)



PokerStars Game #59958020754:  Hold'em No Limit ($5/$10) - 2009/07/01 10:04:10 ET
Table 'IyraSBLp+yhyRE6/jd8spA' 2-max Seat #2 is the button
Seat 1: sVocLgrQLp4Ke1DJ2pbNKg ($1058 in chips)
Seat 2: 3nbnu02+Z7ZmECb/JLOUvg ($1042 in chips)
3nbnu02+Z7ZmECb/JLOUvg: posts small blind $5
sVocLgrQLp4Ke1DJ2pbNKg: posts big blind $10
*** HOLE CARDS ***
3nbnu02+Z7ZmECb/JLOUvg: folds
sVocLgrQLp4Ke1DJ2pbNKg collected $10 from pot
*** SUMMARY ***
Total pot $10 | Rake $0
Seat 1: sVocLgrQLp4Ke1DJ2pbNKg (big blind) collected ($10)
Seat 2: 3nbnu02+Z7ZmECb/JLOUvg (button) (small blind) folded before Flop



PokerStars Game #59958029184:  Hold'em No Limit ($5/$10) - 2009/07/01 10:04:21 ET
Table 'IyraSBLp+yhyRE6/jd8spA' 2-max Seat #1 is the button
Seat 1: sVocLgrQLp4Ke1DJ2pbNKg ($1063 in chips)
Seat 2: 3nbnu02+Z7ZmECb/JLOUvg ($1037 in chips)
sVocLgrQLp4Ke1DJ2pbNKg: posts small blind $5
3nbnu02+Z7ZmECb/JLOUvg: posts big blind $10
*** HOLE CARDS ***
sVocLgrQLp4Ke1DJ2pbNKg: raises $10 to $20
3nbnu02+Z7ZmECb/JLOUvg: folds
sVocLgrQLp4Ke1DJ2pbNKg collected $20 from pot
sVocLgrQLp4Ke1DJ2pbNKg: doesn't show hand
*** SUMMARY ***
Total pot $20 | Rake $0
Seat 1: sVocLgrQLp4Ke1DJ2pbNKg (button) (small blind) collected ($20)
Seat 2: 3nbnu02+Z7ZmECb/JLOUvg (big blind) folded before Flop



PokerStars Game #59958034654:  Hold'em No Limit ($5/$10) - 2009/07/01 10:04:28 ET
Table 'IyraSBLp+yhyRE6/jd8spA' 2-max Seat #2 is the button
Seat 1: sVocLgrQLp4Ke1DJ2pbNKg ($1073 in chips)
Seat 2: 3nbnu02+Z7ZmECb/JLOUvg ($1027 in chips)
3nbnu02+Z7ZmECb/JLOUvg: posts small blind $5
sVocLgrQLp4Ke1DJ2pbNKg: posts big blind $10
*** HOLE CARDS ***
3nbnu02+Z7ZmECb/JLOUvg: raises $20 to $30
sVocLgrQLp4Ke1DJ2pbNKg: raises $70 to $100
3nbnu02+Z7ZmECb/JLOUvg: folds
sVocLgrQLp4Ke1DJ2pbNKg collected $60 from pot
sVocLgrQLp4Ke1DJ2pbNKg: doesn't show hand
*** SUMMARY ***
Total pot $60 | Rake $0
Seat 1: sVocLgrQLp4Ke1DJ2pbNKg (big blind) collected ($60)
Seat 2: 3nbnu02+Z7ZmECb/JLOUvg (button) (small blind) folded before Flop



PokerStars Game #59958043266:  Hold'em No Limit ($5/$10) - 2009/07/01 10:04:39 ET
Table 'IyraSBLp+yhyRE6/jd8spA' 2-max Seat #1 is the button
Seat 1: sVocLgrQLp4Ke1DJ2pbNKg ($1103 in chips)
Seat 2: 3nbnu02+Z7ZmECb/JLOUvg ($997 in chips)
sVocLgrQLp4Ke1DJ2pbNKg: posts small blind $5
3nbnu02+Z7ZmECb/JLOUvg: posts big blind $10
*** HOLE CARDS ***
sVocLgrQLp4Ke1DJ2pbNKg: folds
3nbnu02+Z7ZmECb/JLOUvg collected $10 from pot
*** SUMMARY ***
Total pot $10 | Rake $0
Seat 1: sVocLgrQLp4Ke1DJ2pbNKg (button) (small blind) folded before Flop
Seat 2: 3nbnu02+Z7ZmECb/JLOUvg (big blind) collected ($10)



PokerStars Game #59958047736:  Hold'em No Limit ($5/$10) - 2009/07/01 10:04:45 ET
Table 'IyraSBLp+yhyRE6/jd8spA' 2-max Seat #2 is the button
Seat 1: sVocLgrQLp4Ke1DJ2pbNKg ($1098 in chips)
Seat 2: 3nbnu02+Z7ZmECb/JLOUvg ($1002 in chips)
3nbnu02+Z7ZmECb/JLOUvg: posts small blind $5
sVocLgrQLp4Ke1DJ2pbNKg: posts big blind $10
*** HOLE CARDS ***
3nbnu02+Z7ZmECb/JLOUvg: raises $20 to $30
sVocLgrQLp4Ke1DJ2pbNKg: folds
3nbnu02+Z7ZmECb/JLOUvg collected $20 from pot
*** SUMMARY ***
Total pot $20 | Rake $0
Seat 1: sVocLgrQLp4Ke1DJ2pbNKg (big blind) folded before Flop
Seat 2: 3nbnu02+Z7ZmECb/JLOUvg (button) (small blind) collected ($20)



PokerStars Game #59958054378:  Hold'em No Limit ($5/$10) - 2009/07/01 10:04:54 ET
Table 'IyraSBLp+yhyRE6/jd8spA' 2-max Seat #1 is the button
Seat 1: sVocLgrQLp4Ke1DJ2pbNKg ($1088 in chips)
Seat 2: 3nbnu02+Z7ZmECb/JLOUvg ($1012 in chips)
sVocLgrQLp4Ke1DJ2pbNKg: posts small blind $5
3nbnu02+Z7ZmECb/JLOUvg: posts big blind $10
*** HOLE CARDS ***
sVocLgrQLp4Ke1DJ2pbNKg: raises $10 to $20
3nbnu02+Z7ZmECb/JLOUvg: raises $50 to $70
sVocLgrQLp4Ke1DJ2pbNKg: folds
3nbnu02+Z7ZmECb/JLOUvg collected $40 from pot
*** SUMMARY ***
Total pot $40 | Rake $0
Seat 1: sVocLgrQLp4Ke1DJ2pbNKg (button) (small blind) folded before Flop
Seat 2: 3nbnu02+Z7ZmECb/JLOUvg (big blind) collected ($40)



PokerStars Game #59958065472:  Hold'em No Limit ($5/$10) - 2009/07/01 10:05:07 ET
Table 'IyraSBLp+yhyRE6/jd8spA' 2-max Seat #2 is the button
Seat 1: sVocLgrQLp4Ke1DJ2pbNKg ($1068 in chips)
Seat 2: 3nbnu02+Z7ZmECb/JLOUvg ($1032 in chips)
3nbnu02+Z7ZmECb/JLOUvg: posts small blind $5
sVocLgrQLp4Ke1DJ2pbNKg: posts big blind $10
*** HOLE CARDS ***
3nbnu02+Z7ZmECb/JLOUvg: raises $20 to $30
sVocLgrQLp4Ke1DJ2pbNKg: folds
3nbnu02+Z7ZmECb/JLOUvg collected $20 from pot
*** SUMMARY ***
Total pot $20 | Rake $0
Seat 1: sVocLgrQLp4Ke1DJ2pbNKg (big blind) folded before Flop
Seat 2: 3nbnu02+Z7ZmECb/JLOUvg (button) (small blind) collected ($20)



PokerStars Game #59958072460:  Hold'em No Limit ($5/$10) - 2009/07/01 10:05:16 ET
Table 'IyraSBLp+yhyRE6/jd8spA' 2-max Seat #1 is the button
Seat 1: sVocLgrQLp4Ke1DJ2pbNKg ($1058 in chips)
Seat 2: 3nbnu02+Z7ZmECb/JLOUvg ($1042 in chips)
sVocLgrQLp4Ke1DJ2pbNKg: posts small blind $5
3nbnu02+Z7ZmECb/JLOUvg: posts big blind $10
*** HOLE CARDS ***
sVocLgrQLp4Ke1DJ2pbNKg: raises $10 to $20
3nbnu02+Z7ZmECb/JLOUvg: folds
sVocLgrQLp4Ke1DJ2pbNKg collected $20 from pot
sVocLgrQLp4Ke1DJ2pbNKg: doesn't show hand
*** SUMMARY ***
Total pot $20 | Rake $0
Seat 1: sVocLgrQLp4Ke1DJ2pbNKg (button) (small blind) collected ($20)
Seat 2: 3nbnu02+Z7ZmECb/JLOUvg (big blind) folded before Flop



PokerStars Game #59958077778:  Hold'em No Limit ($5/$10) - 2009/07/01 10:05:23 ET
Table 'IyraSBLp+yhyRE6/jd8spA' 2-max Seat #2 is the button
Seat 1: sVocLgrQLp4Ke1DJ2pbNKg ($1068 in chips)
Seat 2: 3nbnu02+Z7ZmECb/JLOUvg ($1032 in chips)
3nbnu02+Z7ZmECb/JLOUvg: posts small blind $5
sVocLgrQLp4Ke1DJ2pbNKg: posts big blind $10
*** HOLE CARDS ***
3nbnu02+Z7ZmECb/JLOUvg: raises $20 to $30
sVocLgrQLp4Ke1DJ2pbNKg: folds
3nbnu02+Z7ZmECb/JLOUvg collected $20 from pot
*** SUMMARY ***
Total pot $20 | Rake $0
Seat 1: sVocLgrQLp4Ke1DJ2pbNKg (big blind) folded before Flop
Seat 2: 3nbnu02+Z7ZmECb/JLOUvg (button) (small blind) collected ($20)



PokerStars Game #59958084900:  Hold'em No Limit ($5/$10) - 2009/07/01 10:05:32 ET
Table 'IyraSBLp+yhyRE6/jd8spA' 2-max Seat #1 is the button
Seat 1: sVocLgrQLp4Ke1DJ2pbNKg ($1058 in chips)
Seat 2: 3nbnu02+Z7ZmECb/JLOUvg ($1042 in chips)
sVocLgrQLp4Ke1DJ2pbNKg: posts small blind $5
3nbnu02+Z7ZmECb/JLOUvg: posts big blind $10
*** HOLE CARDS ***
sVocLgrQLp4Ke1DJ2pbNKg: folds
3nbnu02+Z7ZmECb/JLOUvg collected $10 from pot
*** SUMMARY ***
Total pot $10 | Rake $0
Seat 1: sVocLgrQLp4Ke1DJ2pbNKg (button) (small blind) folded before Flop
Seat 2: 3nbnu02+Z7ZmECb/JLOUvg (big blind) collected ($10)



PokerStars Game #59958089310:  Hold'em No Limit ($5/$10) - 2009/07/01 10:05:38 ET
Table 'IyraSBLp+yhyRE6/jd8spA' 2-max Seat #2 is the button
Seat 1: sVocLgrQLp4Ke1DJ2pbNKg ($1053 in chips)
Seat 2: 3nbnu02+Z7ZmECb/JLOUvg ($1047 in chips)
3nbnu02+Z7ZmECb/JLOUvg: posts small blind $5
sVocLgrQLp4Ke1DJ2pbNKg: posts big blind $10
*** HOLE CARDS ***
3nbnu02+Z7ZmECb/JLOUvg: raises $20 to $30
sVocLgrQLp4Ke1DJ2pbNKg: folds
3nbnu02+Z7ZmECb/JLOUvg collected $20 from pot
*** SUMMARY ***
Total pot $20 | Rake $0
Seat 1: sVocLgrQLp4Ke1DJ2pbNKg (big blind) folded before Flop
Seat 2: 3nbnu02+Z7ZmECb/JLOUvg (button) (small blind) collected ($20)



PokerStars Game #59958094760:  Hold'em No Limit ($5/$10) - 2009/07/01 10:05:45 ET
Table 'IyraSBLp+yhyRE6/jd8spA' 2-max Seat #1 is the button
Seat 1: sVocLgrQLp4Ke1DJ2pbNKg ($1043 in chips)
Seat 2: 3nbnu02+Z7ZmECb/JLOUvg ($1057 in chips)
sVocLgrQLp4Ke1DJ2pbNKg: posts small blind $5
3nbnu02+Z7ZmECb/JLOUvg: posts big blind $10
*** HOLE CARDS ***
sVocLgrQLp4Ke1DJ2pbNKg: raises $10 to $20
3nbnu02+Z7ZmECb/JLOUvg: folds
sVocLgrQLp4Ke1DJ2pbNKg collected $20 from pot
sVocLgrQLp4Ke1DJ2pbNKg: doesn't show hand
*** SUMMARY ***
Total pot $20 | Rake $0
Seat 1: sVocLgrQLp4Ke1DJ2pbNKg (button) (small blind) collected ($20)
Seat 2: 3nbnu02+Z7ZmECb/JLOUvg (big blind) folded before Flop



PokerStars Game #59958101066:  Hold'em No Limit ($5/$10) - 2009/07/01 10:05:53 ET
Table 'IyraSBLp+yhyRE6/jd8spA' 2-max Seat #2 is the button
Seat 1: sVocLgrQLp4Ke1DJ2pbNKg ($1053 in chips)
Seat 2: 3nbnu02+Z7ZmECb/JLOUvg ($1047 in chips)
3nbnu02+Z7ZmECb/JLOUvg: posts small blind $5
sVocLgrQLp4Ke1DJ2pbNKg: posts big blind $10
*** HOLE CARDS ***
3nbnu02+Z7ZmECb/JLOUvg: raises $20 to $30
sVocLgrQLp4Ke1DJ2pbNKg: folds
3nbnu02+Z7ZmECb/JLOUvg collected $20 from pot
*** SUMMARY ***
Total pot $20 | Rake $0
Seat 1: sVocLgrQLp4Ke1DJ2pbNKg (big blind) folded before Flop
Seat 2: 3nbnu02+Z7ZmECb/JLOUvg (button) (small blind) collected ($20)



PokerStars Game #59958109070:  Hold'em No Limit ($5/$10) - 2009/07/01 10:06:03 ET
Table 'IyraSBLp+yhyRE6/jd8spA' 2-max Seat #1 is the button
Seat 1: sVocLgrQLp4Ke1DJ2pbNKg ($1043 in chips)
Seat 2: 3nbnu02+Z7ZmECb/JLOUvg ($1057 in chips)
sVocLgrQLp4Ke1DJ2pbNKg: posts small blind $5
3nbnu02+Z7ZmECb/JLOUvg: posts big blind $10
*** HOLE CARDS ***
sVocLgrQLp4Ke1DJ2pbNKg: raises $10 to $20
3nbnu02+Z7ZmECb/JLOUvg: calls $10
*** FLOP *** [4d Qs 4h]
3nbnu02+Z7ZmECb/JLOUvg: checks
sVocLgrQLp4Ke1DJ2pbNKg: checks
*** TURN *** [4d Qs 4h] [Th]
3nbnu02+Z7ZmECb/JLOUvg: checks
sVocLgrQLp4Ke1DJ2pbNKg: checks
*** RIVER *** [4d Qs 4h Th] [6c]
3nbnu02+Z7ZmECb/JLOUvg: checks
sVocLgrQLp4Ke1DJ2pbNKg: checks
*** SHOW DOWN ***
3nbnu02+Z7ZmECb/JLOUvg: shows [9d Kd] (a pair of Fours)
sVocLgrQLp4Ke1DJ2pbNKg: mucks hand
3nbnu02+Z7ZmECb/JLOUvg collected $39.50 from pot
*** SUMMARY ***
Total pot $40 | Rake $0.50
Board [4d Qs 4h Th 6c]
Seat 1: sVocLgrQLp4Ke1DJ2pbNKg (button) (small blind) mucked
Seat 2: 3nbnu02+Z7ZmECb/JLOUvg (big blind) showed [9d Kd] and won ($39.50) with a pair of Fours



PokerStars Game #59958130030:  Hold'em No Limit ($5/$10) - 2009/07/01 10:06:30 ET
Table 'IyraSBLp+yhyRE6/jd8spA' 2-max Seat #2 is the button
Seat 1: sVocLgrQLp4Ke1DJ2pbNKg ($1023 in chips)
Seat 2: 3nbnu02+Z7ZmECb/JLOUvg ($1076.50 in chips)
3nbnu02+Z7ZmECb/JLOUvg: posts small blind $5
sVocLgrQLp4Ke1DJ2pbNKg: posts big blind $10
*** HOLE CARDS ***
3nbnu02+Z7ZmECb/JLOUvg: raises $20 to $30
sVocLgrQLp4Ke1DJ2pbNKg: folds
3nbnu02+Z7ZmECb/JLOUvg collected $20 from pot
*** SUMMARY ***
Total pot $20 | Rake $0
Seat 1: sVocLgrQLp4Ke1DJ2pbNKg (big blind) folded before Flop
Seat 2: 3nbnu02+Z7ZmECb/JLOUvg (button) (small blind) collected ($20)



PokerStars Game #59958141694:  Hold'em No Limit ($5/$10) - 2009/07/01 10:06:45 ET
Table 'IyraSBLp+yhyRE6/jd8spA' 2-max Seat #1 is the button
Seat 1: sVocLgrQLp4Ke1DJ2pbNKg ($1013 in chips)
Seat 2: 3nbnu02+Z7ZmECb/JLOUvg ($1086.50 in chips)
sVocLgrQLp4Ke1DJ2pbNKg: posts small blind $5
3nbnu02+Z7ZmECb/JLOUvg: posts big blind $10
*** HOLE CARDS ***
sVocLgrQLp4Ke1DJ2pbNKg: folds
3nbnu02+Z7ZmECb/JLOUvg collected $10 from pot
*** SUMMARY ***
Total pot $10 | Rake $0
Seat 1: sVocLgrQLp4Ke1DJ2pbNKg (button) (small blind) folded before Flop
Seat 2: 3nbnu02+Z7ZmECb/JLOUvg (big blind) collected ($10)



PokerStars Game #59958146484:  Hold'em No Limit ($5/$10) - 2009/07/01 10:06:51 ET
Table 'IyraSBLp+yhyRE6/jd8spA' 2-max Seat #2 is the button
Seat 1: sVocLgrQLp4Ke1DJ2pbNKg ($1008 in chips)
Seat 2: 3nbnu02+Z7ZmECb/JLOUvg ($1091.50 in chips)
3nbnu02+Z7ZmECb/JLOUvg: posts small blind $5
sVocLgrQLp4Ke1DJ2pbNKg: posts big blind $10
*** HOLE CARDS ***
3nbnu02+Z7ZmECb/JLOUvg: folds
sVocLgrQLp4Ke1DJ2pbNKg collected $10 from pot
sVocLgrQLp4Ke1DJ2pbNKg: doesn't show hand
*** SUMMARY ***
Total pot $10 | Rake $0
Seat 1: sVocLgrQLp4Ke1DJ2pbNKg (big blind) collected ($10)
Seat 2: 3nbnu02+Z7ZmECb/JLOUvg (button) (small blind) folded before Flop



PokerStars Game #59958150886:  Hold'em No Limit ($5/$10) - 2009/07/01 10:06:57 ET
Table 'IyraSBLp+yhyRE6/jd8spA' 2-max Seat #1 is the button
Seat 1: sVocLgrQLp4Ke1DJ2pbNKg ($1013 in chips)
Seat 2: 3nbnu02+Z7ZmECb/JLOUvg ($1086.50 in chips)
sVocLgrQLp4Ke1DJ2pbNKg: posts small blind $5
3nbnu02+Z7ZmECb/JLOUvg: posts big blind $10
*** HOLE CARDS ***
sVocLgrQLp4Ke1DJ2pbNKg: raises $10 to $20
3nbnu02+Z7ZmECb/JLOUvg: folds
sVocLgrQLp4Ke1DJ2pbNKg collected $20 from pot
sVocLgrQLp4Ke1DJ2pbNKg: doesn't show hand
*** SUMMARY ***
Total pot $20 | Rake $0
Seat 1: sVocLgrQLp4Ke1DJ2pbNKg (button) (small blind) collected ($20)
Seat 2: 3nbnu02+Z7ZmECb/JLOUvg (big blind) folded before Flop



PokerStars Game #59958156504:  Hold'em No Limit ($5/$10) - 2009/07/01 10:07:04 ET
Table 'IyraSBLp+yhyRE6/jd8spA' 2-max Seat #2 is the button
Seat 1: sVocLgrQLp4Ke1DJ2pbNKg ($1023 in chips)
Seat 2: 3nbnu02+Z7ZmECb/JLOUvg ($1076.50 in chips)
3nbnu02+Z7ZmECb/JLOUvg: posts small blind $5
sVocLgrQLp4Ke1DJ2pbNKg: posts big blind $10
*** HOLE CARDS ***
3nbnu02+Z7ZmECb/JLOUvg: folds
sVocLgrQLp4Ke1DJ2pbNKg collected $10 from pot
sVocLgrQLp4Ke1DJ2pbNKg: doesn't show hand
*** SUMMARY ***
Total pot $10 | Rake $0
Seat 1: sVocLgrQLp4Ke1DJ2pbNKg (big blind) collected ($10)
Seat 2: 3nbnu02+Z7ZmECb/JLOUvg (button) (small blind) folded before Flop



PokerStars Game #59958161114:  Hold'em No Limit ($5/$10) - 2009/07/01 10:07:09 ET
Table 'IyraSBLp+yhyRE6/jd8spA' 2-max Seat #1 is the button
Seat 1: sVocLgrQLp4Ke1DJ2pbNKg ($1028 in chips)
Seat 2: 3nbnu02+Z7ZmECb/JLOUvg ($1071.50 in chips)
sVocLgrQLp4Ke1DJ2pbNKg: posts small blind $5
3nbnu02+Z7ZmECb/JLOUvg: posts big blind $10
*** HOLE CARDS ***
sVocLgrQLp4Ke1DJ2pbNKg: raises $10 to $20
3nbnu02+Z7ZmECb/JLOUvg: raises $50 to $70
sVocLgrQLp4Ke1DJ2pbNKg: raises $110 to $180
3nbnu02+Z7ZmECb/JLOUvg: folds
sVocLgrQLp4Ke1DJ2pbNKg collected $140 from pot
sVocLgrQLp4Ke1DJ2pbNKg: doesn't show hand
*** SUMMARY ***
Total pot $140 | Rake $0
Seat 1: sVocLgrQLp4Ke1DJ2pbNKg (button) (small blind) collected ($140)
Seat 2: 3nbnu02+Z7ZmECb/JLOUvg (big blind) folded before Flop



PokerStars Game #59958163670:  Hold'em No Limit ($5/$10) - 2009/07/01 10:07:13 ET
Table 'wzNFj5MQqlxqCMWZS8AYXg' 2-max Seat #2 is the button
Seat 1: qqhtVDUyt/YmQrIDXT9oXw ($1064 in chips)
Seat 2: lhkk4tvkAIWjBBrsHuNe/A ($1000 in chips)
lhkk4tvkAIWjBBrsHuNe/A: posts small blind $5
qqhtVDUyt/YmQrIDXT9oXw: posts big blind $10
*** HOLE CARDS ***
lhkk4tvkAIWjBBrsHuNe/A: folds
qqhtVDUyt/YmQrIDXT9oXw collected $10 from pot
qqhtVDUyt/YmQrIDXT9oXw: doesn't show hand
*** SUMMARY ***
Total pot $10 | Rake $0
Seat 1: qqhtVDUyt/YmQrIDXT9oXw (big blind) collected ($10)
Seat 2: lhkk4tvkAIWjBBrsHuNe/A (button) (small blind) folded before Flop



PokerStars Game #59958173094:  Hold'em No Limit ($5/$10) - 2009/07/01 10:07:25 ET
Table 'IyraSBLp+yhyRE6/jd8spA' 2-max Seat #2 is the button
Seat 1: sVocLgrQLp4Ke1DJ2pbNKg ($1098 in chips)
Seat 2: 3nbnu02+Z7ZmECb/JLOUvg ($1001.50 in chips)
3nbnu02+Z7ZmECb/JLOUvg: posts small blind $5
sVocLgrQLp4Ke1DJ2pbNKg: posts big blind $10
*** HOLE CARDS ***
3nbnu02+Z7ZmECb/JLOUvg: folds
3nbnu02+Z7ZmECb/JLOUvg leaves the table
sVocLgrQLp4Ke1DJ2pbNKg collected $10 from pot
sVocLgrQLp4Ke1DJ2pbNKg: doesn't show hand
*** SUMMARY ***
Total pot $10 | Rake $0
Seat 1: sVocLgrQLp4Ke1DJ2pbNKg (big blind) collected ($10)
Seat 2: 3nbnu02+Z7ZmECb/JLOUvg (button) (small blind) folded before Flop



PokerStars Game #59958176538:  Hold'em No Limit ($5/$10) - 2009/07/01 10:07:29 ET
Table 'wzNFj5MQqlxqCMWZS8AYXg' 2-max Seat #1 is the button
Seat 1: qqhtVDUyt/YmQrIDXT9oXw ($1069 in chips)
Seat 2: lhkk4tvkAIWjBBrsHuNe/A ($1000 in chips)
qqhtVDUyt/YmQrIDXT9oXw: posts small blind $5
lhkk4tvkAIWjBBrsHuNe/A: posts big blind $10
*** HOLE CARDS ***
qqhtVDUyt/YmQrIDXT9oXw: raises $20 to $30
lhkk4tvkAIWjBBrsHuNe/A: folds
qqhtVDUyt/YmQrIDXT9oXw collected $20 from pot
qqhtVDUyt/YmQrIDXT9oXw: doesn't show hand
*** SUMMARY ***
Total pot $20 | Rake $0
Seat 1: qqhtVDUyt/YmQrIDXT9oXw (button) (small blind) collected ($20)
Seat 2: lhkk4tvkAIWjBBrsHuNe/A (big blind) folded before Flop



PokerStars Game #59958183218:  Hold'em No Limit ($5/$10) - 2009/07/01 10:07:38 ET
Table 'wzNFj5MQqlxqCMWZS8AYXg' 2-max Seat #2 is the button
Seat 1: qqhtVDUyt/YmQrIDXT9oXw ($1079 in chips)
Seat 2: lhkk4tvkAIWjBBrsHuNe/A ($1000 in chips)
lhkk4tvkAIWjBBrsHuNe/A: posts small blind $5
qqhtVDUyt/YmQrIDXT9oXw: posts big blind $10
*** HOLE CARDS ***
lhkk4tvkAIWjBBrsHuNe/A: raises $10 to $20
qqhtVDUyt/YmQrIDXT9oXw: calls $10
*** FLOP *** [5d 4c Ks]
qqhtVDUyt/YmQrIDXT9oXw: bets $30
lhkk4tvkAIWjBBrsHuNe/A: folds
qqhtVDUyt/YmQrIDXT9oXw collected $39.50 from pot
qqhtVDUyt/YmQrIDXT9oXw: doesn't show hand
*** SUMMARY ***
Total pot $40 | Rake $0.50
Board [5d 4c Ks]
Seat 1: qqhtVDUyt/YmQrIDXT9oXw (big blind) collected ($39.50)
Seat 2: lhkk4tvkAIWjBBrsHuNe/A (button) (small blind) folded on the Flop



PokerStars Game #59958192006:  Hold'em No Limit ($5/$10) - 2009/07/01 10:07:49 ET
Table '2a86NK3xhs21kwGZmbj0QA' 6-max Seat #5 is the button
Seat 1: NczJqEIUdrpEc5Nbd7h1Ig ($329 in chips)
Seat 2: Xl+I49lxCJwPGRuegiaHoA ($1000 in chips)
Seat 3: voSAIKXtXUUbJnds83sYfQ ($1224 in chips)
Seat 4: H/55aK4Sgl3B8A9bHghYVQ ($653.25 in chips)
Seat 5: jkH6qYMpn8JA/IyBOhQPMw ($1880 in chips)
Seat 6: ovpz8iX9p4XQ/6AFQrnDTw ($520.30 in chips)
ovpz8iX9p4XQ/6AFQrnDTw: posts small blind $5
NczJqEIUdrpEc5Nbd7h1Ig: posts big blind $10
*** HOLE CARDS ***
Xl+I49lxCJwPGRuegiaHoA: folds
voSAIKXtXUUbJnds83sYfQ: folds
H/55aK4Sgl3B8A9bHghYVQ: raises $20 to $30
jkH6qYMpn8JA/IyBOhQPMw: folds
ovpz8iX9p4XQ/6AFQrnDTw: folds
NczJqEIUdrpEc5Nbd7h1Ig: calls $20
*** FLOP *** [3h Th 8c]
NczJqEIUdrpEc5Nbd7h1Ig: checks
H/55aK4Sgl3B8A9bHghYVQ: bets $50
NczJqEIUdrpEc5Nbd7h1Ig: folds
H/55aK4Sgl3B8A9bHghYVQ collected $62 from pot
*** SUMMARY ***
Total pot $65 | Rake $3
Board [3h Th 8c]
Seat 1: NczJqEIUdrpEc5Nbd7h1Ig (big blind) folded on the Flop
Seat 2: Xl+I49lxCJwPGRuegiaHoA folded before Flop (didn't bet)
Seat 3: voSAIKXtXUUbJnds83sYfQ folded before Flop (didn't bet)
Seat 4: H/55aK4Sgl3B8A9bHghYVQ collected ($62)
Seat 5: jkH6qYMpn8JA/IyBOhQPMw (button) folded before Flop (didn't bet)
Seat 6: ovpz8iX9p4XQ/6AFQrnDTw (small blind) folded before Flop



PokerStars Game #59958194012:  Hold'em No Limit ($5/$10) - 2009/07/01 10:07:52 ET
Table 'wzNFj5MQqlxqCMWZS8AYXg' 2-max Seat #1 is the button
Seat 1: qqhtVDUyt/YmQrIDXT9oXw ($1098.50 in chips)
Seat 2: lhkk4tvkAIWjBBrsHuNe/A ($1000 in chips)
qqhtVDUyt/YmQrIDXT9oXw: posts small blind $5
lhkk4tvkAIWjBBrsHuNe/A: posts big blind $10
*** HOLE CARDS ***
qqhtVDUyt/YmQrIDXT9oXw: raises $10 to $20
lhkk4tvkAIWjBBrsHuNe/A: folds
qqhtVDUyt/YmQrIDXT9oXw collected $20 from pot
qqhtVDUyt/YmQrIDXT9oXw: doesn't show hand
*** SUMMARY ***
Total pot $20 | Rake $0
Seat 1: qqhtVDUyt/YmQrIDXT9oXw (button) (small blind) collected ($20)
Seat 2: lhkk4tvkAIWjBBrsHuNe/A (big blind) folded before Flop



PokerStars Game #59958204084:  Hold'em No Limit ($5/$10) - 2009/07/01 10:08:04 ET
Table 'wzNFj5MQqlxqCMWZS8AYXg' 2-max Seat #2 is the button
Seat 1: qqhtVDUyt/YmQrIDXT9oXw ($1108.50 in chips)
Seat 2: lhkk4tvkAIWjBBrsHuNe/A ($1000 in chips)
lhkk4tvkAIWjBBrsHuNe/A: posts small blind $5
qqhtVDUyt/YmQrIDXT9oXw: posts big blind $10
*** HOLE CARDS ***
lhkk4tvkAIWjBBrsHuNe/A: raises $20 to $30
qqhtVDUyt/YmQrIDXT9oXw: folds
lhkk4tvkAIWjBBrsHuNe/A collected $20 from pot
lhkk4tvkAIWjBBrsHuNe/A: doesn't show hand
*** SUMMARY ***
Total pot $20 | Rake $0
Seat 1: qqhtVDUyt/YmQrIDXT9oXw (big blind) folded before Flop
Seat 2: lhkk4tvkAIWjBBrsHuNe/A (button) (small blind) collected ($20)



PokerStars Game #59958220548:  Hold'em No Limit ($5/$10) - 2009/07/01 10:08:25 ET
Table '2a86NK3xhs21kwGZmbj0QA' 6-max Seat #6 is the button
Seat 1: NczJqEIUdrpEc5Nbd7h1Ig ($299 in chips)
Seat 2: Xl+I49lxCJwPGRuegiaHoA ($1000 in chips)
Seat 3: voSAIKXtXUUbJnds83sYfQ ($1224 in chips)
Seat 4: H/55aK4Sgl3B8A9bHghYVQ ($685.25 in chips)
Seat 5: jkH6qYMpn8JA/IyBOhQPMw ($1880 in chips)
Seat 6: ovpz8iX9p4XQ/6AFQrnDTw ($515.30 in chips)
NczJqEIUdrpEc5Nbd7h1Ig: posts small blind $5
Xl+I49lxCJwPGRuegiaHoA: posts big blind $10
*** HOLE CARDS ***
voSAIKXtXUUbJnds83sYfQ: folds
H/55aK4Sgl3B8A9bHghYVQ: folds
jkH6qYMpn8JA/IyBOhQPMw: raises $20 to $30
ovpz8iX9p4XQ/6AFQrnDTw: folds
NczJqEIUdrpEc5Nbd7h1Ig: folds
Xl+I49lxCJwPGRuegiaHoA: folds
jkH6qYMpn8JA/IyBOhQPMw collected $25 from pot
jkH6qYMpn8JA/IyBOhQPMw: doesn't show hand
*** SUMMARY ***
Total pot $25 | Rake $0
Seat 1: NczJqEIUdrpEc5Nbd7h1Ig (small blind) folded before Flop
Seat 2: Xl+I49lxCJwPGRuegiaHoA (big blind) folded before Flop
Seat 3: voSAIKXtXUUbJnds83sYfQ folded before Flop (didn't bet)
Seat 4: H/55aK4Sgl3B8A9bHghYVQ folded before Flop (didn't bet)
Seat 5: jkH6qYMpn8JA/IyBOhQPMw collected ($25)
Seat 6: ovpz8iX9p4XQ/6AFQrnDTw (button) folded before Flop (didn't bet)



PokerStars Game #59958235330:  Hold'em No Limit ($5/$10) - 2009/07/01 10:08:44 ET
Table '2a86NK3xhs21kwGZmbj0QA' 6-max Seat #1 is the button
Seat 1: NczJqEIUdrpEc5Nbd7h1Ig ($294 in chips)
Seat 2: Xl+I49lxCJwPGRuegiaHoA ($1000 in chips)
Seat 3: voSAIKXtXUUbJnds83sYfQ ($1224 in chips)
Seat 4: H/55aK4Sgl3B8A9bHghYVQ ($685.25 in chips)
Seat 5: jkH6qYMpn8JA/IyBOhQPMw ($1895 in chips)
Seat 6: ovpz8iX9p4XQ/6AFQrnDTw ($515.30 in chips)
Xl+I49lxCJwPGRuegiaHoA: posts small blind $5
voSAIKXtXUUbJnds83sYfQ: posts big blind $10
*** HOLE CARDS ***
H/55aK4Sgl3B8A9bHghYVQ: folds
jkH6qYMpn8JA/IyBOhQPMw: folds
ovpz8iX9p4XQ/6AFQrnDTw: folds
NczJqEIUdrpEc5Nbd7h1Ig: calls $10
Xl+I49lxCJwPGRuegiaHoA: folds
voSAIKXtXUUbJnds83sYfQ: checks
*** FLOP *** [Ad 5s 7s]
voSAIKXtXUUbJnds83sYfQ: checks
NczJqEIUdrpEc5Nbd7h1Ig: bets $30
voSAIKXtXUUbJnds83sYfQ: folds
NczJqEIUdrpEc5Nbd7h1Ig collected $23.75 from pot
*** SUMMARY ***
Total pot $25 | Rake $1.25
Board [Ad 5s 7s]
Seat 1: NczJqEIUdrpEc5Nbd7h1Ig (button) collected ($23.75)
Seat 2: Xl+I49lxCJwPGRuegiaHoA (small blind) folded before Flop
Seat 3: voSAIKXtXUUbJnds83sYfQ (big blind) folded on the Flop
Seat 4: H/55aK4Sgl3B8A9bHghYVQ folded before Flop (didn't bet)
Seat 5: jkH6qYMpn8JA/IyBOhQPMw folded before Flop (didn't bet)
Seat 6: ovpz8iX9p4XQ/6AFQrnDTw folded before Flop (didn't bet)



PokerStars Game #59958257518:  Hold'em No Limit ($5/$10) - 2009/07/01 10:09:12 ET
Table '2a86NK3xhs21kwGZmbj0QA' 6-max Seat #2 is the button
Seat 1: NczJqEIUdrpEc5Nbd7h1Ig ($307.75 in chips)
Seat 2: Xl+I49lxCJwPGRuegiaHoA ($1000 in chips)
Seat 3: voSAIKXtXUUbJnds83sYfQ ($1214 in chips)
Seat 4: H/55aK4Sgl3B8A9bHghYVQ ($685.25 in chips)
Seat 5: jkH6qYMpn8JA/IyBOhQPMw ($1895 in chips)
Seat 6: ovpz8iX9p4XQ/6AFQrnDTw ($515.30 in chips)
voSAIKXtXUUbJnds83sYfQ: posts small blind $5
H/55aK4Sgl3B8A9bHghYVQ: posts big blind $10
*** HOLE CARDS ***
jkH6qYMpn8JA/IyBOhQPMw: folds
ovpz8iX9p4XQ/6AFQrnDTw: folds
NczJqEIUdrpEc5Nbd7h1Ig: raises $20 to $30
Xl+I49lxCJwPGRuegiaHoA: folds
voSAIKXtXUUbJnds83sYfQ: folds
H/55aK4Sgl3B8A9bHghYVQ: raises $40 to $70
NczJqEIUdrpEc5Nbd7h1Ig: raises $237.75 to $307.75 and is all-in
H/55aK4Sgl3B8A9bHghYVQ: calls $237.75
*** FLOP *** [2h Th Tc]
*** TURN *** [2h Th Tc] [3c]
*** RIVER *** [2h Th Tc 3c] [7s]
*** SHOW DOWN ***
H/55aK4Sgl3B8A9bHghYVQ: shows [6s 6d] (two pair, Tens and Sixes)
NczJqEIUdrpEc5Nbd7h1Ig: mucks hand
H/55aK4Sgl3B8A9bHghYVQ collected $617.50 from pot
*** SUMMARY ***
Total pot $620.50 | Rake $3
Board [2h Th Tc 3c 7s]
Seat 1: NczJqEIUdrpEc5Nbd7h1Ig mucked
Seat 2: Xl+I49lxCJwPGRuegiaHoA (button) folded before Flop (didn't bet)
Seat 3: voSAIKXtXUUbJnds83sYfQ (small blind) folded before Flop
Seat 4: H/55aK4Sgl3B8A9bHghYVQ (big blind) showed [6s 6d] and won ($617.50) with two pair, Tens and Sixes
Seat 5: jkH6qYMpn8JA/IyBOhQPMw folded before Flop (didn't bet)
Seat 6: ovpz8iX9p4XQ/6AFQrnDTw folded before Flop (didn't bet)



PokerStars Game #59958293786:  Hold'em No Limit ($5/$10) - 2009/07/01 10:09:58 ET
Table '2a86NK3xhs21kwGZmbj0QA' 6-max Seat #3 is the button
Seat 2: Xl+I49lxCJwPGRuegiaHoA ($1000 in chips)
Seat 3: voSAIKXtXUUbJnds83sYfQ ($1209 in chips)
Seat 4: H/55aK4Sgl3B8A9bHghYVQ ($995 in chips)
Seat 5: jkH6qYMpn8JA/IyBOhQPMw ($1895 in chips)
Seat 6: ovpz8iX9p4XQ/6AFQrnDTw ($515.30 in chips)
H/55aK4Sgl3B8A9bHghYVQ: posts small blind $5
jkH6qYMpn8JA/IyBOhQPMw: posts big blind $10
*** HOLE CARDS ***
ovpz8iX9p4XQ/6AFQrnDTw: folds
Xl+I49lxCJwPGRuegiaHoA: folds
voSAIKXtXUUbJnds83sYfQ: folds
H/55aK4Sgl3B8A9bHghYVQ: raises $10 to $20
jkH6qYMpn8JA/IyBOhQPMw: raises $70 to $90
NczJqEIUdrpEc5Nbd7h1Ig has returned
H/55aK4Sgl3B8A9bHghYVQ: folds
jkH6qYMpn8JA/IyBOhQPMw collected $40 from pot
jkH6qYMpn8JA/IyBOhQPMw: doesn't show hand
*** SUMMARY ***
Total pot $40 | Rake $0
Seat 2: Xl+I49lxCJwPGRuegiaHoA folded before Flop (didn't bet)
Seat 3: voSAIKXtXUUbJnds83sYfQ (button) folded before Flop (didn't bet)
Seat 4: H/55aK4Sgl3B8A9bHghYVQ (small blind) folded before Flop
Seat 5: jkH6qYMpn8JA/IyBOhQPMw (big blind) collected ($40)
Seat 6: ovpz8iX9p4XQ/6AFQrnDTw folded before Flop (didn't bet)



PokerStars Game #59958319386:  Hold'em No Limit ($5/$10) - 2009/07/01 10:10:31 ET
Table '2a86NK3xhs21kwGZmbj0QA' 6-max Seat #4 is the button
Seat 1: NczJqEIUdrpEc5Nbd7h1Ig ($300 in chips)
Seat 2: Xl+I49lxCJwPGRuegiaHoA ($1000 in chips)
Seat 3: voSAIKXtXUUbJnds83sYfQ ($1209 in chips)
Seat 4: H/55aK4Sgl3B8A9bHghYVQ ($975 in chips)
Seat 5: jkH6qYMpn8JA/IyBOhQPMw ($1915 in chips)
Seat 6: ovpz8iX9p4XQ/6AFQrnDTw ($515.30 in chips)
jkH6qYMpn8JA/IyBOhQPMw: posts small blind $5
ovpz8iX9p4XQ/6AFQrnDTw: posts big blind $10
*** HOLE CARDS ***
NczJqEIUdrpEc5Nbd7h1Ig: folds
Xl+I49lxCJwPGRuegiaHoA: folds
voSAIKXtXUUbJnds83sYfQ: raises $20 to $30
H/55aK4Sgl3B8A9bHghYVQ: calls $30
jkH6qYMpn8JA/IyBOhQPMw: raises $105 to $135
ovpz8iX9p4XQ/6AFQrnDTw: folds
voSAIKXtXUUbJnds83sYfQ: folds
H/55aK4Sgl3B8A9bHghYVQ: calls $105
*** FLOP *** [Th 9c 8h]
jkH6qYMpn8JA/IyBOhQPMw: checks
H/55aK4Sgl3B8A9bHghYVQ: bets $140
jkH6qYMpn8JA/IyBOhQPMw: folds
H/55aK4Sgl3B8A9bHghYVQ collected $307 from pot
*** SUMMARY ***
Total pot $310 | Rake $3
Board [Th 9c 8h]
Seat 1: NczJqEIUdrpEc5Nbd7h1Ig folded before Flop (didn't bet)
Seat 2: Xl+I49lxCJwPGRuegiaHoA folded before Flop (didn't bet)
Seat 3: voSAIKXtXUUbJnds83sYfQ folded before Flop
Seat 4: H/55aK4Sgl3B8A9bHghYVQ (button) collected ($307)
Seat 5: jkH6qYMpn8JA/IyBOhQPMw (small blind) folded on the Flop
Seat 6: ovpz8iX9p4XQ/6AFQrnDTw (big blind) folded before Flop



PokerStars Game #59958362738:  Hold'em No Limit ($5/$10) - 2009/07/01 10:11:26 ET
Table '2a86NK3xhs21kwGZmbj0QA' 6-max Seat #5 is the button
Seat 1: NczJqEIUdrpEc5Nbd7h1Ig ($300 in chips)
Seat 2: Xl+I49lxCJwPGRuegiaHoA ($1000 in chips)
Seat 3: voSAIKXtXUUbJnds83sYfQ ($1179 in chips)
Seat 4: H/55aK4Sgl3B8A9bHghYVQ ($1147 in chips)
Seat 5: jkH6qYMpn8JA/IyBOhQPMw ($1780 in chips)
Seat 6: ovpz8iX9p4XQ/6AFQrnDTw ($505.30 in chips)
ovpz8iX9p4XQ/6AFQrnDTw: posts small blind $5
NczJqEIUdrpEc5Nbd7h1Ig: posts big blind $10
*** HOLE CARDS ***
Xl+I49lxCJwPGRuegiaHoA: folds
voSAIKXtXUUbJnds83sYfQ: folds
H/55aK4Sgl3B8A9bHghYVQ: folds
jkH6qYMpn8JA/IyBOhQPMw: folds
ovpz8iX9p4XQ/6AFQrnDTw: folds
NczJqEIUdrpEc5Nbd7h1Ig collected $10 from pot
*** SUMMARY ***
Total pot $10 | Rake $0
Seat 1: NczJqEIUdrpEc5Nbd7h1Ig (big blind) collected ($10)
Seat 2: Xl+I49lxCJwPGRuegiaHoA folded before Flop (didn't bet)
Seat 3: voSAIKXtXUUbJnds83sYfQ folded before Flop (didn't bet)
Seat 4: H/55aK4Sgl3B8A9bHghYVQ folded before Flop (didn't bet)
Seat 5: jkH6qYMpn8JA/IyBOhQPMw (button) folded before Flop (didn't bet)
Seat 6: ovpz8iX9p4XQ/6AFQrnDTw (small blind) folded before Flop



PokerStars Game #59958373024:  Hold'em No Limit ($5/$10) - 2009/07/01 10:11:39 ET
Table '2a86NK3xhs21kwGZmbj0QA' 6-max Seat #6 is the button
Seat 1: NczJqEIUdrpEc5Nbd7h1Ig ($305 in chips)
Seat 2: Xl+I49lxCJwPGRuegiaHoA ($1000 in chips)
Seat 3: voSAIKXtXUUbJnds83sYfQ ($1179 in chips)
Seat 4: H/55aK4Sgl3B8A9bHghYVQ ($1147 in chips)
Seat 5: jkH6qYMpn8JA/IyBOhQPMw ($1780 in chips)
Seat 6: ovpz8iX9p4XQ/6AFQrnDTw ($500.30 in chips)
NczJqEIUdrpEc5Nbd7h1Ig: posts small blind $5
Xl+I49lxCJwPGRuegiaHoA: posts big blind $10
*** HOLE CARDS ***
voSAIKXtXUUbJnds83sYfQ: folds
H/55aK4Sgl3B8A9bHghYVQ: raises $10 to $20
jkH6qYMpn8JA/IyBOhQPMw: calls $20
ovpz8iX9p4XQ/6AFQrnDTw: folds
NczJqEIUdrpEc5Nbd7h1Ig: calls $15
Xl+I49lxCJwPGRuegiaHoA: folds
*** FLOP *** [As 8h Td]
NczJqEIUdrpEc5Nbd7h1Ig: checks
H/55aK4Sgl3B8A9bHghYVQ: checks
jkH6qYMpn8JA/IyBOhQPMw: checks
*** TURN *** [As 8h Td] [7c]
NczJqEIUdrpEc5Nbd7h1Ig: bets $30
H/55aK4Sgl3B8A9bHghYVQ: calls $30
jkH6qYMpn8JA/IyBOhQPMw: folds
*** RIVER *** [As 8h Td 7c] [5s]
NczJqEIUdrpEc5Nbd7h1Ig: bets $40
H/55aK4Sgl3B8A9bHghYVQ: folds
NczJqEIUdrpEc5Nbd7h1Ig collected $127 from pot
*** SUMMARY ***
Total pot $130 | Rake $3
Board [As 8h Td 7c 5s]
Seat 1: NczJqEIUdrpEc5Nbd7h1Ig (small blind) collected ($127)
Seat 2: Xl+I49lxCJwPGRuegiaHoA (big blind) folded before Flop
Seat 3: voSAIKXtXUUbJnds83sYfQ folded before Flop (didn't bet)
Seat 4: H/55aK4Sgl3B8A9bHghYVQ folded on the River
Seat 5: jkH6qYMpn8JA/IyBOhQPMw folded on the Turn
Seat 6: ovpz8iX9p4XQ/6AFQrnDTw (button) folded before Flop (didn't bet)



PokerStars Game #59958423558:  Hold'em No Limit ($5/$10) - 2009/07/01 10:12:43 ET
Table '2a86NK3xhs21kwGZmbj0QA' 6-max Seat #1 is the button
Seat 1: NczJqEIUdrpEc5Nbd7h1Ig ($382 in chips)
Seat 2: Xl+I49lxCJwPGRuegiaHoA ($1000 in chips)
Seat 3: voSAIKXtXUUbJnds83sYfQ ($1179 in chips)
Seat 4: H/55aK4Sgl3B8A9bHghYVQ ($1097 in chips)
Seat 5: jkH6qYMpn8JA/IyBOhQPMw ($1760 in chips)
Seat 6: ovpz8iX9p4XQ/6AFQrnDTw ($500.30 in chips)
Xl+I49lxCJwPGRuegiaHoA: posts small blind $5
voSAIKXtXUUbJnds83sYfQ: posts big blind $10
*** HOLE CARDS ***
H/55aK4Sgl3B8A9bHghYVQ: folds
jkH6qYMpn8JA/IyBOhQPMw: raises $20 to $30
ovpz8iX9p4XQ/6AFQrnDTw: calls $30
NczJqEIUdrpEc5Nbd7h1Ig: calls $30
Xl+I49lxCJwPGRuegiaHoA: folds
voSAIKXtXUUbJnds83sYfQ: folds
*** FLOP *** [Ad Qd Ts]
jkH6qYMpn8JA/IyBOhQPMw: checks
ovpz8iX9p4XQ/6AFQrnDTw: checks
NczJqEIUdrpEc5Nbd7h1Ig: checks
*** TURN *** [Ad Qd Ts] [2d]
jkH6qYMpn8JA/IyBOhQPMw: checks
ovpz8iX9p4XQ/6AFQrnDTw: checks
NczJqEIUdrpEc5Nbd7h1Ig: checks
*** RIVER *** [Ad Qd Ts 2d] [4d]
jkH6qYMpn8JA/IyBOhQPMw: checks
ovpz8iX9p4XQ/6AFQrnDTw: checks
NczJqEIUdrpEc5Nbd7h1Ig: bets $50
jkH6qYMpn8JA/IyBOhQPMw: folds
ovpz8iX9p4XQ/6AFQrnDTw: calls $50
*** SHOW DOWN ***
NczJqEIUdrpEc5Nbd7h1Ig: shows [Kd 9d] (a flush, Ace high)
ovpz8iX9p4XQ/6AFQrnDTw: mucks hand
NczJqEIUdrpEc5Nbd7h1Ig collected $202 from pot
*** SUMMARY ***
Total pot $205 | Rake $3
Board [Ad Qd Ts 2d 4d]
Seat 1: NczJqEIUdrpEc5Nbd7h1Ig (button) showed [Kd 9d] and won ($202) with a flush, Ace high
Seat 2: Xl+I49lxCJwPGRuegiaHoA (small blind) folded before Flop
Seat 3: voSAIKXtXUUbJnds83sYfQ (big blind) folded before Flop
Seat 4: H/55aK4Sgl3B8A9bHghYVQ folded before Flop (didn't bet)
Seat 5: jkH6qYMpn8JA/IyBOhQPMw folded on the River
Seat 6: ovpz8iX9p4XQ/6AFQrnDTw mucked



PokerStars Game #59958473072:  Hold'em No Limit ($5/$10) - 2009/07/01 10:13:46 ET
Table '2a86NK3xhs21kwGZmbj0QA' 6-max Seat #2 is the button
Seat 1: NczJqEIUdrpEc5Nbd7h1Ig ($504 in chips)
Seat 2: Xl+I49lxCJwPGRuegiaHoA ($1000 in chips)
Seat 3: voSAIKXtXUUbJnds83sYfQ ($1169 in chips)
Seat 4: H/55aK4Sgl3B8A9bHghYVQ ($1097 in chips)
Seat 5: jkH6qYMpn8JA/IyBOhQPMw ($1730 in chips)
Seat 6: ovpz8iX9p4XQ/6AFQrnDTw ($420.30 in chips)
voSAIKXtXUUbJnds83sYfQ: posts small blind $5
H/55aK4Sgl3B8A9bHghYVQ: posts big blind $10
*** HOLE CARDS ***
jkH6qYMpn8JA/IyBOhQPMw: folds
ovpz8iX9p4XQ/6AFQrnDTw: folds
NczJqEIUdrpEc5Nbd7h1Ig: folds
Xl+I49lxCJwPGRuegiaHoA: folds
voSAIKXtXUUbJnds83sYfQ: folds
H/55aK4Sgl3B8A9bHghYVQ collected $10 from pot
*** SUMMARY ***
Total pot $10 | Rake $0
Seat 1: NczJqEIUdrpEc5Nbd7h1Ig folded before Flop (didn't bet)
Seat 2: Xl+I49lxCJwPGRuegiaHoA (button) folded before Flop (didn't bet)
Seat 3: voSAIKXtXUUbJnds83sYfQ (small blind) folded before Flop
Seat 4: H/55aK4Sgl3B8A9bHghYVQ (big blind) collected ($10)
Seat 5: jkH6qYMpn8JA/IyBOhQPMw folded before Flop (didn't bet)
Seat 6: ovpz8iX9p4XQ/6AFQrnDTw folded before Flop (didn't bet)



PokerStars Game #59958490404:  Hold'em No Limit ($5/$10) - 2009/07/01 10:14:08 ET
Table '2a86NK3xhs21kwGZmbj0QA' 6-max Seat #3 is the button
Seat 1: NczJqEIUdrpEc5Nbd7h1Ig ($504 in chips)
Seat 2: Xl+I49lxCJwPGRuegiaHoA ($1000 in chips)
Seat 3: voSAIKXtXUUbJnds83sYfQ ($1164 in chips)
Seat 4: H/55aK4Sgl3B8A9bHghYVQ ($1102 in chips)
Seat 5: jkH6qYMpn8JA/IyBOhQPMw ($1730 in chips)
Seat 6: ovpz8iX9p4XQ/6AFQrnDTw ($420.30 in chips)
H/55aK4Sgl3B8A9bHghYVQ: posts small blind $5
jkH6qYMpn8JA/IyBOhQPMw: posts big blind $10
*** HOLE CARDS ***
ovpz8iX9p4XQ/6AFQrnDTw: folds
NczJqEIUdrpEc5Nbd7h1Ig: calls $10
Xl+I49lxCJwPGRuegiaHoA: folds
voSAIKXtXUUbJnds83sYfQ: folds
H/55aK4Sgl3B8A9bHghYVQ: raises $20 to $30
jkH6qYMpn8JA/IyBOhQPMw: calls $20
NczJqEIUdrpEc5Nbd7h1Ig: calls $20
*** FLOP *** [Kd 6s Ac]
H/55aK4Sgl3B8A9bHghYVQ: checks
jkH6qYMpn8JA/IyBOhQPMw: checks
NczJqEIUdrpEc5Nbd7h1Ig: checks
*** TURN *** [Kd 6s Ac] [9s]
H/55aK4Sgl3B8A9bHghYVQ: checks
jkH6qYMpn8JA/IyBOhQPMw: bets $72
NczJqEIUdrpEc5Nbd7h1Ig: folds
H/55aK4Sgl3B8A9bHghYVQ: folds
jkH6qYMpn8JA/IyBOhQPMw collected $87 from pot
jkH6qYMpn8JA/IyBOhQPMw: doesn't show hand
*** SUMMARY ***
Total pot $90 | Rake $3
Board [Kd 6s Ac 9s]
Seat 1: NczJqEIUdrpEc5Nbd7h1Ig folded on the Turn
Seat 2: Xl+I49lxCJwPGRuegiaHoA folded before Flop (didn't bet)
Seat 3: voSAIKXtXUUbJnds83sYfQ (button) folded before Flop (didn't bet)
Seat 4: H/55aK4Sgl3B8A9bHghYVQ (small blind) folded on the Turn
Seat 5: jkH6qYMpn8JA/IyBOhQPMw (big blind) collected ($87)
Seat 6: ovpz8iX9p4XQ/6AFQrnDTw folded before Flop (didn't bet)



PokerStars Game #59958533588:  Hold'em No Limit ($5/$10) - 2009/07/01 10:15:02 ET
Table '2a86NK3xhs21kwGZmbj0QA' 6-max Seat #4 is the button
Seat 1: NczJqEIUdrpEc5Nbd7h1Ig ($474 in chips)
Seat 2: Xl+I49lxCJwPGRuegiaHoA ($1000 in chips)
Seat 3: voSAIKXtXUUbJnds83sYfQ ($1164 in chips)
Seat 4: H/55aK4Sgl3B8A9bHghYVQ ($1072 in chips)
Seat 5: jkH6qYMpn8JA/IyBOhQPMw ($1787 in chips)
Seat 6: ovpz8iX9p4XQ/6AFQrnDTw ($820.30 in chips)
jkH6qYMpn8JA/IyBOhQPMw: posts small blind $5
ovpz8iX9p4XQ/6AFQrnDTw: posts big blind $10
*** HOLE CARDS ***
NczJqEIUdrpEc5Nbd7h1Ig: folds
Xl+I49lxCJwPGRuegiaHoA: folds
voSAIKXtXUUbJnds83sYfQ: raises $20 to $30
H/55aK4Sgl3B8A9bHghYVQ: calls $30
jkH6qYMpn8JA/IyBOhQPMw: folds
ovpz8iX9p4XQ/6AFQrnDTw: raises $100 to $130
voSAIKXtXUUbJnds83sYfQ: folds
H/55aK4Sgl3B8A9bHghYVQ: calls $100
*** FLOP *** [6s 9c 2c]
ovpz8iX9p4XQ/6AFQrnDTw: bets $190
H/55aK4Sgl3B8A9bHghYVQ: raises $190 to $380
ovpz8iX9p4XQ/6AFQrnDTw: folds
H/55aK4Sgl3B8A9bHghYVQ collected $672 from pot
*** SUMMARY ***
Total pot $675 | Rake $3
Board [6s 9c 2c]
Seat 1: NczJqEIUdrpEc5Nbd7h1Ig folded before Flop (didn't bet)
Seat 2: Xl+I49lxCJwPGRuegiaHoA folded before Flop (didn't bet)
Seat 3: voSAIKXtXUUbJnds83sYfQ folded before Flop
Seat 4: H/55aK4Sgl3B8A9bHghYVQ (button) collected ($672)
Seat 5: jkH6qYMpn8JA/IyBOhQPMw (small blind) folded before Flop
Seat 6: ovpz8iX9p4XQ/6AFQrnDTw (big blind) folded on the Flop



PokerStars Game #59958588540:  Hold'em No Limit ($5/$10) - 2009/07/01 10:16:10 ET
Table '2a86NK3xhs21kwGZmbj0QA' 6-max Seat #5 is the button
Seat 1: NczJqEIUdrpEc5Nbd7h1Ig ($474 in chips)
Seat 2: Xl+I49lxCJwPGRuegiaHoA ($1000 in chips)
Seat 3: voSAIKXtXUUbJnds83sYfQ ($1134 in chips)
Seat 4: H/55aK4Sgl3B8A9bHghYVQ ($1424 in chips)
Seat 5: jkH6qYMpn8JA/IyBOhQPMw ($1782 in chips)
Seat 6: ovpz8iX9p4XQ/6AFQrnDTw ($500.30 in chips)
ovpz8iX9p4XQ/6AFQrnDTw: posts small blind $5
NczJqEIUdrpEc5Nbd7h1Ig: posts big blind $10
*** HOLE CARDS ***
Xl+I49lxCJwPGRuegiaHoA: folds
voSAIKXtXUUbJnds83sYfQ: raises $20 to $30
H/55aK4Sgl3B8A9bHghYVQ: folds
jkH6qYMpn8JA/IyBOhQPMw: folds
ovpz8iX9p4XQ/6AFQrnDTw: calls $25
NczJqEIUdrpEc5Nbd7h1Ig: calls $20
*** FLOP *** [Js Tc 7s]
ovpz8iX9p4XQ/6AFQrnDTw: checks
NczJqEIUdrpEc5Nbd7h1Ig: checks
voSAIKXtXUUbJnds83sYfQ: checks
*** TURN *** [Js Tc 7s] [Qh]
ovpz8iX9p4XQ/6AFQrnDTw: checks
NczJqEIUdrpEc5Nbd7h1Ig: bets $40
voSAIKXtXUUbJnds83sYfQ: folds
ovpz8iX9p4XQ/6AFQrnDTw: folds
NczJqEIUdrpEc5Nbd7h1Ig collected $87 from pot
*** SUMMARY ***
Total pot $90 | Rake $3
Board [Js Tc 7s Qh]
Seat 1: NczJqEIUdrpEc5Nbd7h1Ig (big blind) collected ($87)
Seat 2: Xl+I49lxCJwPGRuegiaHoA folded before Flop (didn't bet)
Seat 3: voSAIKXtXUUbJnds83sYfQ folded on the Turn
Seat 4: H/55aK4Sgl3B8A9bHghYVQ folded before Flop (didn't bet)
Seat 5: jkH6qYMpn8JA/IyBOhQPMw (button) folded before Flop (didn't bet)
Seat 6: ovpz8iX9p4XQ/6AFQrnDTw (small blind) folded on the Turn



PokerStars Game #59958630272:  Hold'em No Limit ($5/$10) - 2009/07/01 10:17:02 ET
Table '2a86NK3xhs21kwGZmbj0QA' 6-max Seat #6 is the button
Seat 1: NczJqEIUdrpEc5Nbd7h1Ig ($531 in chips)
Seat 2: Xl+I49lxCJwPGRuegiaHoA ($1000 in chips)
Seat 3: voSAIKXtXUUbJnds83sYfQ ($1104 in chips)
Seat 4: H/55aK4Sgl3B8A9bHghYVQ ($1424 in chips)
Seat 5: jkH6qYMpn8JA/IyBOhQPMw ($1782 in chips)
Seat 6: ovpz8iX9p4XQ/6AFQrnDTw ($500 in chips)
NczJqEIUdrpEc5Nbd7h1Ig: posts small blind $5
Xl+I49lxCJwPGRuegiaHoA: posts big blind $10
*** HOLE CARDS ***
voSAIKXtXUUbJnds83sYfQ: folds
H/55aK4Sgl3B8A9bHghYVQ: raises $10 to $20
jkH6qYMpn8JA/IyBOhQPMw: folds
ovpz8iX9p4XQ/6AFQrnDTw: folds
NczJqEIUdrpEc5Nbd7h1Ig: calls $15
Xl+I49lxCJwPGRuegiaHoA: calls $10
*** FLOP *** [2s 7d 9d]
NczJqEIUdrpEc5Nbd7h1Ig: checks
Xl+I49lxCJwPGRuegiaHoA: checks
H/55aK4Sgl3B8A9bHghYVQ: bets $10
NczJqEIUdrpEc5Nbd7h1Ig: folds
Xl+I49lxCJwPGRuegiaHoA: raises $40 to $50
H/55aK4Sgl3B8A9bHghYVQ: calls $40
*** TURN *** [2s 7d 9d] [Qd]
Xl+I49lxCJwPGRuegiaHoA: bets $75
H/55aK4Sgl3B8A9bHghYVQ: folds
Xl+I49lxCJwPGRuegiaHoA collected $157 from pot
Xl+I49lxCJwPGRuegiaHoA: doesn't show hand
*** SUMMARY ***
Total pot $160 | Rake $3
Board [2s 7d 9d Qd]
Seat 1: NczJqEIUdrpEc5Nbd7h1Ig (small blind) folded on the Flop
Seat 2: Xl+I49lxCJwPGRuegiaHoA (big blind) collected ($157)
Seat 3: voSAIKXtXUUbJnds83sYfQ folded before Flop (didn't bet)
Seat 4: H/55aK4Sgl3B8A9bHghYVQ folded on the Turn
Seat 5: jkH6qYMpn8JA/IyBOhQPMw folded before Flop (didn't bet)
Seat 6: ovpz8iX9p4XQ/6AFQrnDTw (button) folded before Flop (didn't bet)



PokerStars Game #59958679866:  Hold'em No Limit ($5/$10) - 2009/07/01 10:18:04 ET
Table '2a86NK3xhs21kwGZmbj0QA' 6-max Seat #1 is the button
Seat 1: NczJqEIUdrpEc5Nbd7h1Ig ($511 in chips)
Seat 2: Xl+I49lxCJwPGRuegiaHoA ($1087 in chips)
Seat 3: voSAIKXtXUUbJnds83sYfQ ($1104 in chips)
Seat 4: H/55aK4Sgl3B8A9bHghYVQ ($1354 in chips)
Seat 5: jkH6qYMpn8JA/IyBOhQPMw ($1782 in chips)
Seat 6: ovpz8iX9p4XQ/6AFQrnDTw ($500 in chips)
Xl+I49lxCJwPGRuegiaHoA: posts small blind $5
voSAIKXtXUUbJnds83sYfQ: posts big blind $10
*** HOLE CARDS ***
H/55aK4Sgl3B8A9bHghYVQ: raises $20 to $30
jkH6qYMpn8JA/IyBOhQPMw: calls $30
ovpz8iX9p4XQ/6AFQrnDTw: folds
NczJqEIUdrpEc5Nbd7h1Ig: calls $30
Xl+I49lxCJwPGRuegiaHoA: folds
voSAIKXtXUUbJnds83sYfQ: folds
*** FLOP *** [2d Kd 4h]
H/55aK4Sgl3B8A9bHghYVQ: checks
jkH6qYMpn8JA/IyBOhQPMw: bets $80
NczJqEIUdrpEc5Nbd7h1Ig: calls $80
H/55aK4Sgl3B8A9bHghYVQ: folds
*** TURN *** [2d Kd 4h] [5d]
jkH6qYMpn8JA/IyBOhQPMw: checks
H/55aK4Sgl3B8A9bHghYVQ leaves the table
NczJqEIUdrpEc5Nbd7h1Ig: bets $100
jkH6qYMpn8JA/IyBOhQPMw: calls $100
*** RIVER *** [2d Kd 4h 5d] [4s]
jkH6qYMpn8JA/IyBOhQPMw: checks
NczJqEIUdrpEc5Nbd7h1Ig: checks
*** SHOW DOWN ***
jkH6qYMpn8JA/IyBOhQPMw: shows [Kh 7h] (two pair, Kings and Fours)
NczJqEIUdrpEc5Nbd7h1Ig: shows [Qs Kc] (two pair, Kings and Fours - Queen kicker)
NczJqEIUdrpEc5Nbd7h1Ig collected $462 from pot
*** SUMMARY ***
Total pot $465 | Rake $3
Board [2d Kd 4h 5d 4s]
Seat 1: NczJqEIUdrpEc5Nbd7h1Ig (button) showed [Qs Kc] and won ($462) with two pair, Kings and Fours
Seat 2: Xl+I49lxCJwPGRuegiaHoA (small blind) folded before Flop
Seat 3: voSAIKXtXUUbJnds83sYfQ (big blind) folded before Flop
Seat 4: H/55aK4Sgl3B8A9bHghYVQ folded on the Flop
Seat 5: jkH6qYMpn8JA/IyBOhQPMw showed [Kh 7h] and lost with two pair, Kings and Fours
Seat 6: ovpz8iX9p4XQ/6AFQrnDTw folded before Flop (didn't bet)



PokerStars Game #59958733118:  Hold'em No Limit ($5/$10) - 2009/07/01 10:19:10 ET
Table '2a86NK3xhs21kwGZmbj0QA' 6-max Seat #2 is the button
Seat 1: NczJqEIUdrpEc5Nbd7h1Ig ($763 in chips)
Seat 2: Xl+I49lxCJwPGRuegiaHoA ($1082 in chips)
Seat 3: voSAIKXtXUUbJnds83sYfQ ($1094 in chips)
Seat 5: jkH6qYMpn8JA/IyBOhQPMw ($1572 in chips)
Seat 6: ovpz8iX9p4XQ/6AFQrnDTw ($500 in chips)
voSAIKXtXUUbJnds83sYfQ: posts small blind $5
jkH6qYMpn8JA/IyBOhQPMw: posts big blind $10
*** HOLE CARDS ***
ovpz8iX9p4XQ/6AFQrnDTw: folds
NczJqEIUdrpEc5Nbd7h1Ig: calls $10
Xl+I49lxCJwPGRuegiaHoA: folds
voSAIKXtXUUbJnds83sYfQ: folds
jkH6qYMpn8JA/IyBOhQPMw: raises $30 to $40
NczJqEIUdrpEc5Nbd7h1Ig: calls $30
*** FLOP *** [3d 6s 5h]
jkH6qYMpn8JA/IyBOhQPMw: bets $62
NczJqEIUdrpEc5Nbd7h1Ig: calls $62
*** TURN *** [3d 6s 5h] [6h]
jkH6qYMpn8JA/IyBOhQPMw: checks
NczJqEIUdrpEc5Nbd7h1Ig: checks
*** RIVER *** [3d 6s 5h 6h] [Jd]
jkH6qYMpn8JA/IyBOhQPMw: bets $175
NczJqEIUdrpEc5Nbd7h1Ig: calls $175
1ScqYmNf7/uWx1XSBgPTBw joins the table at seat #4
*** SHOW DOWN ***
jkH6qYMpn8JA/IyBOhQPMw: shows [Ad Jh] (two pair, Jacks and Sixes)
NczJqEIUdrpEc5Nbd7h1Ig: mucks hand
jkH6qYMpn8JA/IyBOhQPMw collected $557 from pot
*** SUMMARY ***
Total pot $559 | Rake $2
Board [3d 6s 5h 6h Jd]
Seat 1: NczJqEIUdrpEc5Nbd7h1Ig mucked
Seat 2: Xl+I49lxCJwPGRuegiaHoA (button) folded before Flop (didn't bet)
Seat 3: voSAIKXtXUUbJnds83sYfQ (small blind) folded before Flop
Seat 5: jkH6qYMpn8JA/IyBOhQPMw (big blind) showed [Ad Jh] and won ($557) with two pair, Jacks and Sixes
Seat 6: ovpz8iX9p4XQ/6AFQrnDTw folded before Flop (didn't bet)



PokerStars Game #59958776478:  Hold'em No Limit ($5/$10) - 2009/07/01 10:20:04 ET
Table '2a86NK3xhs21kwGZmbj0QA' 6-max Seat #3 is the button
Seat 1: NczJqEIUdrpEc5Nbd7h1Ig ($486 in chips)
Seat 2: Xl+I49lxCJwPGRuegiaHoA ($1082 in chips)
Seat 3: voSAIKXtXUUbJnds83sYfQ ($1089 in chips)
Seat 5: jkH6qYMpn8JA/IyBOhQPMw ($1852 in chips)
Seat 6: ovpz8iX9p4XQ/6AFQrnDTw ($677.30 in chips)
1ScqYmNf7/uWx1XSBgPTBw will be allowed to play after the button
jkH6qYMpn8JA/IyBOhQPMw: posts small blind $5
ovpz8iX9p4XQ/6AFQrnDTw: posts big blind $10
*** HOLE CARDS ***
NczJqEIUdrpEc5Nbd7h1Ig: calls $10
Xl+I49lxCJwPGRuegiaHoA: folds
voSAIKXtXUUbJnds83sYfQ: folds
jkH6qYMpn8JA/IyBOhQPMw: folds
ovpz8iX9p4XQ/6AFQrnDTw: checks
*** FLOP *** [2c Js Kd]
ovpz8iX9p4XQ/6AFQrnDTw: checks
NczJqEIUdrpEc5Nbd7h1Ig: bets $30
ovpz8iX9p4XQ/6AFQrnDTw: raises $70 to $100
NczJqEIUdrpEc5Nbd7h1Ig: folds
ovpz8iX9p4XQ/6AFQrnDTw collected $83 from pot
ovpz8iX9p4XQ/6AFQrnDTw: doesn't show hand
*** SUMMARY ***
Total pot $85 | Rake $2
Board [2c Js Kd]
Seat 1: NczJqEIUdrpEc5Nbd7h1Ig folded on the Flop
Seat 2: Xl+I49lxCJwPGRuegiaHoA folded before Flop (didn't bet)
Seat 3: voSAIKXtXUUbJnds83sYfQ (button) folded before Flop (didn't bet)
Seat 5: jkH6qYMpn8JA/IyBOhQPMw (small blind) folded before Flop
Seat 6: ovpz8iX9p4XQ/6AFQrnDTw (big blind) collected ($83)



PokerStars Game #59958796358:  Hold'em No Limit ($5/$10) - 2009/07/01 10:20:28 ET
Table '2a86NK3xhs21kwGZmbj0QA' 6-max Seat #5 is the button
Seat 1: NczJqEIUdrpEc5Nbd7h1Ig ($446 in chips)
Seat 2: Xl+I49lxCJwPGRuegiaHoA ($1082 in chips)
Seat 3: voSAIKXtXUUbJnds83sYfQ ($1089 in chips)
Seat 5: jkH6qYMpn8JA/IyBOhQPMw ($1847 in chips)
Seat 6: ovpz8iX9p4XQ/6AFQrnDTw ($720.30 in chips)
ovpz8iX9p4XQ/6AFQrnDTw: posts small blind $5
NczJqEIUdrpEc5Nbd7h1Ig: posts big blind $10
1ScqYmNf7/uWx1XSBgPTBw: sits out
*** HOLE CARDS ***
Xl+I49lxCJwPGRuegiaHoA: folds
voSAIKXtXUUbJnds83sYfQ: raises $20 to $30
jkH6qYMpn8JA/IyBOhQPMw: raises $70 to $100
ovpz8iX9p4XQ/6AFQrnDTw: folds
NczJqEIUdrpEc5Nbd7h1Ig: folds
voSAIKXtXUUbJnds83sYfQ: folds
jkH6qYMpn8JA/IyBOhQPMw collected $75 from pot
jkH6qYMpn8JA/IyBOhQPMw: doesn't show hand
*** SUMMARY ***
Total pot $75 | Rake $0
Seat 1: NczJqEIUdrpEc5Nbd7h1Ig (big blind) folded before Flop
Seat 2: Xl+I49lxCJwPGRuegiaHoA folded before Flop (didn't bet)
Seat 3: voSAIKXtXUUbJnds83sYfQ folded before Flop
Seat 5: jkH6qYMpn8JA/IyBOhQPMw (button) collected ($75)
Seat 6: ovpz8iX9p4XQ/6AFQrnDTw (small blind) folded before Flop



PokerStars Game #59958812106:  Hold'em No Limit ($5/$10) - 2009/07/01 10:20:48 ET
Table '2a86NK3xhs21kwGZmbj0QA' 6-max Seat #6 is the button
Seat 1: NczJqEIUdrpEc5Nbd7h1Ig ($436 in chips)
Seat 2: Xl+I49lxCJwPGRuegiaHoA ($1082 in chips)
Seat 3: voSAIKXtXUUbJnds83sYfQ ($1059 in chips)
Seat 5: jkH6qYMpn8JA/IyBOhQPMw ($1892 in chips)
Seat 6: ovpz8iX9p4XQ/6AFQrnDTw ($715.30 in chips)
NczJqEIUdrpEc5Nbd7h1Ig: posts small blind $5
Xl+I49lxCJwPGRuegiaHoA: posts big blind $10
1ScqYmNf7/uWx1XSBgPTBw: sits out
*** HOLE CARDS ***
voSAIKXtXUUbJnds83sYfQ: folds
jkH6qYMpn8JA/IyBOhQPMw: raises $20 to $30
ovpz8iX9p4XQ/6AFQrnDTw: folds
NczJqEIUdrpEc5Nbd7h1Ig: folds
Xl+I49lxCJwPGRuegiaHoA: calls $20
*** FLOP *** [Jd Ac 2s]
Xl+I49lxCJwPGRuegiaHoA: checks
jkH6qYMpn8JA/IyBOhQPMw: bets $52
Xl+I49lxCJwPGRuegiaHoA: calls $52
*** TURN *** [Jd Ac 2s] [Jh]
Xl+I49lxCJwPGRuegiaHoA: checks
jkH6qYMpn8JA/IyBOhQPMw: checks
*** RIVER *** [Jd Ac 2s Jh] [2c]
Xl+I49lxCJwPGRuegiaHoA: bets $75
jkH6qYMpn8JA/IyBOhQPMw: calls $75
*** SHOW DOWN ***
Xl+I49lxCJwPGRuegiaHoA: shows [9c 8c] (two pair, Jacks and Deuces)
jkH6qYMpn8JA/IyBOhQPMw: shows [3d Ad] (two pair, Aces and Jacks)
jkH6qYMpn8JA/IyBOhQPMw collected $317 from pot
*** SUMMARY ***
Total pot $319 | Rake $2
Board [Jd Ac 2s Jh 2c]
Seat 1: NczJqEIUdrpEc5Nbd7h1Ig (small blind) folded before Flop
Seat 2: Xl+I49lxCJwPGRuegiaHoA (big blind) showed [9c 8c] and lost with two pair, Jacks and Deuces
Seat 3: voSAIKXtXUUbJnds83sYfQ folded before Flop (didn't bet)
Seat 5: jkH6qYMpn8JA/IyBOhQPMw showed [3d Ad] and won ($317) with two pair, Aces and Jacks
Seat 6: ovpz8iX9p4XQ/6AFQrnDTw (button) folded before Flop (didn't bet)



PokerStars Game #59958859640:  Hold'em No Limit ($5/$10) - 2009/07/01 10:21:47 ET
Table '2a86NK3xhs21kwGZmbj0QA' 6-max Seat #1 is the button
Seat 1: NczJqEIUdrpEc5Nbd7h1Ig ($431 in chips)
Seat 2: Xl+I49lxCJwPGRuegiaHoA ($1000 in chips)
Seat 3: voSAIKXtXUUbJnds83sYfQ ($1059 in chips)
Seat 5: jkH6qYMpn8JA/IyBOhQPMw ($2052 in chips)
Seat 6: ovpz8iX9p4XQ/6AFQrnDTw ($715.30 in chips)
Xl+I49lxCJwPGRuegiaHoA: posts small blind $5
voSAIKXtXUUbJnds83sYfQ: posts big blind $10
1ScqYmNf7/uWx1XSBgPTBw: sits out
*** HOLE CARDS ***
jkH6qYMpn8JA/IyBOhQPMw: raises $20 to $30
ovpz8iX9p4XQ/6AFQrnDTw: folds
NczJqEIUdrpEc5Nbd7h1Ig: calls $30
Xl+I49lxCJwPGRuegiaHoA: calls $25
voSAIKXtXUUbJnds83sYfQ: folds
*** FLOP *** [5s Jd Tc]
Xl+I49lxCJwPGRuegiaHoA: checks
jkH6qYMpn8JA/IyBOhQPMw: checks
NczJqEIUdrpEc5Nbd7h1Ig: bets $90
Xl+I49lxCJwPGRuegiaHoA: raises $95 to $185
jkH6qYMpn8JA/IyBOhQPMw: folds
NczJqEIUdrpEc5Nbd7h1Ig: folds
Xl+I49lxCJwPGRuegiaHoA collected $278 from pot
Xl+I49lxCJwPGRuegiaHoA: doesn't show hand
*** SUMMARY ***
Total pot $280 | Rake $2
Board [5s Jd Tc]
Seat 1: NczJqEIUdrpEc5Nbd7h1Ig (button) folded on the Flop
Seat 2: Xl+I49lxCJwPGRuegiaHoA (small blind) collected ($278)
Seat 3: voSAIKXtXUUbJnds83sYfQ (big blind) folded before Flop
Seat 5: jkH6qYMpn8JA/IyBOhQPMw folded on the Flop
Seat 6: ovpz8iX9p4XQ/6AFQrnDTw folded before Flop (didn't bet)



PokerStars Game #59958864264:  Hold'em No Limit ($5/$10) - 2009/07/01 10:21:52 ET
Table '1Dt9cpcLUVE6HYkx5dUEdQ' 6-max Seat #3 is the button
Seat 1: 2PHCSXghjbGk2qR6jDFe2g ($1864 in chips)
Seat 2: zdS2zKkZYSRe8p+GVcXMgg ($567 in chips)
Seat 3: g/z/ANylbdR10I7oPCJdKQ ($516.25 in chips)
Seat 4: voSAIKXtXUUbJnds83sYfQ ($1000 in chips)
Seat 5: 7SUIdtQak1SCtldWHjwnFA ($200 in chips)
Seat 6: 3mTlg4g0FJN2bo939h/0Wg ($382 in chips)
voSAIKXtXUUbJnds83sYfQ: posts small blind $5
7SUIdtQak1SCtldWHjwnFA: posts big blind $10
*** HOLE CARDS ***
3mTlg4g0FJN2bo939h/0Wg: calls $10
2PHCSXghjbGk2qR6jDFe2g: calls $10
zdS2zKkZYSRe8p+GVcXMgg: folds
g/z/ANylbdR10I7oPCJdKQ: folds
voSAIKXtXUUbJnds83sYfQ: folds
7SUIdtQak1SCtldWHjwnFA: checks
*** FLOP *** [9d 8c 3c]
7SUIdtQak1SCtldWHjwnFA: checks
3mTlg4g0FJN2bo939h/0Wg: checks
2PHCSXghjbGk2qR6jDFe2g: bets $20
7SUIdtQak1SCtldWHjwnFA: raises $50 to $70
3mTlg4g0FJN2bo939h/0Wg: folds
2PHCSXghjbGk2qR6jDFe2g: folds
7SUIdtQak1SCtldWHjwnFA collected $72 from pot
7SUIdtQak1SCtldWHjwnFA: doesn't show hand
*** SUMMARY ***
Total pot $75 | Rake $3
Board [9d 8c 3c]
Seat 1: 2PHCSXghjbGk2qR6jDFe2g folded on the Flop
Seat 2: zdS2zKkZYSRe8p+GVcXMgg folded before Flop (didn't bet)
Seat 3: g/z/ANylbdR10I7oPCJdKQ (button) folded before Flop (didn't bet)
Seat 4: voSAIKXtXUUbJnds83sYfQ (small blind) folded before Flop
Seat 5: 7SUIdtQak1SCtldWHjwnFA (big blind) collected ($72)
Seat 6: 3mTlg4g0FJN2bo939h/0Wg folded on the Flop



PokerStars Game #59958899454:  Hold'em No Limit ($5/$10) - 2009/07/01 10:22:37 ET
Table '2a86NK3xhs21kwGZmbj0QA' 6-max Seat #2 is the button
Seat 1: NczJqEIUdrpEc5Nbd7h1Ig ($311 in chips)
Seat 2: Xl+I49lxCJwPGRuegiaHoA ($1158 in chips)
Seat 3: voSAIKXtXUUbJnds83sYfQ ($1049 in chips)
Seat 4: 1ScqYmNf7/uWx1XSBgPTBw ($200 in chips)
Seat 5: jkH6qYMpn8JA/IyBOhQPMw ($2022 in chips)
Seat 6: ovpz8iX9p4XQ/6AFQrnDTw ($715.30 in chips)
voSAIKXtXUUbJnds83sYfQ: posts small blind $5
1ScqYmNf7/uWx1XSBgPTBw: posts big blind $10
*** HOLE CARDS ***
jkH6qYMpn8JA/IyBOhQPMw: folds
ovpz8iX9p4XQ/6AFQrnDTw: folds
NczJqEIUdrpEc5Nbd7h1Ig: calls $10
Xl+I49lxCJwPGRuegiaHoA: folds
voSAIKXtXUUbJnds83sYfQ: folds
1ScqYmNf7/uWx1XSBgPTBw: checks
*** FLOP *** [Jh Kd 3h]
1ScqYmNf7/uWx1XSBgPTBw: checks
NczJqEIUdrpEc5Nbd7h1Ig: checks
*** TURN *** [Jh Kd 3h] [4h]
1ScqYmNf7/uWx1XSBgPTBw: bets $20
NczJqEIUdrpEc5Nbd7h1Ig: calls $20
*** RIVER *** [Jh Kd 3h 4h] [7d]
1ScqYmNf7/uWx1XSBgPTBw: checks
NczJqEIUdrpEc5Nbd7h1Ig: bets $60
1ScqYmNf7/uWx1XSBgPTBw: calls $60
*** SHOW DOWN ***
NczJqEIUdrpEc5Nbd7h1Ig: shows [Qc 9h] (high card King)
1ScqYmNf7/uWx1XSBgPTBw: shows [6c Ks] (a pair of Kings)
1ScqYmNf7/uWx1XSBgPTBw collected $182 from pot
*** SUMMARY ***
Total pot $185 | Rake $3
Board [Jh Kd 3h 4h 7d]
Seat 1: NczJqEIUdrpEc5Nbd7h1Ig showed [Qc 9h] and lost with high card King
Seat 2: Xl+I49lxCJwPGRuegiaHoA (button) folded before Flop (didn't bet)
Seat 3: voSAIKXtXUUbJnds83sYfQ (small blind) folded before Flop
Seat 4: 1ScqYmNf7/uWx1XSBgPTBw (big blind) showed [6c Ks] and won ($182) with a pair of Kings
Seat 5: jkH6qYMpn8JA/IyBOhQPMw folded before Flop (didn't bet)
Seat 6: ovpz8iX9p4XQ/6AFQrnDTw folded before Flop (didn't bet)



PokerStars Game #59958908518:  Hold'em No Limit ($5/$10) - 2009/07/01 10:22:48 ET
Table '1Dt9cpcLUVE6HYkx5dUEdQ' 6-max Seat #4 is the button
Seat 1: 2PHCSXghjbGk2qR6jDFe2g ($1834 in chips)
Seat 2: zdS2zKkZYSRe8p+GVcXMgg ($567 in chips)
Seat 3: g/z/ANylbdR10I7oPCJdKQ ($516.25 in chips)
Seat 4: voSAIKXtXUUbJnds83sYfQ ($1000 in chips)
Seat 5: 7SUIdtQak1SCtldWHjwnFA ($242 in chips)
Seat 6: 3mTlg4g0FJN2bo939h/0Wg ($372 in chips)
7SUIdtQak1SCtldWHjwnFA: posts small blind $5
3mTlg4g0FJN2bo939h/0Wg: posts big blind $10
*** HOLE CARDS ***
2PHCSXghjbGk2qR6jDFe2g: folds
zdS2zKkZYSRe8p+GVcXMgg: folds
g/z/ANylbdR10I7oPCJdKQ: folds
voSAIKXtXUUbJnds83sYfQ: raises $10 to $20
7SUIdtQak1SCtldWHjwnFA: raises $35 to $55
3mTlg4g0FJN2bo939h/0Wg: calls $45
voSAIKXtXUUbJnds83sYfQ: folds
*** FLOP *** [Jh 6d Js]
7SUIdtQak1SCtldWHjwnFA: bets $80
3mTlg4g0FJN2bo939h/0Wg: raises $120 to $200
7SUIdtQak1SCtldWHjwnFA: calls $107 and is all-in
*** TURN *** [Jh 6d Js] [8d]
*** RIVER *** [Jh 6d Js 8d] [4d]
*** SHOW DOWN ***
7SUIdtQak1SCtldWHjwnFA: shows [6h As] (two pair, Jacks and Sixes)
3mTlg4g0FJN2bo939h/0Wg: shows [7d 7c] (two pair, Jacks and Sevens)
3mTlg4g0FJN2bo939h/0Wg collected $501 from pot
*** SUMMARY ***
Total pot $504 | Rake $3
Board [Jh 6d Js 8d 4d]
Seat 1: 2PHCSXghjbGk2qR6jDFe2g folded before Flop (didn't bet)
Seat 2: zdS2zKkZYSRe8p+GVcXMgg folded before Flop (didn't bet)
Seat 3: g/z/ANylbdR10I7oPCJdKQ folded before Flop (didn't bet)
Seat 4: voSAIKXtXUUbJnds83sYfQ (button) folded before Flop
Seat 5: 7SUIdtQak1SCtldWHjwnFA (small blind) showed [6h As] and lost with two pair, Jacks and Sixes
Seat 6: 3mTlg4g0FJN2bo939h/0Wg (big blind) showed [7d 7c] and won ($501) with two pair, Jacks and Sevens



PokerStars Game #59958924534:  Hold'em No Limit ($5/$10) - 2009/07/01 10:23:08 ET
Table '2a86NK3xhs21kwGZmbj0QA' 6-max Seat #3 is the button
Seat 1: NczJqEIUdrpEc5Nbd7h1Ig ($221 in chips)
Seat 2: Xl+I49lxCJwPGRuegiaHoA ($1158 in chips)
Seat 3: voSAIKXtXUUbJnds83sYfQ ($1044 in chips)
Seat 4: 1ScqYmNf7/uWx1XSBgPTBw ($292 in chips)
Seat 5: jkH6qYMpn8JA/IyBOhQPMw ($2022 in chips)
Seat 6: ovpz8iX9p4XQ/6AFQrnDTw ($715.30 in chips)
1ScqYmNf7/uWx1XSBgPTBw: posts small blind $5
jkH6qYMpn8JA/IyBOhQPMw: posts big blind $10
*** HOLE CARDS ***
ovpz8iX9p4XQ/6AFQrnDTw: folds
NczJqEIUdrpEc5Nbd7h1Ig: calls $10
Xl+I49lxCJwPGRuegiaHoA: folds
voSAIKXtXUUbJnds83sYfQ: folds
1ScqYmNf7/uWx1XSBgPTBw: folds
jkH6qYMpn8JA/IyBOhQPMw: checks
*** FLOP *** [9d 8h Ad]
jkH6qYMpn8JA/IyBOhQPMw: checks
NczJqEIUdrpEc5Nbd7h1Ig: bets $40
jkH6qYMpn8JA/IyBOhQPMw: folds
NczJqEIUdrpEc5Nbd7h1Ig collected $23.75 from pot
*** SUMMARY ***
Total pot $25 | Rake $1.25
Board [9d 8h Ad]
Seat 1: NczJqEIUdrpEc5Nbd7h1Ig collected ($23.75)
Seat 2: Xl+I49lxCJwPGRuegiaHoA folded before Flop (didn't bet)
Seat 3: voSAIKXtXUUbJnds83sYfQ (button) folded before Flop (didn't bet)
Seat 4: 1ScqYmNf7/uWx1XSBgPTBw (small blind) folded before Flop
Seat 5: jkH6qYMpn8JA/IyBOhQPMw (big blind) folded on the Flop
Seat 6: ovpz8iX9p4XQ/6AFQrnDTw folded before Flop (didn't bet)



PokerStars Game #59958946738:  Hold'em No Limit ($5/$10) - 2009/07/01 10:23:36 ET
Table '2a86NK3xhs21kwGZmbj0QA' 6-max Seat #4 is the button
Seat 1: NczJqEIUdrpEc5Nbd7h1Ig ($234.75 in chips)
Seat 2: Xl+I49lxCJwPGRuegiaHoA ($1158 in chips)
Seat 3: voSAIKXtXUUbJnds83sYfQ ($1044 in chips)
Seat 4: 1ScqYmNf7/uWx1XSBgPTBw ($287 in chips)
Seat 5: jkH6qYMpn8JA/IyBOhQPMw ($2012 in chips)
Seat 6: ovpz8iX9p4XQ/6AFQrnDTw ($715.30 in chips)
jkH6qYMpn8JA/IyBOhQPMw: posts small blind $5
ovpz8iX9p4XQ/6AFQrnDTw: posts big blind $10
*** HOLE CARDS ***
NczJqEIUdrpEc5Nbd7h1Ig: folds
Xl+I49lxCJwPGRuegiaHoA: folds
voSAIKXtXUUbJnds83sYfQ: raises $20 to $30
1ScqYmNf7/uWx1XSBgPTBw: folds
jkH6qYMpn8JA/IyBOhQPMw: raises $70 to $100
ovpz8iX9p4XQ/6AFQrnDTw: folds
voSAIKXtXUUbJnds83sYfQ: folds
jkH6qYMpn8JA/IyBOhQPMw collected $70 from pot
jkH6qYMpn8JA/IyBOhQPMw: doesn't show hand
*** SUMMARY ***
Total pot $70 | Rake $0
Seat 1: NczJqEIUdrpEc5Nbd7h1Ig folded before Flop (didn't bet)
Seat 2: Xl+I49lxCJwPGRuegiaHoA folded before Flop (didn't bet)
Seat 3: voSAIKXtXUUbJnds83sYfQ folded before Flop
Seat 4: 1ScqYmNf7/uWx1XSBgPTBw (button) folded before Flop (didn't bet)
Seat 5: jkH6qYMpn8JA/IyBOhQPMw (small blind) collected ($70)
Seat 6: ovpz8iX9p4XQ/6AFQrnDTw (big blind) folded before Flop



PokerStars Game #59958953978:  Hold'em No Limit ($5/$10) - 2009/07/01 10:23:46 ET
Table '1Dt9cpcLUVE6HYkx5dUEdQ' 6-max Seat #5 is the button
Seat 1: 2PHCSXghjbGk2qR6jDFe2g ($1834 in chips)
Seat 2: zdS2zKkZYSRe8p+GVcXMgg ($567 in chips)
Seat 3: g/z/ANylbdR10I7oPCJdKQ ($516.25 in chips)
Seat 4: voSAIKXtXUUbJnds83sYfQ ($1000 in chips)
Seat 5: 7SUIdtQak1SCtldWHjwnFA ($200 in chips)
Seat 6: 3mTlg4g0FJN2bo939h/0Wg ($631 in chips)
3mTlg4g0FJN2bo939h/0Wg: posts small blind $5
2PHCSXghjbGk2qR6jDFe2g: posts big blind $10
*** HOLE CARDS ***
zdS2zKkZYSRe8p+GVcXMgg: raises $20 to $30
g/z/ANylbdR10I7oPCJdKQ: folds
voSAIKXtXUUbJnds83sYfQ: folds
7SUIdtQak1SCtldWHjwnFA: folds
3mTlg4g0FJN2bo939h/0Wg: folds
2PHCSXghjbGk2qR6jDFe2g: folds
zdS2zKkZYSRe8p+GVcXMgg collected $25 from pot
*** SUMMARY ***
Total pot $25 | Rake $0
Seat 1: 2PHCSXghjbGk2qR6jDFe2g (big blind) folded before Flop
Seat 2: zdS2zKkZYSRe8p+GVcXMgg collected ($25)
Seat 3: g/z/ANylbdR10I7oPCJdKQ folded before Flop (didn't bet)
Seat 4: voSAIKXtXUUbJnds83sYfQ folded before Flop (didn't bet)
Seat 5: 7SUIdtQak1SCtldWHjwnFA (button) folded before Flop (didn't bet)
Seat 6: 3mTlg4g0FJN2bo939h/0Wg (small blind) folded before Flop



PokerStars Game #59958970836:  Hold'em No Limit ($5/$10) - 2009/07/01 10:24:07 ET
Table '1Dt9cpcLUVE6HYkx5dUEdQ' 6-max Seat #6 is the button
Seat 1: 2PHCSXghjbGk2qR6jDFe2g ($1824 in chips)
Seat 2: zdS2zKkZYSRe8p+GVcXMgg ($582 in chips)
Seat 3: g/z/ANylbdR10I7oPCJdKQ ($516.25 in chips)
Seat 4: voSAIKXtXUUbJnds83sYfQ ($1000 in chips)
Seat 5: 7SUIdtQak1SCtldWHjwnFA ($200 in chips)
Seat 6: 3mTlg4g0FJN2bo939h/0Wg ($626 in chips)
2PHCSXghjbGk2qR6jDFe2g: posts small blind $5
zdS2zKkZYSRe8p+GVcXMgg: posts big blind $10
*** HOLE CARDS ***
g/z/ANylbdR10I7oPCJdKQ: raises $20 to $30
voSAIKXtXUUbJnds83sYfQ: calls $30
7SUIdtQak1SCtldWHjwnFA: folds
3mTlg4g0FJN2bo939h/0Wg: folds
2PHCSXghjbGk2qR6jDFe2g: folds
zdS2zKkZYSRe8p+GVcXMgg: calls $20
*** FLOP *** [6c 8d 6h]
zdS2zKkZYSRe8p+GVcXMgg: checks
g/z/ANylbdR10I7oPCJdKQ: checks
voSAIKXtXUUbJnds83sYfQ: bets $65
zdS2zKkZYSRe8p+GVcXMgg: calls $65
g/z/ANylbdR10I7oPCJdKQ: folds
*** TURN *** [6c 8d 6h] [9s]
zdS2zKkZYSRe8p+GVcXMgg: checks
voSAIKXtXUUbJnds83sYfQ: checks
*** RIVER *** [6c 8d 6h 9s] [5d]
zdS2zKkZYSRe8p+GVcXMgg: bets $120
voSAIKXtXUUbJnds83sYfQ: folds
zdS2zKkZYSRe8p+GVcXMgg collected $222 from pot
*** SUMMARY ***
Total pot $225 | Rake $3
Board [6c 8d 6h 9s 5d]
Seat 1: 2PHCSXghjbGk2qR6jDFe2g (small blind) folded before Flop
Seat 2: zdS2zKkZYSRe8p+GVcXMgg (big blind) collected ($222)
Seat 3: g/z/ANylbdR10I7oPCJdKQ folded on the Flop
Seat 4: voSAIKXtXUUbJnds83sYfQ folded on the River
Seat 5: 7SUIdtQak1SCtldWHjwnFA folded before Flop (didn't bet)
Seat 6: 3mTlg4g0FJN2bo939h/0Wg (button) folded before Flop (didn't bet)



PokerStars Game #59958972736:  Hold'em No Limit ($5/$10) - 2009/07/01 10:24:09 ET
Table '2a86NK3xhs21kwGZmbj0QA' 6-max Seat #5 is the button
Seat 1: NczJqEIUdrpEc5Nbd7h1Ig ($234.75 in chips)
Seat 2: Xl+I49lxCJwPGRuegiaHoA ($1158 in chips)
Seat 3: voSAIKXtXUUbJnds83sYfQ ($1014 in chips)
Seat 4: 1ScqYmNf7/uWx1XSBgPTBw ($287 in chips)
Seat 5: jkH6qYMpn8JA/IyBOhQPMw ($2052 in chips)
Seat 6: ovpz8iX9p4XQ/6AFQrnDTw ($705.30 in chips)
ovpz8iX9p4XQ/6AFQrnDTw: posts small blind $5
NczJqEIUdrpEc5Nbd7h1Ig: posts big blind $10
*** HOLE CARDS ***
Xl+I49lxCJwPGRuegiaHoA: folds
voSAIKXtXUUbJnds83sYfQ: raises $20 to $30
1ScqYmNf7/uWx1XSBgPTBw: folds
jkH6qYMpn8JA/IyBOhQPMw: calls $30
ovpz8iX9p4XQ/6AFQrnDTw: folds
NczJqEIUdrpEc5Nbd7h1Ig: calls $20
*** FLOP *** [5h Qc Tc]
NczJqEIUdrpEc5Nbd7h1Ig: checks
voSAIKXtXUUbJnds83sYfQ: checks
jkH6qYMpn8JA/IyBOhQPMw: checks
*** TURN *** [5h Qc Tc] [8d]
NczJqEIUdrpEc5Nbd7h1Ig: checks
voSAIKXtXUUbJnds83sYfQ: checks
jkH6qYMpn8JA/IyBOhQPMw: bets $72
NczJqEIUdrpEc5Nbd7h1Ig: raises $132.75 to $204.75 and is all-in
voSAIKXtXUUbJnds83sYfQ: folds
jkH6qYMpn8JA/IyBOhQPMw: folds
NczJqEIUdrpEc5Nbd7h1Ig collected $236 from pot
*** SUMMARY ***
Total pot $239 | Rake $3
Board [5h Qc Tc 8d]
Seat 1: NczJqEIUdrpEc5Nbd7h1Ig (big blind) collected ($236)
Seat 2: Xl+I49lxCJwPGRuegiaHoA folded before Flop (didn't bet)
Seat 3: voSAIKXtXUUbJnds83sYfQ folded on the Turn
Seat 4: 1ScqYmNf7/uWx1XSBgPTBw folded before Flop (didn't bet)
Seat 5: jkH6qYMpn8JA/IyBOhQPMw (button) folded on the Turn
Seat 6: ovpz8iX9p4XQ/6AFQrnDTw (small blind) folded before Flop



PokerStars Game #59959023634:  Hold'em No Limit ($5/$10) - 2009/07/01 10:25:14 ET
Table '1Dt9cpcLUVE6HYkx5dUEdQ' 6-max Seat #1 is the button
Seat 1: 2PHCSXghjbGk2qR6jDFe2g ($1819 in chips)
Seat 2: zdS2zKkZYSRe8p+GVcXMgg ($709 in chips)
Seat 3: g/z/ANylbdR10I7oPCJdKQ ($486.25 in chips)
Seat 4: voSAIKXtXUUbJnds83sYfQ ($1000 in chips)
Seat 5: 7SUIdtQak1SCtldWHjwnFA ($200 in chips)
Seat 6: 3mTlg4g0FJN2bo939h/0Wg ($626 in chips)
zdS2zKkZYSRe8p+GVcXMgg: posts small blind $5
g/z/ANylbdR10I7oPCJdKQ: posts big blind $10
*** HOLE CARDS ***
voSAIKXtXUUbJnds83sYfQ: folds
7SUIdtQak1SCtldWHjwnFA: folds
3mTlg4g0FJN2bo939h/0Wg: folds
2PHCSXghjbGk2qR6jDFe2g: folds
zdS2zKkZYSRe8p+GVcXMgg: folds
g/z/ANylbdR10I7oPCJdKQ collected $10 from pot
g/z/ANylbdR10I7oPCJdKQ: doesn't show hand
*** SUMMARY ***
Total pot $10 | Rake $0
Seat 1: 2PHCSXghjbGk2qR6jDFe2g (button) folded before Flop (didn't bet)
Seat 2: zdS2zKkZYSRe8p+GVcXMgg (small blind) folded before Flop
Seat 3: g/z/ANylbdR10I7oPCJdKQ (big blind) collected ($10)
Seat 4: voSAIKXtXUUbJnds83sYfQ folded before Flop (didn't bet)
Seat 5: 7SUIdtQak1SCtldWHjwnFA folded before Flop (didn't bet)
Seat 6: 3mTlg4g0FJN2bo939h/0Wg folded before Flop (didn't bet)



PokerStars Game #59959032268:  Hold'em No Limit ($5/$10) - 2009/07/01 10:25:25 ET
Table '2a86NK3xhs21kwGZmbj0QA' 6-max Seat #6 is the button
Seat 1: NczJqEIUdrpEc5Nbd7h1Ig ($368.75 in chips)
Seat 2: Xl+I49lxCJwPGRuegiaHoA ($1158 in chips)
Seat 3: voSAIKXtXUUbJnds83sYfQ ($1000 in chips)
Seat 4: 1ScqYmNf7/uWx1XSBgPTBw ($287 in chips)
Seat 5: jkH6qYMpn8JA/IyBOhQPMw ($1950 in chips)
Seat 6: ovpz8iX9p4XQ/6AFQrnDTw ($700.30 in chips)
NczJqEIUdrpEc5Nbd7h1Ig: posts small blind $5
Xl+I49lxCJwPGRuegiaHoA: posts big blind $10
*** HOLE CARDS ***
voSAIKXtXUUbJnds83sYfQ: folds
1ScqYmNf7/uWx1XSBgPTBw: folds
jkH6qYMpn8JA/IyBOhQPMw: raises $20 to $30
ovpz8iX9p4XQ/6AFQrnDTw: folds
NczJqEIUdrpEc5Nbd7h1Ig: calls $25
Xl+I49lxCJwPGRuegiaHoA: folds
*** FLOP *** [Qc Td Tc]
NczJqEIUdrpEc5Nbd7h1Ig: checks
jkH6qYMpn8JA/IyBOhQPMw: checks
*** TURN *** [Qc Td Tc] [3c]
NczJqEIUdrpEc5Nbd7h1Ig: bets $40
jkH6qYMpn8JA/IyBOhQPMw: raises $105 to $145
NczJqEIUdrpEc5Nbd7h1Ig: folds
jkH6qYMpn8JA/IyBOhQPMw collected $147 from pot
jkH6qYMpn8JA/IyBOhQPMw: doesn't show hand
*** SUMMARY ***
Total pot $150 | Rake $3
Board [Qc Td Tc 3c]
Seat 1: NczJqEIUdrpEc5Nbd7h1Ig (small blind) folded on the Turn
Seat 2: Xl+I49lxCJwPGRuegiaHoA (big blind) folded before Flop
Seat 3: voSAIKXtXUUbJnds83sYfQ folded before Flop (didn't bet)
Seat 4: 1ScqYmNf7/uWx1XSBgPTBw folded before Flop (didn't bet)
Seat 5: jkH6qYMpn8JA/IyBOhQPMw collected ($147)
Seat 6: ovpz8iX9p4XQ/6AFQrnDTw (button) folded before Flop (didn't bet)



PokerStars Game #59959038912:  Hold'em No Limit ($5/$10) - 2009/07/01 10:25:33 ET
Table 'IyraSBLp+yhyRE6/jd8spA' 2-max Seat #1 is the button
Seat 1: sVocLgrQLp4Ke1DJ2pbNKg ($1103 in chips)
Seat 2: ezwKQeNDkLTr+c7tP2UjNw ($1000 in chips)
sVocLgrQLp4Ke1DJ2pbNKg: posts small blind $5
ezwKQeNDkLTr+c7tP2UjNw: posts big blind $10
*** HOLE CARDS ***
sVocLgrQLp4Ke1DJ2pbNKg: raises $10 to $20
ezwKQeNDkLTr+c7tP2UjNw: raises $50 to $70
sVocLgrQLp4Ke1DJ2pbNKg: calls $50
*** FLOP *** [3h Td 7d]
ezwKQeNDkLTr+c7tP2UjNw: bets $100
sVocLgrQLp4Ke1DJ2pbNKg: calls $100
*** TURN *** [3h Td 7d] [6h]
ezwKQeNDkLTr+c7tP2UjNw: bets $277
sVocLgrQLp4Ke1DJ2pbNKg: folds
ezwKQeNDkLTr+c7tP2UjNw collected $339.50 from pot
ezwKQeNDkLTr+c7tP2UjNw: doesn't show hand
*** SUMMARY ***
Total pot $340 | Rake $0.50
Board [3h Td 7d 6h]
Seat 1: sVocLgrQLp4Ke1DJ2pbNKg (button) (small blind) folded on the Turn
Seat 2: ezwKQeNDkLTr+c7tP2UjNw (big blind) collected ($339.50)



PokerStars Game #59959044514:  Hold'em No Limit ($5/$10) - 2009/07/01 10:25:40 ET
Table '1Dt9cpcLUVE6HYkx5dUEdQ' 6-max Seat #2 is the button
Seat 1: 2PHCSXghjbGk2qR6jDFe2g ($1819 in chips)
Seat 2: zdS2zKkZYSRe8p+GVcXMgg ($704 in chips)
Seat 3: g/z/ANylbdR10I7oPCJdKQ ($491.25 in chips)
Seat 4: voSAIKXtXUUbJnds83sYfQ ($1000 in chips)
Seat 5: 7SUIdtQak1SCtldWHjwnFA ($200 in chips)
Seat 6: 3mTlg4g0FJN2bo939h/0Wg ($626 in chips)
g/z/ANylbdR10I7oPCJdKQ: posts small blind $5
voSAIKXtXUUbJnds83sYfQ: posts big blind $10
*** HOLE CARDS ***
7SUIdtQak1SCtldWHjwnFA: folds
3mTlg4g0FJN2bo939h/0Wg: raises $10 to $20
2PHCSXghjbGk2qR6jDFe2g: folds
zdS2zKkZYSRe8p+GVcXMgg: folds
g/z/ANylbdR10I7oPCJdKQ: folds
voSAIKXtXUUbJnds83sYfQ: folds
3mTlg4g0FJN2bo939h/0Wg collected $25 from pot
*** SUMMARY ***
Total pot $25 | Rake $0
Seat 1: 2PHCSXghjbGk2qR6jDFe2g folded before Flop (didn't bet)
Seat 2: zdS2zKkZYSRe8p+GVcXMgg (button) folded before Flop (didn't bet)
Seat 3: g/z/ANylbdR10I7oPCJdKQ (small blind) folded before Flop
Seat 4: voSAIKXtXUUbJnds83sYfQ (big blind) folded before Flop
Seat 5: 7SUIdtQak1SCtldWHjwnFA folded before Flop (didn't bet)
Seat 6: 3mTlg4g0FJN2bo939h/0Wg collected ($25)



PokerStars Game #59959065870:  Hold'em No Limit ($5/$10) - 2009/07/01 10:26:07 ET
Table '1Dt9cpcLUVE6HYkx5dUEdQ' 6-max Seat #3 is the button
Seat 1: 2PHCSXghjbGk2qR6jDFe2g ($1819 in chips)
Seat 2: zdS2zKkZYSRe8p+GVcXMgg ($704 in chips)
Seat 3: g/z/ANylbdR10I7oPCJdKQ ($486.25 in chips)
Seat 4: voSAIKXtXUUbJnds83sYfQ ($1000 in chips)
Seat 5: 7SUIdtQak1SCtldWHjwnFA ($200 in chips)
Seat 6: 3mTlg4g0FJN2bo939h/0Wg ($641 in chips)
voSAIKXtXUUbJnds83sYfQ: posts small blind $5
7SUIdtQak1SCtldWHjwnFA: posts big blind $10
*** HOLE CARDS ***
3mTlg4g0FJN2bo939h/0Wg: raises $20 to $30
2PHCSXghjbGk2qR6jDFe2g: folds
zdS2zKkZYSRe8p+GVcXMgg: calls $30
g/z/ANylbdR10I7oPCJdKQ: folds
voSAIKXtXUUbJnds83sYfQ: folds
7SUIdtQak1SCtldWHjwnFA: folds
*** FLOP *** [8c 3d 5c]
3mTlg4g0FJN2bo939h/0Wg: bets $30
zdS2zKkZYSRe8p+GVcXMgg: calls $30
*** TURN *** [8c 3d 5c] [9c]
3mTlg4g0FJN2bo939h/0Wg: bets $100
zdS2zKkZYSRe8p+GVcXMgg: folds
3mTlg4g0FJN2bo939h/0Wg collected $132 from pot
*** SUMMARY ***
Total pot $135 | Rake $3
Board [8c 3d 5c 9c]
Seat 1: 2PHCSXghjbGk2qR6jDFe2g folded before Flop (didn't bet)
Seat 2: zdS2zKkZYSRe8p+GVcXMgg folded on the Turn
Seat 3: g/z/ANylbdR10I7oPCJdKQ (button) folded before Flop (didn't bet)
Seat 4: voSAIKXtXUUbJnds83sYfQ (small blind) folded before Flop
Seat 5: 7SUIdtQak1SCtldWHjwnFA (big blind) folded before Flop
Seat 6: 3mTlg4g0FJN2bo939h/0Wg collected ($132)



PokerStars Game #59959069272:  Hold'em No Limit ($5/$10) - 2009/07/01 10:26:11 ET
Table '2a86NK3xhs21kwGZmbj0QA' 6-max Seat #1 is the button
Seat 1: NczJqEIUdrpEc5Nbd7h1Ig ($298.75 in chips)
Seat 2: Xl+I49lxCJwPGRuegiaHoA ($1148 in chips)
Seat 3: voSAIKXtXUUbJnds83sYfQ ($1000 in chips)
Seat 4: 1ScqYmNf7/uWx1XSBgPTBw ($287 in chips)
Seat 5: jkH6qYMpn8JA/IyBOhQPMw ($2027 in chips)
Seat 6: ovpz8iX9p4XQ/6AFQrnDTw ($700.30 in chips)
Xl+I49lxCJwPGRuegiaHoA: posts small blind $5
voSAIKXtXUUbJnds83sYfQ: posts big blind $10
*** HOLE CARDS ***
1ScqYmNf7/uWx1XSBgPTBw: folds
jkH6qYMpn8JA/IyBOhQPMw: folds
ovpz8iX9p4XQ/6AFQrnDTw: folds
NczJqEIUdrpEc5Nbd7h1Ig: raises $20 to $30
Xl+I49lxCJwPGRuegiaHoA: calls $25
voSAIKXtXUUbJnds83sYfQ: folds
*** FLOP *** [2c As 8h]
Xl+I49lxCJwPGRuegiaHoA: checks
NczJqEIUdrpEc5Nbd7h1Ig: bets $50
Xl+I49lxCJwPGRuegiaHoA: folds
NczJqEIUdrpEc5Nbd7h1Ig collected $67 from pot
*** SUMMARY ***
Total pot $70 | Rake $3
Board [2c As 8h]
Seat 1: NczJqEIUdrpEc5Nbd7h1Ig (button) collected ($67)
Seat 2: Xl+I49lxCJwPGRuegiaHoA (small blind) folded on the Flop
Seat 3: voSAIKXtXUUbJnds83sYfQ (big blind) folded before Flop
Seat 4: 1ScqYmNf7/uWx1XSBgPTBw folded before Flop (didn't bet)
Seat 5: jkH6qYMpn8JA/IyBOhQPMw folded before Flop (didn't bet)
Seat 6: ovpz8iX9p4XQ/6AFQrnDTw folded before Flop (didn't bet)



PokerStars Game #59959081388:  Hold'em No Limit ($5/$10) - 2009/07/01 10:26:27 ET
Table 'IyraSBLp+yhyRE6/jd8spA' 2-max Seat #2 is the button
Seat 1: sVocLgrQLp4Ke1DJ2pbNKg ($1000 in chips)
Seat 2: ezwKQeNDkLTr+c7tP2UjNw ($1169.50 in chips)
ezwKQeNDkLTr+c7tP2UjNw: posts small blind $5
sVocLgrQLp4Ke1DJ2pbNKg: posts big blind $10
*** HOLE CARDS ***
ezwKQeNDkLTr+c7tP2UjNw: folds
sVocLgrQLp4Ke1DJ2pbNKg collected $10 from pot
*** SUMMARY ***
Total pot $10 | Rake $0
Seat 1: sVocLgrQLp4Ke1DJ2pbNKg (big blind) collected ($10)
Seat 2: ezwKQeNDkLTr+c7tP2UjNw (button) (small blind) folded before Flop



PokerStars Game #59959085598:  Hold'em No Limit ($5/$10) - 2009/07/01 10:26:32 ET
Table 'IyraSBLp+yhyRE6/jd8spA' 2-max Seat #1 is the button
Seat 1: sVocLgrQLp4Ke1DJ2pbNKg ($1005 in chips)
Seat 2: ezwKQeNDkLTr+c7tP2UjNw ($1164.50 in chips)
sVocLgrQLp4Ke1DJ2pbNKg: posts small blind $5
ezwKQeNDkLTr+c7tP2UjNw: posts big blind $10
*** HOLE CARDS ***
sVocLgrQLp4Ke1DJ2pbNKg: raises $20 to $30
ezwKQeNDkLTr+c7tP2UjNw: folds
sVocLgrQLp4Ke1DJ2pbNKg collected $20 from pot
*** SUMMARY ***
Total pot $20 | Rake $0
Seat 1: sVocLgrQLp4Ke1DJ2pbNKg (button) (small blind) collected ($20)
Seat 2: ezwKQeNDkLTr+c7tP2UjNw (big blind) folded before Flop



PokerStars Game #59959090534:  Hold'em No Limit ($5/$10) - 2009/07/01 10:26:38 ET
Table 'IyraSBLp+yhyRE6/jd8spA' 2-max Seat #2 is the button
Seat 1: sVocLgrQLp4Ke1DJ2pbNKg ($1015 in chips)
Seat 2: ezwKQeNDkLTr+c7tP2UjNw ($1154.50 in chips)
ezwKQeNDkLTr+c7tP2UjNw: posts small blind $5
sVocLgrQLp4Ke1DJ2pbNKg: posts big blind $10
*** HOLE CARDS ***
ezwKQeNDkLTr+c7tP2UjNw: raises $20 to $30
sVocLgrQLp4Ke1DJ2pbNKg: folds
ezwKQeNDkLTr+c7tP2UjNw collected $20 from pot
ezwKQeNDkLTr+c7tP2UjNw: doesn't show hand
*** SUMMARY ***
Total pot $20 | Rake $0
Seat 1: sVocLgrQLp4Ke1DJ2pbNKg (big blind) folded before Flop
Seat 2: ezwKQeNDkLTr+c7tP2UjNw (button) (small blind) collected ($20)



PokerStars Game #59959091536:  Hold'em No Limit ($5/$10) - 2009/07/01 10:26:40 ET
Table '2a86NK3xhs21kwGZmbj0QA' 6-max Seat #2 is the button
Seat 1: NczJqEIUdrpEc5Nbd7h1Ig ($335.75 in chips)
Seat 2: Xl+I49lxCJwPGRuegiaHoA ($1118 in chips)
Seat 3: voSAIKXtXUUbJnds83sYfQ ($1000 in chips)
Seat 4: 1ScqYmNf7/uWx1XSBgPTBw ($287 in chips)
Seat 5: jkH6qYMpn8JA/IyBOhQPMw ($2027 in chips)
Seat 6: ovpz8iX9p4XQ/6AFQrnDTw ($700.30 in chips)
voSAIKXtXUUbJnds83sYfQ: posts small blind $5
1ScqYmNf7/uWx1XSBgPTBw: posts big blind $10
*** HOLE CARDS ***
jkH6qYMpn8JA/IyBOhQPMw: folds
ovpz8iX9p4XQ/6AFQrnDTw: folds
NczJqEIUdrpEc5Nbd7h1Ig: calls $10
Xl+I49lxCJwPGRuegiaHoA: folds
voSAIKXtXUUbJnds83sYfQ: raises $35 to $45
1ScqYmNf7/uWx1XSBgPTBw: folds
NczJqEIUdrpEc5Nbd7h1Ig: calls $35
*** FLOP *** [Qh 5s Qd]
voSAIKXtXUUbJnds83sYfQ: bets $60
NczJqEIUdrpEc5Nbd7h1Ig: calls $60
*** TURN *** [Qh 5s Qd] [Th]
ovpz8iX9p4XQ/6AFQrnDTw leaves the table
voSAIKXtXUUbJnds83sYfQ: checks
NczJqEIUdrpEc5Nbd7h1Ig: bets $150
voSAIKXtXUUbJnds83sYfQ: folds
NczJqEIUdrpEc5Nbd7h1Ig collected $217 from pot
*** SUMMARY ***
Total pot $220 | Rake $3
Board [Qh 5s Qd Th]
Seat 1: NczJqEIUdrpEc5Nbd7h1Ig collected ($217)
Seat 2: Xl+I49lxCJwPGRuegiaHoA (button) folded before Flop (didn't bet)
Seat 3: voSAIKXtXUUbJnds83sYfQ (small blind) folded on the Turn
Seat 4: 1ScqYmNf7/uWx1XSBgPTBw (big blind) folded before Flop
Seat 5: jkH6qYMpn8JA/IyBOhQPMw folded before Flop (didn't bet)
Seat 6: ovpz8iX9p4XQ/6AFQrnDTw folded before Flop (didn't bet)



PokerStars Game #59959096804:  Hold'em No Limit ($5/$10) - 2009/07/01 10:26:46 ET
Table '1Dt9cpcLUVE6HYkx5dUEdQ' 6-max Seat #4 is the button
Seat 1: 2PHCSXghjbGk2qR6jDFe2g ($1819 in chips)
Seat 2: zdS2zKkZYSRe8p+GVcXMgg ($644 in chips)
Seat 3: g/z/ANylbdR10I7oPCJdKQ ($486.25 in chips)
Seat 4: voSAIKXtXUUbJnds83sYfQ ($1000 in chips)
Seat 5: 7SUIdtQak1SCtldWHjwnFA ($190 in chips)
Seat 6: 3mTlg4g0FJN2bo939h/0Wg ($713 in chips)
7SUIdtQak1SCtldWHjwnFA: posts small blind $5
3mTlg4g0FJN2bo939h/0Wg: posts big blind $10
*** HOLE CARDS ***
2PHCSXghjbGk2qR6jDFe2g: folds
zdS2zKkZYSRe8p+GVcXMgg: calls $10
g/z/ANylbdR10I7oPCJdKQ: calls $10
voSAIKXtXUUbJnds83sYfQ: folds
7SUIdtQak1SCtldWHjwnFA: folds
3mTlg4g0FJN2bo939h/0Wg: checks
*** FLOP *** [8h Kd Ts]
3mTlg4g0FJN2bo939h/0Wg: checks
zdS2zKkZYSRe8p+GVcXMgg: checks
g/z/ANylbdR10I7oPCJdKQ: bets $20
3mTlg4g0FJN2bo939h/0Wg: calls $20
zdS2zKkZYSRe8p+GVcXMgg: folds
*** TURN *** [8h Kd Ts] [7h]
3mTlg4g0FJN2bo939h/0Wg: checks
g/z/ANylbdR10I7oPCJdKQ: bets $30
3mTlg4g0FJN2bo939h/0Wg: folds
g/z/ANylbdR10I7oPCJdKQ collected $72 from pot
g/z/ANylbdR10I7oPCJdKQ: doesn't show hand
*** SUMMARY ***
Total pot $75 | Rake $3
Board [8h Kd Ts 7h]
Seat 1: 2PHCSXghjbGk2qR6jDFe2g folded before Flop (didn't bet)
Seat 2: zdS2zKkZYSRe8p+GVcXMgg folded on the Flop
Seat 3: g/z/ANylbdR10I7oPCJdKQ collected ($72)
Seat 4: voSAIKXtXUUbJnds83sYfQ (button) folded before Flop (didn't bet)
Seat 5: 7SUIdtQak1SCtldWHjwnFA (small blind) folded before Flop
Seat 6: 3mTlg4g0FJN2bo939h/0Wg (big blind) folded on the Turn



PokerStars Game #59959098890:  Hold'em No Limit ($5/$10) - 2009/07/01 10:26:49 ET
Table 'IyraSBLp+yhyRE6/jd8spA' 2-max Seat #1 is the button
Seat 1: sVocLgrQLp4Ke1DJ2pbNKg ($1005 in chips)
Seat 2: ezwKQeNDkLTr+c7tP2UjNw ($1164.50 in chips)
sVocLgrQLp4Ke1DJ2pbNKg: posts small blind $5
ezwKQeNDkLTr+c7tP2UjNw: posts big blind $10
*** HOLE CARDS ***
sVocLgrQLp4Ke1DJ2pbNKg: raises $20 to $30
ezwKQeNDkLTr+c7tP2UjNw: raises $70 to $100
sVocLgrQLp4Ke1DJ2pbNKg: folds
ezwKQeNDkLTr+c7tP2UjNw collected $60 from pot
ezwKQeNDkLTr+c7tP2UjNw: doesn't show hand
*** SUMMARY ***
Total pot $60 | Rake $0
Seat 1: sVocLgrQLp4Ke1DJ2pbNKg (button) (small blind) folded before Flop
Seat 2: ezwKQeNDkLTr+c7tP2UjNw (big blind) collected ($60)



PokerStars Game #59959109540:  Hold'em No Limit ($5/$10) - 2009/07/01 10:27:02 ET
Table 'IyraSBLp+yhyRE6/jd8spA' 2-max Seat #2 is the button
Seat 1: sVocLgrQLp4Ke1DJ2pbNKg ($1000 in chips)
Seat 2: ezwKQeNDkLTr+c7tP2UjNw ($1194.50 in chips)
ezwKQeNDkLTr+c7tP2UjNw: posts small blind $5
sVocLgrQLp4Ke1DJ2pbNKg: posts big blind $10
*** HOLE CARDS ***
ezwKQeNDkLTr+c7tP2UjNw: folds
sVocLgrQLp4Ke1DJ2pbNKg collected $10 from pot
*** SUMMARY ***
Total pot $10 | Rake $0
Seat 1: sVocLgrQLp4Ke1DJ2pbNKg (big blind) collected ($10)
Seat 2: ezwKQeNDkLTr+c7tP2UjNw (button) (small blind) folded before Flop



PokerStars Game #59959113894:  Hold'em No Limit ($5/$10) - 2009/07/01 10:27:08 ET
Table 'IyraSBLp+yhyRE6/jd8spA' 2-max Seat #1 is the button
Seat 1: sVocLgrQLp4Ke1DJ2pbNKg ($1005 in chips)
Seat 2: ezwKQeNDkLTr+c7tP2UjNw ($1189.50 in chips)
sVocLgrQLp4Ke1DJ2pbNKg: posts small blind $5
ezwKQeNDkLTr+c7tP2UjNw: posts big blind $10
*** HOLE CARDS ***
sVocLgrQLp4Ke1DJ2pbNKg: raises $20 to $30
ezwKQeNDkLTr+c7tP2UjNw: raises $70 to $100
sVocLgrQLp4Ke1DJ2pbNKg: raises $905 to $1005 and is all-in
ezwKQeNDkLTr+c7tP2UjNw: calls $905
*** FLOP *** [Js 7h Kh]
*** TURN *** [Js 7h Kh] [4h]
*** RIVER *** [Js 7h Kh 4h] [Ts]
*** SHOW DOWN ***
ezwKQeNDkLTr+c7tP2UjNw: shows [Kd Qs] (a pair of Kings)
sVocLgrQLp4Ke1DJ2pbNKg: mucks hand
ezwKQeNDkLTr+c7tP2UjNw collected $2009.50 from pot
*** SUMMARY ***
Total pot $2010 | Rake $0.50
Board [Js 7h Kh 4h Ts]
Seat 1: sVocLgrQLp4Ke1DJ2pbNKg (button) (small blind) mucked
Seat 2: ezwKQeNDkLTr+c7tP2UjNw (big blind) showed [Kd Qs] and won ($2009.50) with a pair of Kings



PokerStars Game #59959131606:  Hold'em No Limit ($5/$10) - 2009/07/01 10:27:30 ET
Table 'IyraSBLp+yhyRE6/jd8spA' 2-max Seat #2 is the button
Seat 1: sVocLgrQLp4Ke1DJ2pbNKg ($1000 in chips)
Seat 2: ezwKQeNDkLTr+c7tP2UjNw ($2194 in chips)
ezwKQeNDkLTr+c7tP2UjNw: posts small blind $5
sVocLgrQLp4Ke1DJ2pbNKg: posts big blind $10
*** HOLE CARDS ***
ezwKQeNDkLTr+c7tP2UjNw: folds
sVocLgrQLp4Ke1DJ2pbNKg collected $10 from pot
*** SUMMARY ***
Total pot $10 | Rake $0
Seat 1: sVocLgrQLp4Ke1DJ2pbNKg (big blind) collected ($10)
Seat 2: ezwKQeNDkLTr+c7tP2UjNw (button) (small blind) folded before Flop



PokerStars Game #59959136316:  Hold'em No Limit ($5/$10) - 2009/07/01 10:27:36 ET
Table 'IyraSBLp+yhyRE6/jd8spA' 2-max Seat #1 is the button
Seat 1: sVocLgrQLp4Ke1DJ2pbNKg ($1005 in chips)
Seat 2: ezwKQeNDkLTr+c7tP2UjNw ($2189 in chips)
sVocLgrQLp4Ke1DJ2pbNKg: posts small blind $5
ezwKQeNDkLTr+c7tP2UjNw: posts big blind $10
*** HOLE CARDS ***
sVocLgrQLp4Ke1DJ2pbNKg: raises $20 to $30
ezwKQeNDkLTr+c7tP2UjNw: folds
sVocLgrQLp4Ke1DJ2pbNKg collected $20 from pot
sVocLgrQLp4Ke1DJ2pbNKg: doesn't show hand
*** SUMMARY ***
Total pot $20 | Rake $0
Seat 1: sVocLgrQLp4Ke1DJ2pbNKg (button) (small blind) collected ($20)
Seat 2: ezwKQeNDkLTr+c7tP2UjNw (big blind) folded before Flop



PokerStars Game #59959138030:  Hold'em No Limit ($5/$10) - 2009/07/01 10:27:38 ET
Table '2a86NK3xhs21kwGZmbj0QA' 6-max Seat #3 is the button
Seat 1: NczJqEIUdrpEc5Nbd7h1Ig ($447.75 in chips)
Seat 2: Xl+I49lxCJwPGRuegiaHoA ($1118 in chips)
Seat 3: voSAIKXtXUUbJnds83sYfQ ($1000 in chips)
Seat 4: 1ScqYmNf7/uWx1XSBgPTBw ($277 in chips)
Seat 5: jkH6qYMpn8JA/IyBOhQPMw ($2027 in chips)
1ScqYmNf7/uWx1XSBgPTBw: posts small blind $5
jkH6qYMpn8JA/IyBOhQPMw: posts big blind $10
*** HOLE CARDS ***
NczJqEIUdrpEc5Nbd7h1Ig: folds
Xl+I49lxCJwPGRuegiaHoA: folds
voSAIKXtXUUbJnds83sYfQ: folds
1ScqYmNf7/uWx1XSBgPTBw: folds
jkH6qYMpn8JA/IyBOhQPMw collected $10 from pot
jkH6qYMpn8JA/IyBOhQPMw: doesn't show hand
*** SUMMARY ***
Total pot $10 | Rake $0
Seat 1: NczJqEIUdrpEc5Nbd7h1Ig folded before Flop (didn't bet)
Seat 2: Xl+I49lxCJwPGRuegiaHoA folded before Flop (didn't bet)
Seat 3: voSAIKXtXUUbJnds83sYfQ (button) folded before Flop (didn't bet)
Seat 4: 1ScqYmNf7/uWx1XSBgPTBw (small blind) folded before Flop
Seat 5: jkH6qYMpn8JA/IyBOhQPMw (big blind) collected ($10)



PokerStars Game #59959141114:  Hold'em No Limit ($5/$10) - 2009/07/01 10:27:42 ET
Table 'IyraSBLp+yhyRE6/jd8spA' 2-max Seat #2 is the button
Seat 1: sVocLgrQLp4Ke1DJ2pbNKg ($1015 in chips)
Seat 2: ezwKQeNDkLTr+c7tP2UjNw ($2179 in chips)
ezwKQeNDkLTr+c7tP2UjNw: posts small blind $5
sVocLgrQLp4Ke1DJ2pbNKg: posts big blind $10
*** HOLE CARDS ***
ezwKQeNDkLTr+c7tP2UjNw: raises $20 to $30
sVocLgrQLp4Ke1DJ2pbNKg: folds
ezwKQeNDkLTr+c7tP2UjNw collected $20 from pot
ezwKQeNDkLTr+c7tP2UjNw: doesn't show hand
*** SUMMARY ***
Total pot $20 | Rake $0
Seat 1: sVocLgrQLp4Ke1DJ2pbNKg (big blind) folded before Flop
Seat 2: ezwKQeNDkLTr+c7tP2UjNw (button) (small blind) collected ($20)



PokerStars Game #59959147034:  Hold'em No Limit ($5/$10) - 2009/07/01 10:27:49 ET
Table 'IyraSBLp+yhyRE6/jd8spA' 2-max Seat #1 is the button
Seat 1: sVocLgrQLp4Ke1DJ2pbNKg ($1005 in chips)
Seat 2: ezwKQeNDkLTr+c7tP2UjNw ($2189 in chips)
sVocLgrQLp4Ke1DJ2pbNKg: posts small blind $5
ezwKQeNDkLTr+c7tP2UjNw: posts big blind $10
*** HOLE CARDS ***
sVocLgrQLp4Ke1DJ2pbNKg: raises $20 to $30
ezwKQeNDkLTr+c7tP2UjNw: calls $20
*** FLOP *** [7c Ad 3s]
ezwKQeNDkLTr+c7tP2UjNw: checks
sVocLgrQLp4Ke1DJ2pbNKg: checks
*** TURN *** [7c Ad 3s] [3c]
ezwKQeNDkLTr+c7tP2UjNw: checks
sVocLgrQLp4Ke1DJ2pbNKg: bets $30
ezwKQeNDkLTr+c7tP2UjNw: folds
sVocLgrQLp4Ke1DJ2pbNKg collected $59.50 from pot
*** SUMMARY ***
Total pot $60 | Rake $0.50
Board [7c Ad 3s 3c]
Seat 1: sVocLgrQLp4Ke1DJ2pbNKg (button) (small blind) collected ($59.50)
Seat 2: ezwKQeNDkLTr+c7tP2UjNw (big blind) folded on the Turn



PokerStars Game #59959151736:  Hold'em No Limit ($5/$10) - 2009/07/01 10:27:56 ET
Table '1Dt9cpcLUVE6HYkx5dUEdQ' 6-max Seat #5 is the button
Seat 1: 2PHCSXghjbGk2qR6jDFe2g ($1819 in chips)
Seat 2: zdS2zKkZYSRe8p+GVcXMgg ($634 in chips)
Seat 3: g/z/ANylbdR10I7oPCJdKQ ($528.25 in chips)
Seat 4: voSAIKXtXUUbJnds83sYfQ ($1000 in chips)
Seat 5: 7SUIdtQak1SCtldWHjwnFA ($185 in chips)
Seat 6: 3mTlg4g0FJN2bo939h/0Wg ($683 in chips)
3mTlg4g0FJN2bo939h/0Wg: posts small blind $5
2PHCSXghjbGk2qR6jDFe2g: posts big blind $10
*** HOLE CARDS ***
zdS2zKkZYSRe8p+GVcXMgg: calls $10
g/z/ANylbdR10I7oPCJdKQ: raises $20 to $30
voSAIKXtXUUbJnds83sYfQ: folds
7SUIdtQak1SCtldWHjwnFA: folds
3mTlg4g0FJN2bo939h/0Wg: folds
2PHCSXghjbGk2qR6jDFe2g: folds
zdS2zKkZYSRe8p+GVcXMgg: calls $20
*** FLOP *** [4s 3d Js]
zdS2zKkZYSRe8p+GVcXMgg: checks
g/z/ANylbdR10I7oPCJdKQ: bets $30
zdS2zKkZYSRe8p+GVcXMgg: calls $30
*** TURN *** [4s 3d Js] [7h]
zdS2zKkZYSRe8p+GVcXMgg: checks
g/z/ANylbdR10I7oPCJdKQ: bets $60
zdS2zKkZYSRe8p+GVcXMgg: calls $60
*** RIVER *** [4s 3d Js 7h] [Th]
zdS2zKkZYSRe8p+GVcXMgg: checks
g/z/ANylbdR10I7oPCJdKQ: bets $70
zdS2zKkZYSRe8p+GVcXMgg: calls $70
*** SHOW DOWN ***
g/z/ANylbdR10I7oPCJdKQ: shows [Jc Jh] (three of a kind, Jacks)
zdS2zKkZYSRe8p+GVcXMgg: mucks hand
g/z/ANylbdR10I7oPCJdKQ collected $392 from pot
*** SUMMARY ***
Total pot $395 | Rake $3
Board [4s 3d Js 7h Th]
Seat 1: 2PHCSXghjbGk2qR6jDFe2g (big blind) folded before Flop
Seat 2: zdS2zKkZYSRe8p+GVcXMgg mucked
Seat 3: g/z/ANylbdR10I7oPCJdKQ showed [Jc Jh] and won ($392) with three of a kind, Jacks
Seat 4: voSAIKXtXUUbJnds83sYfQ folded before Flop (didn't bet)
Seat 5: 7SUIdtQak1SCtldWHjwnFA (button) folded before Flop (didn't bet)
Seat 6: 3mTlg4g0FJN2bo939h/0Wg (small blind) folded before Flop



PokerStars Game #59959152904:  Hold'em No Limit ($5/$10) - 2009/07/01 10:27:57 ET
Table '2a86NK3xhs21kwGZmbj0QA' 6-max Seat #4 is the button
Seat 1: NczJqEIUdrpEc5Nbd7h1Ig ($447.75 in chips)
Seat 2: Xl+I49lxCJwPGRuegiaHoA ($1118 in chips)
Seat 3: voSAIKXtXUUbJnds83sYfQ ($1000 in chips)
Seat 4: 1ScqYmNf7/uWx1XSBgPTBw ($272 in chips)
Seat 5: jkH6qYMpn8JA/IyBOhQPMw ($2032 in chips)
jkH6qYMpn8JA/IyBOhQPMw: posts small blind $5
NczJqEIUdrpEc5Nbd7h1Ig: posts big blind $10
*** HOLE CARDS ***
Xl+I49lxCJwPGRuegiaHoA: folds
voSAIKXtXUUbJnds83sYfQ: folds
1ScqYmNf7/uWx1XSBgPTBw: folds
jkH6qYMpn8JA/IyBOhQPMw: folds
NczJqEIUdrpEc5Nbd7h1Ig collected $10 from pot
*** SUMMARY ***
Total pot $10 | Rake $0
Seat 1: NczJqEIUdrpEc5Nbd7h1Ig (big blind) collected ($10)
Seat 2: Xl+I49lxCJwPGRuegiaHoA folded before Flop (didn't bet)
Seat 3: voSAIKXtXUUbJnds83sYfQ folded before Flop (didn't bet)
Seat 4: 1ScqYmNf7/uWx1XSBgPTBw (button) folded before Flop (didn't bet)
Seat 5: jkH6qYMpn8JA/IyBOhQPMw (small blind) folded before Flop



PokerStars Game #59959159622:  Hold'em No Limit ($5/$10) - 2009/07/01 10:28:05 ET
Table 'IyraSBLp+yhyRE6/jd8spA' 2-max Seat #2 is the button
Seat 1: sVocLgrQLp4Ke1DJ2pbNKg ($1034.50 in chips)
Seat 2: ezwKQeNDkLTr+c7tP2UjNw ($2159 in chips)
ezwKQeNDkLTr+c7tP2UjNw: posts small blind $5
sVocLgrQLp4Ke1DJ2pbNKg: posts big blind $10
*** HOLE CARDS ***
ezwKQeNDkLTr+c7tP2UjNw: raises $20 to $30
sVocLgrQLp4Ke1DJ2pbNKg: calls $20
*** FLOP *** [9c 6d 4h]
sVocLgrQLp4Ke1DJ2pbNKg: checks
ezwKQeNDkLTr+c7tP2UjNw: checks
*** TURN *** [9c 6d 4h] [Ks]
sVocLgrQLp4Ke1DJ2pbNKg: checks
ezwKQeNDkLTr+c7tP2UjNw: checks
*** RIVER *** [9c 6d 4h Ks] [5d]
sVocLgrQLp4Ke1DJ2pbNKg: checks
ezwKQeNDkLTr+c7tP2UjNw: checks
*** SHOW DOWN ***
sVocLgrQLp4Ke1DJ2pbNKg: shows [As 4s] (a pair of Fours)
ezwKQeNDkLTr+c7tP2UjNw: mucks hand
sVocLgrQLp4Ke1DJ2pbNKg collected $59.50 from pot
*** SUMMARY ***
Total pot $60 | Rake $0.50
Board [9c 6d 4h Ks 5d]
Seat 1: sVocLgrQLp4Ke1DJ2pbNKg (big blind) showed [As 4s] and won ($59.50) with a pair of Fours
Seat 2: ezwKQeNDkLTr+c7tP2UjNw (button) (small blind) mucked



PokerStars Game #59959162566:  Hold'em No Limit ($5/$10) - 2009/07/01 10:28:09 ET
Table '2a86NK3xhs21kwGZmbj0QA' 6-max Seat #5 is the button
Seat 1: NczJqEIUdrpEc5Nbd7h1Ig ($452.75 in chips)
Seat 2: Xl+I49lxCJwPGRuegiaHoA ($1118 in chips)
Seat 3: voSAIKXtXUUbJnds83sYfQ ($1000 in chips)
Seat 4: 1ScqYmNf7/uWx1XSBgPTBw ($272 in chips)
Seat 5: jkH6qYMpn8JA/IyBOhQPMw ($2027 in chips)
NczJqEIUdrpEc5Nbd7h1Ig: posts small blind $5
Xl+I49lxCJwPGRuegiaHoA: posts big blind $10
*** HOLE CARDS ***
voSAIKXtXUUbJnds83sYfQ: calls $10
1ScqYmNf7/uWx1XSBgPTBw: folds
jkH6qYMpn8JA/IyBOhQPMw: folds
NczJqEIUdrpEc5Nbd7h1Ig: calls $5
Xl+I49lxCJwPGRuegiaHoA: checks
*** FLOP *** [Tc 6h Jh]
NczJqEIUdrpEc5Nbd7h1Ig: bets $40
Xl+I49lxCJwPGRuegiaHoA: folds
voSAIKXtXUUbJnds83sYfQ: calls $40
*** TURN *** [Tc 6h Jh] [2h]
NczJqEIUdrpEc5Nbd7h1Ig: bets $100
voSAIKXtXUUbJnds83sYfQ: folds
NczJqEIUdrpEc5Nbd7h1Ig collected $108 from pot
*** SUMMARY ***
Total pot $110 | Rake $2
Board [Tc 6h Jh 2h]
Seat 1: NczJqEIUdrpEc5Nbd7h1Ig (small blind) collected ($108)
Seat 2: Xl+I49lxCJwPGRuegiaHoA (big blind) folded on the Flop
Seat 3: voSAIKXtXUUbJnds83sYfQ folded on the Turn
Seat 4: 1ScqYmNf7/uWx1XSBgPTBw folded before Flop (didn't bet)
Seat 5: jkH6qYMpn8JA/IyBOhQPMw (button) folded before Flop (didn't bet)



PokerStars Game #59959170918:  Hold'em No Limit ($5/$10) - 2009/07/01 10:28:20 ET
Table 'IyraSBLp+yhyRE6/jd8spA' 2-max Seat #1 is the button
Seat 1: sVocLgrQLp4Ke1DJ2pbNKg ($1064 in chips)
Seat 2: ezwKQeNDkLTr+c7tP2UjNw ($2129 in chips)
sVocLgrQLp4Ke1DJ2pbNKg: posts small blind $5
ezwKQeNDkLTr+c7tP2UjNw: posts big blind $10
*** HOLE CARDS ***
sVocLgrQLp4Ke1DJ2pbNKg: raises $20 to $30
ezwKQeNDkLTr+c7tP2UjNw: raises $70 to $100
sVocLgrQLp4Ke1DJ2pbNKg: folds
ezwKQeNDkLTr+c7tP2UjNw collected $60 from pot
ezwKQeNDkLTr+c7tP2UjNw: doesn't show hand
*** SUMMARY ***
Total pot $60 | Rake $0
Seat 1: sVocLgrQLp4Ke1DJ2pbNKg (button) (small blind) folded before Flop
Seat 2: ezwKQeNDkLTr+c7tP2UjNw (big blind) collected ($60)



PokerStars Game #59959178136:  Hold'em No Limit ($5/$10) - 2009/07/01 10:28:29 ET
Table 'IyraSBLp+yhyRE6/jd8spA' 2-max Seat #2 is the button
Seat 1: sVocLgrQLp4Ke1DJ2pbNKg ($1034 in chips)
Seat 2: ezwKQeNDkLTr+c7tP2UjNw ($2159 in chips)
ezwKQeNDkLTr+c7tP2UjNw: posts small blind $5
sVocLgrQLp4Ke1DJ2pbNKg: posts big blind $10
*** HOLE CARDS ***
ezwKQeNDkLTr+c7tP2UjNw: raises $20 to $30
sVocLgrQLp4Ke1DJ2pbNKg: raises $70 to $100
ezwKQeNDkLTr+c7tP2UjNw: calls $70
*** FLOP *** [Th Kh Qc]
sVocLgrQLp4Ke1DJ2pbNKg: bets $140
ezwKQeNDkLTr+c7tP2UjNw: calls $140
*** TURN *** [Th Kh Qc] [Jd]
sVocLgrQLp4Ke1DJ2pbNKg: checks
ezwKQeNDkLTr+c7tP2UjNw: checks
*** RIVER *** [Th Kh Qc Jd] [Ad]
sVocLgrQLp4Ke1DJ2pbNKg: bets $794 and is all-in
ezwKQeNDkLTr+c7tP2UjNw: calls $794
*** SHOW DOWN ***
sVocLgrQLp4Ke1DJ2pbNKg: shows [Kc Jc] (a straight, Ten to Ace)
ezwKQeNDkLTr+c7tP2UjNw: shows [Kd 6d] (a straight, Ten to Ace)
sVocLgrQLp4Ke1DJ2pbNKg collected $1033.75 from pot
ezwKQeNDkLTr+c7tP2UjNw collected $1033.75 from pot
*** SUMMARY ***
Total pot $2068 | Rake $0.50
Board [Th Kh Qc Jd Ad]
Seat 1: sVocLgrQLp4Ke1DJ2pbNKg (big blind) showed [Kc Jc] and won ($1033.75) with a straight, Ten to Ace
Seat 2: ezwKQeNDkLTr+c7tP2UjNw (button) (small blind) showed [Kd 6d] and won ($1033.75) with a straight, Ten to Ace



PokerStars Game #59959194366:  Hold'em No Limit ($5/$10) - 2009/07/01 10:28:49 ET
Table 'IyraSBLp+yhyRE6/jd8spA' 2-max Seat #1 is the button
Seat 1: sVocLgrQLp4Ke1DJ2pbNKg ($1033.75 in chips)
Seat 2: ezwKQeNDkLTr+c7tP2UjNw ($2158.75 in chips)
sVocLgrQLp4Ke1DJ2pbNKg: posts small blind $5
ezwKQeNDkLTr+c7tP2UjNw: posts big blind $10
*** HOLE CARDS ***
sVocLgrQLp4Ke1DJ2pbNKg: raises $20 to $30
ezwKQeNDkLTr+c7tP2UjNw: folds
sVocLgrQLp4Ke1DJ2pbNKg collected $20 from pot
sVocLgrQLp4Ke1DJ2pbNKg: doesn't show hand
*** SUMMARY ***
Total pot $20 | Rake $0
Seat 1: sVocLgrQLp4Ke1DJ2pbNKg (button) (small blind) collected ($20)
Seat 2: ezwKQeNDkLTr+c7tP2UjNw (big blind) folded before Flop



PokerStars Game #59959199096:  Hold'em No Limit ($5/$10) - 2009/07/01 10:28:55 ET
Table 'IyraSBLp+yhyRE6/jd8spA' 2-max Seat #2 is the button
Seat 1: sVocLgrQLp4Ke1DJ2pbNKg ($1043.75 in chips)
Seat 2: ezwKQeNDkLTr+c7tP2UjNw ($2148.75 in chips)
ezwKQeNDkLTr+c7tP2UjNw: posts small blind $5
sVocLgrQLp4Ke1DJ2pbNKg: posts big blind $10
*** HOLE CARDS ***
ezwKQeNDkLTr+c7tP2UjNw: folds
sVocLgrQLp4Ke1DJ2pbNKg collected $10 from pot
sVocLgrQLp4Ke1DJ2pbNKg: doesn't show hand
*** SUMMARY ***
Total pot $10 | Rake $0
Seat 1: sVocLgrQLp4Ke1DJ2pbNKg (big blind) collected ($10)
Seat 2: ezwKQeNDkLTr+c7tP2UjNw (button) (small blind) folded before Flop



PokerStars Game #59959199772:  Hold'em No Limit ($5/$10) - 2009/07/01 10:28:56 ET
Table '2a86NK3xhs21kwGZmbj0QA' 6-max Seat #1 is the button
Seat 1: NczJqEIUdrpEc5Nbd7h1Ig ($510.75 in chips)
Seat 2: Xl+I49lxCJwPGRuegiaHoA ($1108 in chips)
Seat 3: voSAIKXtXUUbJnds83sYfQ ($1000 in chips)
Seat 4: 1ScqYmNf7/uWx1XSBgPTBw ($272 in chips)
Seat 5: jkH6qYMpn8JA/IyBOhQPMw ($2027 in chips)
Xl+I49lxCJwPGRuegiaHoA: posts small blind $5
voSAIKXtXUUbJnds83sYfQ: posts big blind $10
*** HOLE CARDS ***
1ScqYmNf7/uWx1XSBgPTBw: raises $10 to $20
jkH6qYMpn8JA/IyBOhQPMw: folds
ZaYCGtNHUeItoUEheoYDMw joins the table at seat #6
NczJqEIUdrpEc5Nbd7h1Ig: raises $10 to $30
Xl+I49lxCJwPGRuegiaHoA: calls $25
voSAIKXtXUUbJnds83sYfQ: folds
1ScqYmNf7/uWx1XSBgPTBw: raises $242 to $272 and is all-in
NczJqEIUdrpEc5Nbd7h1Ig: folds
Xl+I49lxCJwPGRuegiaHoA: calls $242
*** FLOP *** [7s Qc 4h]
*** TURN *** [7s Qc 4h] [4s]
*** RIVER *** [7s Qc 4h 4s] [2h]
*** SHOW DOWN ***
Xl+I49lxCJwPGRuegiaHoA: shows [8c 8h] (two pair, Eights and Fours)
1ScqYmNf7/uWx1XSBgPTBw: shows [Td Ts] (two pair, Tens and Fours)
1ScqYmNf7/uWx1XSBgPTBw collected $582 from pot
*** SUMMARY ***
Total pot $584 | Rake $2
Board [7s Qc 4h 4s 2h]
Seat 1: NczJqEIUdrpEc5Nbd7h1Ig (button) folded before Flop
Seat 2: Xl+I49lxCJwPGRuegiaHoA (small blind) showed [8c 8h] and lost with two pair, Eights and Fours
Seat 3: voSAIKXtXUUbJnds83sYfQ (big blind) folded before Flop
Seat 4: 1ScqYmNf7/uWx1XSBgPTBw showed [Td Ts] and won ($582) with two pair, Tens and Fours
Seat 5: jkH6qYMpn8JA/IyBOhQPMw folded before Flop (didn't bet)



PokerStars Game #59959203892:  Hold'em No Limit ($5/$10) - 2009/07/01 10:29:01 ET
Table 'IyraSBLp+yhyRE6/jd8spA' 2-max Seat #1 is the button
Seat 1: sVocLgrQLp4Ke1DJ2pbNKg ($1048.75 in chips)
Seat 2: ezwKQeNDkLTr+c7tP2UjNw ($2143.75 in chips)
sVocLgrQLp4Ke1DJ2pbNKg: posts small blind $5
ezwKQeNDkLTr+c7tP2UjNw: posts big blind $10
*** HOLE CARDS ***
sVocLgrQLp4Ke1DJ2pbNKg: raises $20 to $30
ezwKQeNDkLTr+c7tP2UjNw: calls $20
*** FLOP *** [4c Qd Qh]
ezwKQeNDkLTr+c7tP2UjNw: checks
sVocLgrQLp4Ke1DJ2pbNKg: bets $30
ezwKQeNDkLTr+c7tP2UjNw: folds
sVocLgrQLp4Ke1DJ2pbNKg collected $59.50 from pot
sVocLgrQLp4Ke1DJ2pbNKg: doesn't show hand
*** SUMMARY ***
Total pot $60 | Rake $0.50
Board [4c Qd Qh]
Seat 1: sVocLgrQLp4Ke1DJ2pbNKg (button) (small blind) collected ($59.50)
Seat 2: ezwKQeNDkLTr+c7tP2UjNw (big blind) folded on the Flop



PokerStars Game #59959213080:  Hold'em No Limit ($5/$10) - 2009/07/01 10:29:13 ET
Table 'IyraSBLp+yhyRE6/jd8spA' 2-max Seat #2 is the button
Seat 1: sVocLgrQLp4Ke1DJ2pbNKg ($1078.25 in chips)
Seat 2: ezwKQeNDkLTr+c7tP2UjNw ($2113.75 in chips)
ezwKQeNDkLTr+c7tP2UjNw: posts small blind $5
sVocLgrQLp4Ke1DJ2pbNKg: posts big blind $10
*** HOLE CARDS ***
ezwKQeNDkLTr+c7tP2UjNw: folds
sVocLgrQLp4Ke1DJ2pbNKg collected $10 from pot
*** SUMMARY ***
Total pot $10 | Rake $0
Seat 1: sVocLgrQLp4Ke1DJ2pbNKg (big blind) collected ($10)
Seat 2: ezwKQeNDkLTr+c7tP2UjNw (button) (small blind) folded before Flop



PokerStars Game #59959215744:  Hold'em No Limit ($5/$10) - 2009/07/01 10:29:16 ET
Table '1Dt9cpcLUVE6HYkx5dUEdQ' 6-max Seat #6 is the button
Seat 1: 2PHCSXghjbGk2qR6jDFe2g ($1809 in chips)
Seat 2: zdS2zKkZYSRe8p+GVcXMgg ($444 in chips)
Seat 3: g/z/ANylbdR10I7oPCJdKQ ($730.25 in chips)
Seat 4: voSAIKXtXUUbJnds83sYfQ ($1000 in chips)
Seat 5: 7SUIdtQak1SCtldWHjwnFA ($185 in chips)
Seat 6: 3mTlg4g0FJN2bo939h/0Wg ($678 in chips)
2PHCSXghjbGk2qR6jDFe2g: posts small blind $5
zdS2zKkZYSRe8p+GVcXMgg: posts big blind $10
*** HOLE CARDS ***
g/z/ANylbdR10I7oPCJdKQ: folds
voSAIKXtXUUbJnds83sYfQ: folds
7SUIdtQak1SCtldWHjwnFA: folds
3mTlg4g0FJN2bo939h/0Wg: folds
2PHCSXghjbGk2qR6jDFe2g: raises $20 to $30
zdS2zKkZYSRe8p+GVcXMgg: calls $20
*** FLOP *** [5d Kc 3d]
2PHCSXghjbGk2qR6jDFe2g: checks
zdS2zKkZYSRe8p+GVcXMgg: checks
*** TURN *** [5d Kc 3d] [Js]
2PHCSXghjbGk2qR6jDFe2g: bets $60
zdS2zKkZYSRe8p+GVcXMgg: folds
2PHCSXghjbGk2qR6jDFe2g collected $57 from pot
*** SUMMARY ***
Total pot $60 | Rake $3
Board [5d Kc 3d Js]
Seat 1: 2PHCSXghjbGk2qR6jDFe2g (small blind) collected ($57)
Seat 2: zdS2zKkZYSRe8p+GVcXMgg (big blind) folded on the Turn
Seat 3: g/z/ANylbdR10I7oPCJdKQ folded before Flop (didn't bet)
Seat 4: voSAIKXtXUUbJnds83sYfQ folded before Flop (didn't bet)
Seat 5: 7SUIdtQak1SCtldWHjwnFA folded before Flop (didn't bet)
Seat 6: 3mTlg4g0FJN2bo939h/0Wg (button) folded before Flop (didn't bet)



PokerStars Game #59959217268:  Hold'em No Limit ($5/$10) - 2009/07/01 10:29:18 ET
Table 'IyraSBLp+yhyRE6/jd8spA' 2-max Seat #1 is the button
Seat 1: sVocLgrQLp4Ke1DJ2pbNKg ($1083.25 in chips)
Seat 2: ezwKQeNDkLTr+c7tP2UjNw ($2108.75 in chips)
sVocLgrQLp4Ke1DJ2pbNKg: posts small blind $5
ezwKQeNDkLTr+c7tP2UjNw: posts big blind $10
*** HOLE CARDS ***
sVocLgrQLp4Ke1DJ2pbNKg: raises $20 to $30
ezwKQeNDkLTr+c7tP2UjNw: folds
sVocLgrQLp4Ke1DJ2pbNKg collected $20 from pot
*** SUMMARY ***
Total pot $20 | Rake $0
Seat 1: sVocLgrQLp4Ke1DJ2pbNKg (button) (small blind) collected ($20)
Seat 2: ezwKQeNDkLTr+c7tP2UjNw (big blind) folded before Flop



PokerStars Game #59959222126:  Hold'em No Limit ($5/$10) - 2009/07/01 10:29:24 ET
Table 'IyraSBLp+yhyRE6/jd8spA' 2-max Seat #2 is the button
Seat 1: sVocLgrQLp4Ke1DJ2pbNKg ($1093.25 in chips)
Seat 2: ezwKQeNDkLTr+c7tP2UjNw ($2098.75 in chips)
ezwKQeNDkLTr+c7tP2UjNw: posts small blind $5
sVocLgrQLp4Ke1DJ2pbNKg: posts big blind $10
*** HOLE CARDS ***
ezwKQeNDkLTr+c7tP2UjNw: raises $20 to $30
sVocLgrQLp4Ke1DJ2pbNKg: folds
ezwKQeNDkLTr+c7tP2UjNw collected $20 from pot
ezwKQeNDkLTr+c7tP2UjNw: doesn't show hand
*** SUMMARY ***
Total pot $20 | Rake $0
Seat 1: sVocLgrQLp4Ke1DJ2pbNKg (big blind) folded before Flop
Seat 2: ezwKQeNDkLTr+c7tP2UjNw (button) (small blind) collected ($20)



PokerStars Game #59959227344:  Hold'em No Limit ($5/$10) - 2009/07/01 10:29:30 ET
Table 'IyraSBLp+yhyRE6/jd8spA' 2-max Seat #1 is the button
Seat 1: sVocLgrQLp4Ke1DJ2pbNKg ($1083.25 in chips)
Seat 2: ezwKQeNDkLTr+c7tP2UjNw ($2108.75 in chips)
sVocLgrQLp4Ke1DJ2pbNKg: posts small blind $5
ezwKQeNDkLTr+c7tP2UjNw: posts big blind $10
*** HOLE CARDS ***
sVocLgrQLp4Ke1DJ2pbNKg: raises $20 to $30
ezwKQeNDkLTr+c7tP2UjNw: folds
sVocLgrQLp4Ke1DJ2pbNKg collected $20 from pot
sVocLgrQLp4Ke1DJ2pbNKg: doesn't show hand
*** SUMMARY ***
Total pot $20 | Rake $0
Seat 1: sVocLgrQLp4Ke1DJ2pbNKg (button) (small blind) collected ($20)
Seat 2: ezwKQeNDkLTr+c7tP2UjNw (big blind) folded before Flop



PokerStars Game #59959232416:  Hold'em No Limit ($5/$10) - 2009/07/01 10:29:37 ET
Table 'IyraSBLp+yhyRE6/jd8spA' 2-max Seat #2 is the button
Seat 1: sVocLgrQLp4Ke1DJ2pbNKg ($1093.25 in chips)
Seat 2: ezwKQeNDkLTr+c7tP2UjNw ($2098.75 in chips)
ezwKQeNDkLTr+c7tP2UjNw: posts small blind $5
sVocLgrQLp4Ke1DJ2pbNKg: posts big blind $10
*** HOLE CARDS ***
ezwKQeNDkLTr+c7tP2UjNw: raises $20 to $30
sVocLgrQLp4Ke1DJ2pbNKg: calls $20
*** FLOP *** [4s Qd Js]
sVocLgrQLp4Ke1DJ2pbNKg: checks
ezwKQeNDkLTr+c7tP2UjNw: bets $30
sVocLgrQLp4Ke1DJ2pbNKg: raises $70 to $100
ezwKQeNDkLTr+c7tP2UjNw: folds
sVocLgrQLp4Ke1DJ2pbNKg collected $119.50 from pot
sVocLgrQLp4Ke1DJ2pbNKg: doesn't show hand
*** SUMMARY ***
Total pot $120 | Rake $0.50
Board [4s Qd Js]
Seat 1: sVocLgrQLp4Ke1DJ2pbNKg (big blind) collected ($119.50)
Seat 2: ezwKQeNDkLTr+c7tP2UjNw (button) (small blind) folded on the Flop



PokerStars Game #59959233042:  Hold'em No Limit ($5/$10) - 2009/07/01 10:29:37 ET
Table '5DMTRmVjl0/Fvn8CWpM59A' 6-max Seat #1 is the button
Seat 1: ovpz8iX9p4XQ/6AFQrnDTw ($473 in chips)
Seat 2: 7SUIdtQak1SCtldWHjwnFA ($138 in chips)
Seat 3: UcFkfWngu95uR8Jhrj+HrQ ($185 in chips)
Seat 4: 2PHCSXghjbGk2qR6jDFe2g ($371.05 in chips)
Seat 6: 3mTlg4g0FJN2bo939h/0Wg ($220 in chips)
7SUIdtQak1SCtldWHjwnFA: posts small blind $5
UcFkfWngu95uR8Jhrj+HrQ: posts big blind $10
*** HOLE CARDS ***
2PHCSXghjbGk2qR6jDFe2g: raises $20 to $30
3mTlg4g0FJN2bo939h/0Wg: calls $30
ovpz8iX9p4XQ/6AFQrnDTw: calls $30
7SUIdtQak1SCtldWHjwnFA: folds
UcFkfWngu95uR8Jhrj+HrQ: folds
*** FLOP *** [Tc 3h Kd]
2PHCSXghjbGk2qR6jDFe2g: checks
3mTlg4g0FJN2bo939h/0Wg: bets $20
ovpz8iX9p4XQ/6AFQrnDTw: folds
2PHCSXghjbGk2qR6jDFe2g: calls $20
*** TURN *** [Tc 3h Kd] [Kh]
2PHCSXghjbGk2qR6jDFe2g: checks
3mTlg4g0FJN2bo939h/0Wg: checks
*** RIVER *** [Tc 3h Kd Kh] [8d]
2PHCSXghjbGk2qR6jDFe2g: bets $50
qK5PPI0zibyu/o2OTOUoSQ joins the table at seat #5
3mTlg4g0FJN2bo939h/0Wg: folds
2PHCSXghjbGk2qR6jDFe2g collected $143 from pot
2PHCSXghjbGk2qR6jDFe2g: doesn't show hand
*** SUMMARY ***
Total pot $145 | Rake $2
Board [Tc 3h Kd Kh 8d]
Seat 1: ovpz8iX9p4XQ/6AFQrnDTw (button) folded on the Flop
Seat 2: 7SUIdtQak1SCtldWHjwnFA (small blind) folded before Flop
Seat 3: UcFkfWngu95uR8Jhrj+HrQ (big blind) folded before Flop
Seat 4: 2PHCSXghjbGk2qR6jDFe2g collected ($143)
Seat 6: 3mTlg4g0FJN2bo939h/0Wg folded on the River



PokerStars Game #59959234000:  Hold'em No Limit ($5/$10) - 2009/07/01 10:29:38 ET
Table '2a86NK3xhs21kwGZmbj0QA' 6-max Seat #2 is the button
Seat 1: NczJqEIUdrpEc5Nbd7h1Ig ($480.75 in chips)
Seat 2: Xl+I49lxCJwPGRuegiaHoA ($1000 in chips)
Seat 3: voSAIKXtXUUbJnds83sYfQ ($1000 in chips)
Seat 5: jkH6qYMpn8JA/IyBOhQPMw ($2027 in chips)
voSAIKXtXUUbJnds83sYfQ: posts small blind $5
1ScqYmNf7/uWx1XSBgPTBw: is sitting out
jkH6qYMpn8JA/IyBOhQPMw: posts big blind $10
ZaYCGtNHUeItoUEheoYDMw: sits out
*** HOLE CARDS ***
1ScqYmNf7/uWx1XSBgPTBw leaves the table
NczJqEIUdrpEc5Nbd7h1Ig: raises $20 to $30
Xl+I49lxCJwPGRuegiaHoA: folds
voSAIKXtXUUbJnds83sYfQ: folds
jkH6qYMpn8JA/IyBOhQPMw: folds
NczJqEIUdrpEc5Nbd7h1Ig collected $25 from pot
*** SUMMARY ***
Total pot $25 | Rake $0
Seat 1: NczJqEIUdrpEc5Nbd7h1Ig collected ($25)
Seat 2: Xl+I49lxCJwPGRuegiaHoA (button) folded before Flop (didn't bet)
Seat 3: voSAIKXtXUUbJnds83sYfQ (small blind) folded before Flop
Seat 5: jkH6qYMpn8JA/IyBOhQPMw (big blind) folded before Flop



PokerStars Game #59959244120:  Hold'em No Limit ($5/$10) - 2009/07/01 10:29:51 ET
Table 'IyraSBLp+yhyRE6/jd8spA' 2-max Seat #1 is the button
Seat 1: sVocLgrQLp4Ke1DJ2pbNKg ($1152.75 in chips)
Seat 2: ezwKQeNDkLTr+c7tP2UjNw ($2038.75 in chips)
sVocLgrQLp4Ke1DJ2pbNKg: posts small blind $5
ezwKQeNDkLTr+c7tP2UjNw: posts big blind $10
*** HOLE CARDS ***
sVocLgrQLp4Ke1DJ2pbNKg: raises $20 to $30
ezwKQeNDkLTr+c7tP2UjNw: raises $70 to $100
sVocLgrQLp4Ke1DJ2pbNKg: folds
ezwKQeNDkLTr+c7tP2UjNw collected $60 from pot
ezwKQeNDkLTr+c7tP2UjNw: doesn't show hand
*** SUMMARY ***
Total pot $60 | Rake $0
Seat 1: sVocLgrQLp4Ke1DJ2pbNKg (button) (small blind) folded before Flop
Seat 2: ezwKQeNDkLTr+c7tP2UjNw (big blind) collected ($60)



PokerStars Game #59959252782:  Hold'em No Limit ($5/$10) - 2009/07/01 10:30:02 ET
Table 'IyraSBLp+yhyRE6/jd8spA' 2-max Seat #2 is the button
Seat 1: sVocLgrQLp4Ke1DJ2pbNKg ($1122.75 in chips)
Seat 2: ezwKQeNDkLTr+c7tP2UjNw ($2068.75 in chips)
ezwKQeNDkLTr+c7tP2UjNw: posts small blind $5
sVocLgrQLp4Ke1DJ2pbNKg: posts big blind $10
*** HOLE CARDS ***
ezwKQeNDkLTr+c7tP2UjNw: raises $20 to $30
sVocLgrQLp4Ke1DJ2pbNKg: calls $20
*** FLOP *** [5c Kd 9s]
sVocLgrQLp4Ke1DJ2pbNKg: checks
ezwKQeNDkLTr+c7tP2UjNw: bets $30
sVocLgrQLp4Ke1DJ2pbNKg: raises $70 to $100
ezwKQeNDkLTr+c7tP2UjNw: calls $70
*** TURN *** [5c Kd 9s] [9h]
sVocLgrQLp4Ke1DJ2pbNKg: checks
ezwKQeNDkLTr+c7tP2UjNw: bets $125
sVocLgrQLp4Ke1DJ2pbNKg: folds
ezwKQeNDkLTr+c7tP2UjNw collected $259.50 from pot
ezwKQeNDkLTr+c7tP2UjNw: doesn't show hand
*** SUMMARY ***
Total pot $260 | Rake $0.50
Board [5c Kd 9s 9h]
Seat 1: sVocLgrQLp4Ke1DJ2pbNKg (big blind) folded on the Turn
Seat 2: ezwKQeNDkLTr+c7tP2UjNw (button) (small blind) collected ($259.50)



PokerStars Game #59959254078:  Hold'em No Limit ($5/$10) - 2009/07/01 10:30:04 ET
Table '1Dt9cpcLUVE6HYkx5dUEdQ' 6-max Seat #1 is the button
Seat 1: 2PHCSXghjbGk2qR6jDFe2g ($1836 in chips)
Seat 2: zdS2zKkZYSRe8p+GVcXMgg ($414 in chips)
Seat 3: g/z/ANylbdR10I7oPCJdKQ ($730.25 in chips)
Seat 4: voSAIKXtXUUbJnds83sYfQ ($1000 in chips)
Seat 5: 7SUIdtQak1SCtldWHjwnFA ($185 in chips)
Seat 6: 3mTlg4g0FJN2bo939h/0Wg ($678 in chips)
zdS2zKkZYSRe8p+GVcXMgg: posts small blind $5
g/z/ANylbdR10I7oPCJdKQ: posts big blind $10
*** HOLE CARDS ***
voSAIKXtXUUbJnds83sYfQ: folds
7SUIdtQak1SCtldWHjwnFA: folds
3mTlg4g0FJN2bo939h/0Wg: raises $10 to $20
2PHCSXghjbGk2qR6jDFe2g: folds
zdS2zKkZYSRe8p+GVcXMgg: calls $15
g/z/ANylbdR10I7oPCJdKQ: folds
*** FLOP *** [3d Qs 8h]
zdS2zKkZYSRe8p+GVcXMgg: checks
3mTlg4g0FJN2bo939h/0Wg: checks
*** TURN *** [3d Qs 8h] [Js]
zdS2zKkZYSRe8p+GVcXMgg: bets $40
3mTlg4g0FJN2bo939h/0Wg: folds
zdS2zKkZYSRe8p+GVcXMgg collected $47.50 from pot
*** SUMMARY ***
Total pot $50 | Rake $2.50
Board [3d Qs 8h Js]
Seat 1: 2PHCSXghjbGk2qR6jDFe2g (button) folded before Flop (didn't bet)
Seat 2: zdS2zKkZYSRe8p+GVcXMgg (small blind) collected ($47.50)
Seat 3: g/z/ANylbdR10I7oPCJdKQ (big blind) folded before Flop
Seat 4: voSAIKXtXUUbJnds83sYfQ folded before Flop (didn't bet)
Seat 5: 7SUIdtQak1SCtldWHjwnFA folded before Flop (didn't bet)
Seat 6: 3mTlg4g0FJN2bo939h/0Wg folded on the Turn



PokerStars Game #59959254708:  Hold'em No Limit ($5/$10) - 2009/07/01 10:30:05 ET
Table '2a86NK3xhs21kwGZmbj0QA' 6-max Seat #3 is the button
Seat 1: NczJqEIUdrpEc5Nbd7h1Ig ($495.75 in chips)
Seat 2: Xl+I49lxCJwPGRuegiaHoA ($1000 in chips)
Seat 3: voSAIKXtXUUbJnds83sYfQ ($1000 in chips)
Seat 5: jkH6qYMpn8JA/IyBOhQPMw ($2017 in chips)
Seat 6: ZaYCGtNHUeItoUEheoYDMw ($200 in chips)
jkH6qYMpn8JA/IyBOhQPMw: posts small blind $5
ZaYCGtNHUeItoUEheoYDMw: posts big blind $10
*** HOLE CARDS ***
NczJqEIUdrpEc5Nbd7h1Ig: folds
Xl+I49lxCJwPGRuegiaHoA: folds
voSAIKXtXUUbJnds83sYfQ: raises $10 to $20
jkH6qYMpn8JA/IyBOhQPMw: calls $15
Lne9leXjEzXWbU3BGFWsxQ joins the table at seat #4
ZaYCGtNHUeItoUEheoYDMw: folds
*** FLOP *** [7c Ks 6h]
jkH6qYMpn8JA/IyBOhQPMw: bets $36
voSAIKXtXUUbJnds83sYfQ: calls $36
*** TURN *** [7c Ks 6h] [2c]
jkH6qYMpn8JA/IyBOhQPMw: bets $108
voSAIKXtXUUbJnds83sYfQ: calls $108
*** RIVER *** [7c Ks 6h 2c] [5d]
jkH6qYMpn8JA/IyBOhQPMw: bets $310
voSAIKXtXUUbJnds83sYfQ: folds
jkH6qYMpn8JA/IyBOhQPMw collected $336 from pot
jkH6qYMpn8JA/IyBOhQPMw: doesn't show hand
*** SUMMARY ***
Total pot $338 | Rake $2
Board [7c Ks 6h 2c 5d]
Seat 1: NczJqEIUdrpEc5Nbd7h1Ig folded before Flop (didn't bet)
Seat 2: Xl+I49lxCJwPGRuegiaHoA folded before Flop (didn't bet)
Seat 3: voSAIKXtXUUbJnds83sYfQ (button) folded on the River
Seat 5: jkH6qYMpn8JA/IyBOhQPMw (small blind) collected ($336)
Seat 6: ZaYCGtNHUeItoUEheoYDMw (big blind) folded before Flop



PokerStars Game #59959284088:  Hold'em No Limit ($5/$10) - 2009/07/01 10:30:41 ET
Table '1Dt9cpcLUVE6HYkx5dUEdQ' 6-max Seat #2 is the button
Seat 1: 2PHCSXghjbGk2qR6jDFe2g ($1836 in chips)
Seat 2: zdS2zKkZYSRe8p+GVcXMgg ($441.50 in chips)
Seat 3: g/z/ANylbdR10I7oPCJdKQ ($720.25 in chips)
Seat 4: voSAIKXtXUUbJnds83sYfQ ($1000 in chips)
Seat 5: 7SUIdtQak1SCtldWHjwnFA ($185 in chips)
Seat 6: 3mTlg4g0FJN2bo939h/0Wg ($658 in chips)
g/z/ANylbdR10I7oPCJdKQ: posts small blind $5
voSAIKXtXUUbJnds83sYfQ: posts big blind $10
*** HOLE CARDS ***
7SUIdtQak1SCtldWHjwnFA: raises $12 to $22
3mTlg4g0FJN2bo939h/0Wg: folds
2PHCSXghjbGk2qR6jDFe2g: folds
zdS2zKkZYSRe8p+GVcXMgg: calls $22
g/z/ANylbdR10I7oPCJdKQ: folds
voSAIKXtXUUbJnds83sYfQ: folds
*** FLOP *** [6d 4s 7d]
7SUIdtQak1SCtldWHjwnFA: bets $29
zdS2zKkZYSRe8p+GVcXMgg: calls $29
*** TURN *** [6d 4s 7d] [8c]
7SUIdtQak1SCtldWHjwnFA: bets $80
zdS2zKkZYSRe8p+GVcXMgg: folds
7SUIdtQak1SCtldWHjwnFA collected $114 from pot
*** SUMMARY ***
Total pot $117 | Rake $3
Board [6d 4s 7d 8c]
Seat 1: 2PHCSXghjbGk2qR6jDFe2g folded before Flop (didn't bet)
Seat 2: zdS2zKkZYSRe8p+GVcXMgg (button) folded on the Turn
Seat 3: g/z/ANylbdR10I7oPCJdKQ (small blind) folded before Flop
Seat 4: voSAIKXtXUUbJnds83sYfQ (big blind) folded before Flop
Seat 5: 7SUIdtQak1SCtldWHjwnFA collected ($114)
Seat 6: 3mTlg4g0FJN2bo939h/0Wg folded before Flop (didn't bet)



PokerStars Game #59959284288:  Hold'em No Limit ($5/$10) - 2009/07/01 10:30:42 ET
Table 'IyraSBLp+yhyRE6/jd8spA' 2-max Seat #1 is the button
Seat 1: sVocLgrQLp4Ke1DJ2pbNKg ($1000 in chips)
Seat 2: ezwKQeNDkLTr+c7tP2UjNw ($2198.25 in chips)
sVocLgrQLp4Ke1DJ2pbNKg: posts small blind $5
ezwKQeNDkLTr+c7tP2UjNw: posts big blind $10
*** HOLE CARDS ***
sVocLgrQLp4Ke1DJ2pbNKg: raises $20 to $30
ezwKQeNDkLTr+c7tP2UjNw: raises $70 to $100
sVocLgrQLp4Ke1DJ2pbNKg: folds
ezwKQeNDkLTr+c7tP2UjNw collected $60 from pot
ezwKQeNDkLTr+c7tP2UjNw: doesn't show hand
*** SUMMARY ***
Total pot $60 | Rake $0
Seat 1: sVocLgrQLp4Ke1DJ2pbNKg (button) (small blind) folded before Flop
Seat 2: ezwKQeNDkLTr+c7tP2UjNw (big blind) collected ($60)



PokerStars Game #59959286102:  Hold'em No Limit ($5/$10) - 2009/07/01 10:30:44 ET
Table '5DMTRmVjl0/Fvn8CWpM59A' 6-max Seat #2 is the button
Seat 1: ovpz8iX9p4XQ/6AFQrnDTw ($443 in chips)
Seat 2: 7SUIdtQak1SCtldWHjwnFA ($133 in chips)
Seat 3: UcFkfWngu95uR8Jhrj+HrQ ($175 in chips)
Seat 4: 2PHCSXghjbGk2qR6jDFe2g ($464.05 in chips)
Seat 6: 3mTlg4g0FJN2bo939h/0Wg ($170 in chips)
UcFkfWngu95uR8Jhrj+HrQ: posts small blind $5
2PHCSXghjbGk2qR6jDFe2g: posts big blind $10
qK5PPI0zibyu/o2OTOUoSQ: sits out
*** HOLE CARDS ***
3mTlg4g0FJN2bo939h/0Wg: folds
ovpz8iX9p4XQ/6AFQrnDTw: folds
7SUIdtQak1SCtldWHjwnFA: raises $12 to $22
UcFkfWngu95uR8Jhrj+HrQ: raises $153 to $175 and is all-in
2PHCSXghjbGk2qR6jDFe2g: folds
7SUIdtQak1SCtldWHjwnFA: folds
UcFkfWngu95uR8Jhrj+HrQ collected $54 from pot
UcFkfWngu95uR8Jhrj+HrQ: doesn't show hand
*** SUMMARY ***
Total pot $54 | Rake $0
Seat 1: ovpz8iX9p4XQ/6AFQrnDTw folded before Flop (didn't bet)
Seat 2: 7SUIdtQak1SCtldWHjwnFA (button) folded before Flop
Seat 3: UcFkfWngu95uR8Jhrj+HrQ (small blind) collected ($54)
Seat 4: 2PHCSXghjbGk2qR6jDFe2g (big blind) folded before Flop
Seat 6: 3mTlg4g0FJN2bo939h/0Wg folded before Flop (didn't bet)



PokerStars Game #59959291806:  Hold'em No Limit ($5/$10) - 2009/07/01 10:30:51 ET
Table 'IyraSBLp+yhyRE6/jd8spA' 2-max Seat #2 is the button
Seat 1: sVocLgrQLp4Ke1DJ2pbNKg ($1000 in chips)
Seat 2: ezwKQeNDkLTr+c7tP2UjNw ($2228.25 in chips)
ezwKQeNDkLTr+c7tP2UjNw: posts small blind $5
sVocLgrQLp4Ke1DJ2pbNKg: posts big blind $10
*** HOLE CARDS ***
ezwKQeNDkLTr+c7tP2UjNw: raises $20 to $30
sVocLgrQLp4Ke1DJ2pbNKg: folds
ezwKQeNDkLTr+c7tP2UjNw collected $20 from pot
ezwKQeNDkLTr+c7tP2UjNw: doesn't show hand
*** SUMMARY ***
Total pot $20 | Rake $0
Seat 1: sVocLgrQLp4Ke1DJ2pbNKg (big blind) folded before Flop
Seat 2: ezwKQeNDkLTr+c7tP2UjNw (button) (small blind) collected ($20)



PokerStars Game #59959298592:  Hold'em No Limit ($5/$10) - 2009/07/01 10:30:59 ET
Table 'IyraSBLp+yhyRE6/jd8spA' 2-max Seat #1 is the button
Seat 1: sVocLgrQLp4Ke1DJ2pbNKg ($1000 in chips)
Seat 2: ezwKQeNDkLTr+c7tP2UjNw ($2238.25 in chips)
sVocLgrQLp4Ke1DJ2pbNKg: posts small blind $5
ezwKQeNDkLTr+c7tP2UjNw: posts big blind $10
*** HOLE CARDS ***
sVocLgrQLp4Ke1DJ2pbNKg: raises $20 to $30
ezwKQeNDkLTr+c7tP2UjNw: folds
sVocLgrQLp4Ke1DJ2pbNKg collected $20 from pot
*** SUMMARY ***
Total pot $20 | Rake $0
Seat 1: sVocLgrQLp4Ke1DJ2pbNKg (button) (small blind) collected ($20)
Seat 2: ezwKQeNDkLTr+c7tP2UjNw (big blind) folded before Flop



PokerStars Game #59959303132:  Hold'em No Limit ($5/$10) - 2009/07/01 10:31:05 ET
Table 'IyraSBLp+yhyRE6/jd8spA' 2-max Seat #2 is the button
Seat 1: sVocLgrQLp4Ke1DJ2pbNKg ($1010 in chips)
Seat 2: ezwKQeNDkLTr+c7tP2UjNw ($2228.25 in chips)
ezwKQeNDkLTr+c7tP2UjNw: posts small blind $5
sVocLgrQLp4Ke1DJ2pbNKg: posts big blind $10
*** HOLE CARDS ***
ezwKQeNDkLTr+c7tP2UjNw: raises $20 to $30
sVocLgrQLp4Ke1DJ2pbNKg: folds
ezwKQeNDkLTr+c7tP2UjNw collected $20 from pot
ezwKQeNDkLTr+c7tP2UjNw: doesn't show hand
*** SUMMARY ***
Total pot $20 | Rake $0
Seat 1: sVocLgrQLp4Ke1DJ2pbNKg (big blind) folded before Flop
Seat 2: ezwKQeNDkLTr+c7tP2UjNw (button) (small blind) collected ($20)



PokerStars Game #59959310462:  Hold'em No Limit ($5/$10) - 2009/07/01 10:31:14 ET
Table 'IyraSBLp+yhyRE6/jd8spA' 2-max Seat #1 is the button
Seat 1: sVocLgrQLp4Ke1DJ2pbNKg ($1000 in chips)
Seat 2: ezwKQeNDkLTr+c7tP2UjNw ($2238.25 in chips)
sVocLgrQLp4Ke1DJ2pbNKg: posts small blind $5
ezwKQeNDkLTr+c7tP2UjNw: posts big blind $10
*** HOLE CARDS ***
sVocLgrQLp4Ke1DJ2pbNKg: raises $20 to $30
ezwKQeNDkLTr+c7tP2UjNw: folds
sVocLgrQLp4Ke1DJ2pbNKg collected $20 from pot
*** SUMMARY ***
Total pot $20 | Rake $0
Seat 1: sVocLgrQLp4Ke1DJ2pbNKg (button) (small blind) collected ($20)
Seat 2: ezwKQeNDkLTr+c7tP2UjNw (big blind) folded before Flop



PokerStars Game #59959314048:  Hold'em No Limit ($5/$10) - 2009/07/01 10:31:19 ET
Table '5DMTRmVjl0/Fvn8CWpM59A' 6-max Seat #3 is the button
Seat 1: ovpz8iX9p4XQ/6AFQrnDTw ($443 in chips)
Seat 2: 7SUIdtQak1SCtldWHjwnFA ($111 in chips)
Seat 3: UcFkfWngu95uR8Jhrj+HrQ ($207 in chips)
Seat 4: 2PHCSXghjbGk2qR6jDFe2g ($454.05 in chips)
Seat 5: qK5PPI0zibyu/o2OTOUoSQ ($200 in chips)
Seat 6: 3mTlg4g0FJN2bo939h/0Wg ($170 in chips)
2PHCSXghjbGk2qR6jDFe2g: posts small blind $5
qK5PPI0zibyu/o2OTOUoSQ: posts big blind $10
*** HOLE CARDS ***
3mTlg4g0FJN2bo939h/0Wg: folds
ovpz8iX9p4XQ/6AFQrnDTw: calls $10
7SUIdtQak1SCtldWHjwnFA: folds
UcFkfWngu95uR8Jhrj+HrQ: folds
2PHCSXghjbGk2qR6jDFe2g: folds
qK5PPI0zibyu/o2OTOUoSQ: checks
*** FLOP *** [5d 6d Jd]
qK5PPI0zibyu/o2OTOUoSQ: checks
ovpz8iX9p4XQ/6AFQrnDTw: bets $20
qK5PPI0zibyu/o2OTOUoSQ: raises $20 to $40
ovpz8iX9p4XQ/6AFQrnDTw: calls $20
*** TURN *** [5d 6d Jd] [8h]
qK5PPI0zibyu/o2OTOUoSQ: checks
ovpz8iX9p4XQ/6AFQrnDTw: bets $393 and is all-in
qK5PPI0zibyu/o2OTOUoSQ: calls $150 and is all-in
*** RIVER *** [5d 6d Jd 8h] [4d]
*** SHOW DOWN ***
qK5PPI0zibyu/o2OTOUoSQ: shows [7c 8s] (a straight, Four to Eight)
ovpz8iX9p4XQ/6AFQrnDTw: mucks hand
qK5PPI0zibyu/o2OTOUoSQ collected $402 from pot
*** SUMMARY ***
Total pot $405 | Rake $3
Board [5d 6d Jd 8h 4d]
Seat 1: ovpz8iX9p4XQ/6AFQrnDTw mucked
Seat 2: 7SUIdtQak1SCtldWHjwnFA folded before Flop (didn't bet)
Seat 3: UcFkfWngu95uR8Jhrj+HrQ (button) folded before Flop (didn't bet)
Seat 4: 2PHCSXghjbGk2qR6jDFe2g (small blind) folded before Flop
Seat 5: qK5PPI0zibyu/o2OTOUoSQ (big blind) showed [7c 8s] and won ($402) with a straight, Four to Eight
Seat 6: 3mTlg4g0FJN2bo939h/0Wg folded before Flop (didn't bet)



PokerStars Game #59959316132:  Hold'em No Limit ($5/$10) - 2009/07/01 10:31:21 ET
Table 'IyraSBLp+yhyRE6/jd8spA' 2-max Seat #2 is the button
Seat 1: sVocLgrQLp4Ke1DJ2pbNKg ($1010 in chips)
Seat 2: ezwKQeNDkLTr+c7tP2UjNw ($2228.25 in chips)
ezwKQeNDkLTr+c7tP2UjNw: posts small blind $5
sVocLgrQLp4Ke1DJ2pbNKg: posts big blind $10
*** HOLE CARDS ***
ezwKQeNDkLTr+c7tP2UjNw: folds
sVocLgrQLp4Ke1DJ2pbNKg collected $10 from pot
*** SUMMARY ***
Total pot $10 | Rake $0
Seat 1: sVocLgrQLp4Ke1DJ2pbNKg (big blind) collected ($10)
Seat 2: ezwKQeNDkLTr+c7tP2UjNw (button) (small blind) folded before Flop



PokerStars Game #59959320382:  Hold'em No Limit ($5/$10) - 2009/07/01 10:31:26 ET
Table 'IyraSBLp+yhyRE6/jd8spA' 2-max Seat #1 is the button
Seat 1: sVocLgrQLp4Ke1DJ2pbNKg ($1015 in chips)
Seat 2: ezwKQeNDkLTr+c7tP2UjNw ($2223.25 in chips)
sVocLgrQLp4Ke1DJ2pbNKg: posts small blind $5
ezwKQeNDkLTr+c7tP2UjNw: posts big blind $10
*** HOLE CARDS ***
sVocLgrQLp4Ke1DJ2pbNKg: folds
ezwKQeNDkLTr+c7tP2UjNw collected $10 from pot
ezwKQeNDkLTr+c7tP2UjNw: doesn't show hand
*** SUMMARY ***
Total pot $10 | Rake $0
Seat 1: sVocLgrQLp4Ke1DJ2pbNKg (button) (small blind) folded before Flop
Seat 2: ezwKQeNDkLTr+c7tP2UjNw (big blind) collected ($10)



PokerStars Game #59959326046:  Hold'em No Limit ($5/$10) - 2009/07/01 10:31:33 ET
Table 'IyraSBLp+yhyRE6/jd8spA' 2-max Seat #2 is the button
Seat 1: sVocLgrQLp4Ke1DJ2pbNKg ($1010 in chips)
Seat 2: ezwKQeNDkLTr+c7tP2UjNw ($2228.25 in chips)
ezwKQeNDkLTr+c7tP2UjNw: posts small blind $5
sVocLgrQLp4Ke1DJ2pbNKg: posts big blind $10
*** HOLE CARDS ***
ezwKQeNDkLTr+c7tP2UjNw: folds
sVocLgrQLp4Ke1DJ2pbNKg collected $10 from pot
*** SUMMARY ***
Total pot $10 | Rake $0
Seat 1: sVocLgrQLp4Ke1DJ2pbNKg (big blind) collected ($10)
Seat 2: ezwKQeNDkLTr+c7tP2UjNw (button) (small blind) folded before Flop



PokerStars Game #59959330230:  Hold'em No Limit ($5/$10) - 2009/07/01 10:31:39 ET
Table 'IyraSBLp+yhyRE6/jd8spA' 2-max Seat #1 is the button
Seat 1: sVocLgrQLp4Ke1DJ2pbNKg ($1015 in chips)
Seat 2: ezwKQeNDkLTr+c7tP2UjNw ($2223.25 in chips)
sVocLgrQLp4Ke1DJ2pbNKg: posts small blind $5
ezwKQeNDkLTr+c7tP2UjNw: posts big blind $10
*** HOLE CARDS ***
sVocLgrQLp4Ke1DJ2pbNKg: raises $20 to $30
ezwKQeNDkLTr+c7tP2UjNw: raises $70 to $100
sVocLgrQLp4Ke1DJ2pbNKg: folds
ezwKQeNDkLTr+c7tP2UjNw collected $60 from pot
ezwKQeNDkLTr+c7tP2UjNw: doesn't show hand
*** SUMMARY ***
Total pot $60 | Rake $0
Seat 1: sVocLgrQLp4Ke1DJ2pbNKg (button) (small blind) folded before Flop
Seat 2: ezwKQeNDkLTr+c7tP2UjNw (big blind) collected ($60)



PokerStars Game #59959337228:  Hold'em No Limit ($5/$10) - 2009/07/01 10:31:48 ET
Table '1Dt9cpcLUVE6HYkx5dUEdQ' 6-max Seat #3 is the button
Seat 1: 2PHCSXghjbGk2qR6jDFe2g ($1836 in chips)
Seat 2: zdS2zKkZYSRe8p+GVcXMgg ($390.50 in chips)
Seat 3: g/z/ANylbdR10I7oPCJdKQ ($715.25 in chips)
Seat 4: voSAIKXtXUUbJnds83sYfQ ($1000 in chips)
Seat 5: 7SUIdtQak1SCtldWHjwnFA ($248 in chips)
Seat 6: 3mTlg4g0FJN2bo939h/0Wg ($658 in chips)
voSAIKXtXUUbJnds83sYfQ: posts small blind $5
7SUIdtQak1SCtldWHjwnFA: posts big blind $10
*** HOLE CARDS ***
3mTlg4g0FJN2bo939h/0Wg: raises $20 to $30
2PHCSXghjbGk2qR6jDFe2g: folds
zdS2zKkZYSRe8p+GVcXMgg: calls $30
g/z/ANylbdR10I7oPCJdKQ: folds
voSAIKXtXUUbJnds83sYfQ: folds
7SUIdtQak1SCtldWHjwnFA: calls $20
*** FLOP *** [8d Ts Td]
7SUIdtQak1SCtldWHjwnFA: checks
3mTlg4g0FJN2bo939h/0Wg: bets $30
zdS2zKkZYSRe8p+GVcXMgg: raises $60 to $90
7SUIdtQak1SCtldWHjwnFA: raises $60 to $150
3mTlg4g0FJN2bo939h/0Wg: folds
zdS2zKkZYSRe8p+GVcXMgg: raises $60 to $210
7SUIdtQak1SCtldWHjwnFA: raises $8 to $218 and is all-in
zdS2zKkZYSRe8p+GVcXMgg: calls $8
*** TURN *** [8d Ts Td] [Jc]
*** RIVER *** [8d Ts Td Jc] [2s]
*** SHOW DOWN ***
7SUIdtQak1SCtldWHjwnFA: shows [Qh Tc] (three of a kind, Tens)
zdS2zKkZYSRe8p+GVcXMgg: shows [9h 7h] (a straight, Seven to Jack)
zdS2zKkZYSRe8p+GVcXMgg collected $558 from pot
*** SUMMARY ***
Total pot $561 | Rake $3
Board [8d Ts Td Jc 2s]
Seat 1: 2PHCSXghjbGk2qR6jDFe2g folded before Flop (didn't bet)
Seat 2: zdS2zKkZYSRe8p+GVcXMgg showed [9h 7h] and won ($558) with a straight, Seven to Jack
Seat 3: g/z/ANylbdR10I7oPCJdKQ (button) folded before Flop (didn't bet)
Seat 4: voSAIKXtXUUbJnds83sYfQ (small blind) folded before Flop
Seat 5: 7SUIdtQak1SCtldWHjwnFA (big blind) showed [Qh Tc] and lost with three of a kind, Tens
Seat 6: 3mTlg4g0FJN2bo939h/0Wg folded on the Flop



PokerStars Game #59959339246:  Hold'em No Limit ($5/$10) - 2009/07/01 10:31:50 ET
Table 'IyraSBLp+yhyRE6/jd8spA' 2-max Seat #2 is the button
Seat 1: sVocLgrQLp4Ke1DJ2pbNKg ($1000 in chips)
Seat 2: ezwKQeNDkLTr+c7tP2UjNw ($2253.25 in chips)
ezwKQeNDkLTr+c7tP2UjNw: posts small blind $5
sVocLgrQLp4Ke1DJ2pbNKg: posts big blind $10
*** HOLE CARDS ***
ezwKQeNDkLTr+c7tP2UjNw: folds
sVocLgrQLp4Ke1DJ2pbNKg collected $10 from pot
*** SUMMARY ***
Total pot $10 | Rake $0
Seat 1: sVocLgrQLp4Ke1DJ2pbNKg (big blind) collected ($10)
Seat 2: ezwKQeNDkLTr+c7tP2UjNw (button) (small blind) folded before Flop



PokerStars Game #59959343508:  Hold'em No Limit ($5/$10) - 2009/07/01 10:31:55 ET
Table 'IyraSBLp+yhyRE6/jd8spA' 2-max Seat #1 is the button
Seat 1: sVocLgrQLp4Ke1DJ2pbNKg ($1005 in chips)
Seat 2: ezwKQeNDkLTr+c7tP2UjNw ($2248.25 in chips)
sVocLgrQLp4Ke1DJ2pbNKg: posts small blind $5
ezwKQeNDkLTr+c7tP2UjNw: posts big blind $10
*** HOLE CARDS ***
sVocLgrQLp4Ke1DJ2pbNKg: raises $20 to $30
ezwKQeNDkLTr+c7tP2UjNw: calls $20
*** FLOP *** [8d 9s 5c]
ezwKQeNDkLTr+c7tP2UjNw: checks
sVocLgrQLp4Ke1DJ2pbNKg: bets $50
ezwKQeNDkLTr+c7tP2UjNw: raises $100 to $150
sVocLgrQLp4Ke1DJ2pbNKg: folds
ezwKQeNDkLTr+c7tP2UjNw collected $159.50 from pot
ezwKQeNDkLTr+c7tP2UjNw: doesn't show hand
*** SUMMARY ***
Total pot $160 | Rake $0.50
Board [8d 9s 5c]
Seat 1: sVocLgrQLp4Ke1DJ2pbNKg (button) (small blind) folded on the Flop
Seat 2: ezwKQeNDkLTr+c7tP2UjNw (big blind) collected ($159.50)



PokerStars Game #59959344508:  Hold'em No Limit ($5/$10) - 2009/07/01 10:31:57 ET
Table '2a86NK3xhs21kwGZmbj0QA' 6-max Seat #5 is the button
Seat 1: NczJqEIUdrpEc5Nbd7h1Ig ($495.75 in chips)
Seat 2: Xl+I49lxCJwPGRuegiaHoA ($1000 in chips)
Seat 3: voSAIKXtXUUbJnds83sYfQ ($1000 in chips)
Seat 5: jkH6qYMpn8JA/IyBOhQPMw ($2189 in chips)
Seat 6: ZaYCGtNHUeItoUEheoYDMw ($190 in chips)
ZaYCGtNHUeItoUEheoYDMw: posts small blind $5
NczJqEIUdrpEc5Nbd7h1Ig: posts big blind $10
Lne9leXjEzXWbU3BGFWsxQ: sits out
*** HOLE CARDS ***
Xl+I49lxCJwPGRuegiaHoA: folds
voSAIKXtXUUbJnds83sYfQ: folds
jkH6qYMpn8JA/IyBOhQPMw: folds
ZaYCGtNHUeItoUEheoYDMw: folds
NczJqEIUdrpEc5Nbd7h1Ig collected $10 from pot
*** SUMMARY ***
Total pot $10 | Rake $0
Seat 1: NczJqEIUdrpEc5Nbd7h1Ig (big blind) collected ($10)
Seat 2: Xl+I49lxCJwPGRuegiaHoA folded before Flop (didn't bet)
Seat 3: voSAIKXtXUUbJnds83sYfQ folded before Flop (didn't bet)
Seat 5: jkH6qYMpn8JA/IyBOhQPMw (button) folded before Flop (didn't bet)
Seat 6: ZaYCGtNHUeItoUEheoYDMw (small blind) folded before Flop



PokerStars Game #59959359460:  Hold'em No Limit ($5/$10) - 2009/07/01 10:32:15 ET
Table 'IyraSBLp+yhyRE6/jd8spA' 2-max Seat #2 is the button
Seat 1: sVocLgrQLp4Ke1DJ2pbNKg ($1000 in chips)
Seat 2: ezwKQeNDkLTr+c7tP2UjNw ($2327.75 in chips)
ezwKQeNDkLTr+c7tP2UjNw: posts small blind $5
sVocLgrQLp4Ke1DJ2pbNKg: posts big blind $10
*** HOLE CARDS ***
ezwKQeNDkLTr+c7tP2UjNw: raises $20 to $30
sVocLgrQLp4Ke1DJ2pbNKg: raises $70 to $100
ezwKQeNDkLTr+c7tP2UjNw: raises $2227.75 to $2327.75 and is all-in
sVocLgrQLp4Ke1DJ2pbNKg: calls $900 and is all-in
*** FLOP *** [2s 7s Th]
*** TURN *** [2s 7s Th] [Kc]
*** RIVER *** [2s 7s Th Kc] [Qc]
*** SHOW DOWN ***
sVocLgrQLp4Ke1DJ2pbNKg: shows [8h Ah] (high card Ace)
ezwKQeNDkLTr+c7tP2UjNw: shows [6d 6s] (a pair of Sixes)
ezwKQeNDkLTr+c7tP2UjNw collected $1999.50 from pot
*** SUMMARY ***
Total pot $2000 | Rake $0.50
Board [2s 7s Th Kc Qc]
Seat 1: sVocLgrQLp4Ke1DJ2pbNKg (big blind) showed [8h Ah] and lost with high card Ace
Seat 2: ezwKQeNDkLTr+c7tP2UjNw (button) (small blind) showed [6d 6s] and won ($1999.50) with a pair of Sixes



PokerStars Game #59959361426:  Hold'em No Limit ($5/$10) - 2009/07/01 10:32:17 ET
Table '2a86NK3xhs21kwGZmbj0QA' 6-max Seat #6 is the button
Seat 1: NczJqEIUdrpEc5Nbd7h1Ig ($500.75 in chips)
Seat 2: Xl+I49lxCJwPGRuegiaHoA ($1000 in chips)
Seat 3: voSAIKXtXUUbJnds83sYfQ ($1000 in chips)
Seat 5: jkH6qYMpn8JA/IyBOhQPMw ($2189 in chips)
Seat 6: ZaYCGtNHUeItoUEheoYDMw ($185 in chips)
NczJqEIUdrpEc5Nbd7h1Ig: posts small blind $5
Xl+I49lxCJwPGRuegiaHoA: posts big blind $10
Lne9leXjEzXWbU3BGFWsxQ: sits out
*** HOLE CARDS ***
voSAIKXtXUUbJnds83sYfQ: folds
jkH6qYMpn8JA/IyBOhQPMw: folds
ZaYCGtNHUeItoUEheoYDMw: folds
NczJqEIUdrpEc5Nbd7h1Ig: calls $5
Xl+I49lxCJwPGRuegiaHoA: raises $20 to $30
NczJqEIUdrpEc5Nbd7h1Ig: calls $20
*** FLOP *** [7c 4s 9h]
NczJqEIUdrpEc5Nbd7h1Ig: checks
Xl+I49lxCJwPGRuegiaHoA: bets $40
NczJqEIUdrpEc5Nbd7h1Ig: calls $40
*** TURN *** [7c 4s 9h] [Ah]
NczJqEIUdrpEc5Nbd7h1Ig: checks
Xl+I49lxCJwPGRuegiaHoA: checks
*** RIVER *** [7c 4s 9h Ah] [Kc]
NczJqEIUdrpEc5Nbd7h1Ig: bets $90
Xl+I49lxCJwPGRuegiaHoA: folds
NczJqEIUdrpEc5Nbd7h1Ig collected $138 from pot
*** SUMMARY ***
Total pot $140 | Rake $2
Board [7c 4s 9h Ah Kc]
Seat 1: NczJqEIUdrpEc5Nbd7h1Ig (small blind) collected ($138)
Seat 2: Xl+I49lxCJwPGRuegiaHoA (big blind) folded on the River
Seat 3: voSAIKXtXUUbJnds83sYfQ folded before Flop (didn't bet)
Seat 5: jkH6qYMpn8JA/IyBOhQPMw folded before Flop (didn't bet)
Seat 6: ZaYCGtNHUeItoUEheoYDMw (button) folded before Flop (didn't bet)



PokerStars Game #59959366644:  Hold'em No Limit ($5/$10) - 2009/07/01 10:32:24 ET
Table '5DMTRmVjl0/Fvn8CWpM59A' 6-max Seat #4 is the button
Seat 1: ovpz8iX9p4XQ/6AFQrnDTw ($243 in chips)
Seat 2: 7SUIdtQak1SCtldWHjwnFA ($111 in chips)
Seat 3: UcFkfWngu95uR8Jhrj+HrQ ($207 in chips)
Seat 4: 2PHCSXghjbGk2qR6jDFe2g ($449.05 in chips)
Seat 5: qK5PPI0zibyu/o2OTOUoSQ ($402 in chips)
Seat 6: 3mTlg4g0FJN2bo939h/0Wg ($170 in chips)
qK5PPI0zibyu/o2OTOUoSQ: posts small blind $5
3mTlg4g0FJN2bo939h/0Wg: posts big blind $10
*** HOLE CARDS ***
ovpz8iX9p4XQ/6AFQrnDTw: folds
7SUIdtQak1SCtldWHjwnFA: folds
UcFkfWngu95uR8Jhrj+HrQ: folds
2PHCSXghjbGk2qR6jDFe2g: folds
qK5PPI0zibyu/o2OTOUoSQ: calls $5
3mTlg4g0FJN2bo939h/0Wg: checks
*** FLOP *** [Qh 6s Qd]
qK5PPI0zibyu/o2OTOUoSQ: checks
3mTlg4g0FJN2bo939h/0Wg: checks
*** TURN *** [Qh 6s Qd] [Jh]
qK5PPI0zibyu/o2OTOUoSQ: checks
3mTlg4g0FJN2bo939h/0Wg: checks
*** RIVER *** [Qh 6s Qd Jh] [Ah]
qK5PPI0zibyu/o2OTOUoSQ: checks
3mTlg4g0FJN2bo939h/0Wg: checks
*** SHOW DOWN ***
qK5PPI0zibyu/o2OTOUoSQ: shows [4d 4s] (two pair, Queens and Fours)
3mTlg4g0FJN2bo939h/0Wg: mucks hand
qK5PPI0zibyu/o2OTOUoSQ collected $19 from pot
*** SUMMARY ***
Total pot $20 | Rake $1
Board [Qh 6s Qd Jh Ah]
Seat 1: ovpz8iX9p4XQ/6AFQrnDTw folded before Flop (didn't bet)
Seat 2: 7SUIdtQak1SCtldWHjwnFA folded before Flop (didn't bet)
Seat 3: UcFkfWngu95uR8Jhrj+HrQ folded before Flop (didn't bet)
Seat 4: 2PHCSXghjbGk2qR6jDFe2g (button) folded before Flop (didn't bet)
Seat 5: qK5PPI0zibyu/o2OTOUoSQ (small blind) showed [4d 4s] and won ($19) with two pair, Queens and Fours
Seat 6: 3mTlg4g0FJN2bo939h/0Wg (big blind) mucked



PokerStars Game #59959376124:  Hold'em No Limit ($5/$10) - 2009/07/01 10:32:35 ET
Table 'IyraSBLp+yhyRE6/jd8spA' 2-max Seat #1 is the button
Seat 1: sVocLgrQLp4Ke1DJ2pbNKg ($1000 in chips)
Seat 2: ezwKQeNDkLTr+c7tP2UjNw ($3327.25 in chips)
sVocLgrQLp4Ke1DJ2pbNKg: posts small blind $5
ezwKQeNDkLTr+c7tP2UjNw: posts big blind $10
*** HOLE CARDS ***
sVocLgrQLp4Ke1DJ2pbNKg: folds
ezwKQeNDkLTr+c7tP2UjNw collected $10 from pot
ezwKQeNDkLTr+c7tP2UjNw: doesn't show hand
*** SUMMARY ***
Total pot $10 | Rake $0
Seat 1: sVocLgrQLp4Ke1DJ2pbNKg (button) (small blind) folded before Flop
Seat 2: ezwKQeNDkLTr+c7tP2UjNw (big blind) collected ($10)



PokerStars Game #59959382262:  Hold'em No Limit ($5/$10) - 2009/07/01 10:32:43 ET
Table 'IyraSBLp+yhyRE6/jd8spA' 2-max Seat #2 is the button
Seat 1: sVocLgrQLp4Ke1DJ2pbNKg ($1000 in chips)
Seat 2: ezwKQeNDkLTr+c7tP2UjNw ($3332.25 in chips)
ezwKQeNDkLTr+c7tP2UjNw: posts small blind $5
sVocLgrQLp4Ke1DJ2pbNKg: posts big blind $10
*** HOLE CARDS ***
ezwKQeNDkLTr+c7tP2UjNw: raises $20 to $30
sVocLgrQLp4Ke1DJ2pbNKg: raises $70 to $100
ezwKQeNDkLTr+c7tP2UjNw: folds
sVocLgrQLp4Ke1DJ2pbNKg collected $60 from pot
sVocLgrQLp4Ke1DJ2pbNKg: doesn't show hand
*** SUMMARY ***
Total pot $60 | Rake $0
Seat 1: sVocLgrQLp4Ke1DJ2pbNKg (big blind) collected ($60)
Seat 2: ezwKQeNDkLTr+c7tP2UjNw (button) (small blind) folded before Flop



PokerStars Game #59959381822:  Hold'em No Limit ($5/$10) - 2009/07/01 10:32:43 ET
Table '1Dt9cpcLUVE6HYkx5dUEdQ' 6-max Seat #4 is the button
Seat 1: 2PHCSXghjbGk2qR6jDFe2g ($1836 in chips)
Seat 2: zdS2zKkZYSRe8p+GVcXMgg ($700.50 in chips)
Seat 3: g/z/ANylbdR10I7oPCJdKQ ($715.25 in chips)
Seat 4: voSAIKXtXUUbJnds83sYfQ ($1000 in chips)
Seat 5: 7SUIdtQak1SCtldWHjwnFA ($200 in chips)
Seat 6: 3mTlg4g0FJN2bo939h/0Wg ($598 in chips)
7SUIdtQak1SCtldWHjwnFA: posts small blind $5
3mTlg4g0FJN2bo939h/0Wg: posts big blind $10
*** HOLE CARDS ***
2PHCSXghjbGk2qR6jDFe2g: folds
zdS2zKkZYSRe8p+GVcXMgg: raises $20 to $30
g/z/ANylbdR10I7oPCJdKQ: folds
voSAIKXtXUUbJnds83sYfQ: folds
7SUIdtQak1SCtldWHjwnFA: raises $170 to $200 and is all-in
3mTlg4g0FJN2bo939h/0Wg: folds
zdS2zKkZYSRe8p+GVcXMgg: calls $170
*** FLOP *** [4s Jd 5h]
*** TURN *** [4s Jd 5h] [4h]
*** RIVER *** [4s Jd 5h 4h] [Ks]
*** SHOW DOWN ***
7SUIdtQak1SCtldWHjwnFA: shows [Kd Ah] (two pair, Kings and Fours)
zdS2zKkZYSRe8p+GVcXMgg: shows [Jh Jc] (a full house, Jacks full of Fours)
zdS2zKkZYSRe8p+GVcXMgg collected $407 from pot
*** SUMMARY ***
Total pot $410 | Rake $3
Board [4s Jd 5h 4h Ks]
Seat 1: 2PHCSXghjbGk2qR6jDFe2g folded before Flop (didn't bet)
Seat 2: zdS2zKkZYSRe8p+GVcXMgg showed [Jh Jc] and won ($407) with a full house, Jacks full of Fours
Seat 3: g/z/ANylbdR10I7oPCJdKQ folded before Flop (didn't bet)
Seat 4: voSAIKXtXUUbJnds83sYfQ (button) folded before Flop (didn't bet)
Seat 5: 7SUIdtQak1SCtldWHjwnFA (small blind) showed [Kd Ah] and lost with two pair, Kings and Fours
Seat 6: 3mTlg4g0FJN2bo939h/0Wg (big blind) folded before Flop



PokerStars Game #59959389394:  Hold'em No Limit ($5/$10) - 2009/07/01 10:32:52 ET
Table 'IyraSBLp+yhyRE6/jd8spA' 2-max Seat #1 is the button
Seat 1: sVocLgrQLp4Ke1DJ2pbNKg ($1030 in chips)
Seat 2: ezwKQeNDkLTr+c7tP2UjNw ($3302.25 in chips)
sVocLgrQLp4Ke1DJ2pbNKg: posts small blind $5
ezwKQeNDkLTr+c7tP2UjNw: posts big blind $10
*** HOLE CARDS ***
sVocLgrQLp4Ke1DJ2pbNKg: folds
ezwKQeNDkLTr+c7tP2UjNw collected $10 from pot
ezwKQeNDkLTr+c7tP2UjNw: doesn't show hand
*** SUMMARY ***
Total pot $10 | Rake $0
Seat 1: sVocLgrQLp4Ke1DJ2pbNKg (button) (small blind) folded before Flop
Seat 2: ezwKQeNDkLTr+c7tP2UjNw (big blind) collected ($10)



PokerStars Game #59959393388:  Hold'em No Limit ($5/$10) - 2009/07/01 10:32:57 ET
Table 'IyraSBLp+yhyRE6/jd8spA' 2-max Seat #2 is the button
Seat 1: sVocLgrQLp4Ke1DJ2pbNKg ($1025 in chips)
Seat 2: ezwKQeNDkLTr+c7tP2UjNw ($3307.25 in chips)
ezwKQeNDkLTr+c7tP2UjNw: posts small blind $5
sVocLgrQLp4Ke1DJ2pbNKg: posts big blind $10
*** HOLE CARDS ***
ezwKQeNDkLTr+c7tP2UjNw: raises $20 to $30
sVocLgrQLp4Ke1DJ2pbNKg: calls $20
*** FLOP *** [Ah 8s Qs]
sVocLgrQLp4Ke1DJ2pbNKg: checks
ezwKQeNDkLTr+c7tP2UjNw: bets $30
sVocLgrQLp4Ke1DJ2pbNKg: raises $90 to $120
ezwKQeNDkLTr+c7tP2UjNw: calls $90
*** TURN *** [Ah 8s Qs] [Td]
sVocLgrQLp4Ke1DJ2pbNKg: bets $220
ezwKQeNDkLTr+c7tP2UjNw: calls $220
*** RIVER *** [Ah 8s Qs Td] [Jd]
sVocLgrQLp4Ke1DJ2pbNKg: checks
ezwKQeNDkLTr+c7tP2UjNw: checks
*** SHOW DOWN ***
sVocLgrQLp4Ke1DJ2pbNKg: shows [3h Jh] (a pair of Jacks)
ezwKQeNDkLTr+c7tP2UjNw: mucks hand
sVocLgrQLp4Ke1DJ2pbNKg collected $739.50 from pot
*** SUMMARY ***
Total pot $740 | Rake $0.50
Board [Ah 8s Qs Td Jd]
Seat 1: sVocLgrQLp4Ke1DJ2pbNKg (big blind) showed [3h Jh] and won ($739.50) with a pair of Jacks
Seat 2: ezwKQeNDkLTr+c7tP2UjNw (button) (small blind) mucked



PokerStars Game #59959396946:  Hold'em No Limit ($5/$10) - 2009/07/01 10:33:01 ET
Table '5DMTRmVjl0/Fvn8CWpM59A' 6-max Seat #5 is the button
Seat 1: ovpz8iX9p4XQ/6AFQrnDTw ($500 in chips)
Seat 2: 7SUIdtQak1SCtldWHjwnFA ($111 in chips)
Seat 3: UcFkfWngu95uR8Jhrj+HrQ ($207 in chips)
Seat 4: 2PHCSXghjbGk2qR6jDFe2g ($449.05 in chips)
Seat 5: qK5PPI0zibyu/o2OTOUoSQ ($411 in chips)
Seat 6: 3mTlg4g0FJN2bo939h/0Wg ($160 in chips)
3mTlg4g0FJN2bo939h/0Wg: posts small blind $5
ovpz8iX9p4XQ/6AFQrnDTw: posts big blind $10
*** HOLE CARDS ***
7SUIdtQak1SCtldWHjwnFA: raises $12 to $22
UcFkfWngu95uR8Jhrj+HrQ: folds
2PHCSXghjbGk2qR6jDFe2g: folds
qK5PPI0zibyu/o2OTOUoSQ: folds
3mTlg4g0FJN2bo939h/0Wg: calls $17
ovpz8iX9p4XQ/6AFQrnDTw: folds
*** FLOP *** [Ad 6s Ac]
3mTlg4g0FJN2bo939h/0Wg: bets $30
7SUIdtQak1SCtldWHjwnFA: calls $30
*** TURN *** [Ad 6s Ac] [6c]
3mTlg4g0FJN2bo939h/0Wg: checks
7SUIdtQak1SCtldWHjwnFA: checks
*** RIVER *** [Ad 6s Ac 6c] [Kh]
3mTlg4g0FJN2bo939h/0Wg: checks
7SUIdtQak1SCtldWHjwnFA: bets $59 and is all-in
3mTlg4g0FJN2bo939h/0Wg: calls $59
*** SHOW DOWN ***
7SUIdtQak1SCtldWHjwnFA: shows [5s As] (a full house, Aces full of Sixes)
3mTlg4g0FJN2bo939h/0Wg: mucks hand
7SUIdtQak1SCtldWHjwnFA collected $229 from pot
*** SUMMARY ***
Total pot $232 | Rake $3
Board [Ad 6s Ac 6c Kh]
Seat 1: ovpz8iX9p4XQ/6AFQrnDTw (big blind) folded before Flop
Seat 2: 7SUIdtQak1SCtldWHjwnFA showed [5s As] and won ($229) with a full house, Aces full of Sixes
Seat 3: UcFkfWngu95uR8Jhrj+HrQ folded before Flop (didn't bet)
Seat 4: 2PHCSXghjbGk2qR6jDFe2g folded before Flop (didn't bet)
Seat 5: qK5PPI0zibyu/o2OTOUoSQ (button) folded before Flop (didn't bet)
Seat 6: 3mTlg4g0FJN2bo939h/0Wg (small blind) mucked



PokerStars Game #59959407018:  Hold'em No Limit ($5/$10) - 2009/07/01 10:33:13 ET
Table '2a86NK3xhs21kwGZmbj0QA' 6-max Seat #1 is the button
Seat 1: NczJqEIUdrpEc5Nbd7h1Ig ($568.75 in chips)
Seat 2: Xl+I49lxCJwPGRuegiaHoA ($1000 in chips)
Seat 3: voSAIKXtXUUbJnds83sYfQ ($1000 in chips)
Seat 5: jkH6qYMpn8JA/IyBOhQPMw ($2189 in chips)
Seat 6: ZaYCGtNHUeItoUEheoYDMw ($185 in chips)
Xl+I49lxCJwPGRuegiaHoA: posts small blind $5
voSAIKXtXUUbJnds83sYfQ: posts big blind $10
Lne9leXjEzXWbU3BGFWsxQ: sits out
*** HOLE CARDS ***
jkH6qYMpn8JA/IyBOhQPMw: folds
ZaYCGtNHUeItoUEheoYDMw: folds
NczJqEIUdrpEc5Nbd7h1Ig: raises $30 to $40
Xl+I49lxCJwPGRuegiaHoA: folds
voSAIKXtXUUbJnds83sYfQ: folds
NczJqEIUdrpEc5Nbd7h1Ig collected $25 from pot
*** SUMMARY ***
Total pot $25 | Rake $0
Seat 1: NczJqEIUdrpEc5Nbd7h1Ig (button) collected ($25)
Seat 2: Xl+I49lxCJwPGRuegiaHoA (small blind) folded before Flop
Seat 3: voSAIKXtXUUbJnds83sYfQ (big blind) folded before Flop
Seat 5: jkH6qYMpn8JA/IyBOhQPMw folded before Flop (didn't bet)
Seat 6: ZaYCGtNHUeItoUEheoYDMw folded before Flop (didn't bet)



PokerStars Game #59959416330:  Hold'em No Limit ($5/$10) - 2009/07/01 10:33:25 ET
Table '1Dt9cpcLUVE6HYkx5dUEdQ' 6-max Seat #5 is the button
Seat 1: 2PHCSXghjbGk2qR6jDFe2g ($1836 in chips)
Seat 2: zdS2zKkZYSRe8p+GVcXMgg ($907.50 in chips)
Seat 3: g/z/ANylbdR10I7oPCJdKQ ($715.25 in chips)
Seat 4: voSAIKXtXUUbJnds83sYfQ ($1000 in chips)
Seat 5: 7SUIdtQak1SCtldWHjwnFA ($200 in chips)
Seat 6: 3mTlg4g0FJN2bo939h/0Wg ($588 in chips)
3mTlg4g0FJN2bo939h/0Wg: posts small blind $5
2PHCSXghjbGk2qR6jDFe2g: posts big blind $10
*** HOLE CARDS ***
zdS2zKkZYSRe8p+GVcXMgg: folds
g/z/ANylbdR10I7oPCJdKQ: folds
voSAIKXtXUUbJnds83sYfQ: raises $20 to $30
7SUIdtQak1SCtldWHjwnFA: folds
3mTlg4g0FJN2bo939h/0Wg: folds
2PHCSXghjbGk2qR6jDFe2g: folds
voSAIKXtXUUbJnds83sYfQ collected $25 from pot
*** SUMMARY ***
Total pot $25 | Rake $0
Seat 1: 2PHCSXghjbGk2qR6jDFe2g (big blind) folded before Flop
Seat 2: zdS2zKkZYSRe8p+GVcXMgg folded before Flop (didn't bet)
Seat 3: g/z/ANylbdR10I7oPCJdKQ folded before Flop (didn't bet)
Seat 4: voSAIKXtXUUbJnds83sYfQ collected ($25)
Seat 5: 7SUIdtQak1SCtldWHjwnFA (button) folded before Flop (didn't bet)
Seat 6: 3mTlg4g0FJN2bo939h/0Wg (small blind) folded before Flop



PokerStars Game #59959423538:  Hold'em No Limit ($5/$10) - 2009/07/01 10:33:34 ET
Table 'IyraSBLp+yhyRE6/jd8spA' 2-max Seat #1 is the button
Seat 1: sVocLgrQLp4Ke1DJ2pbNKg ($1394.50 in chips)
Seat 2: ezwKQeNDkLTr+c7tP2UjNw ($2937.25 in chips)
sVocLgrQLp4Ke1DJ2pbNKg: posts small blind $5
ezwKQeNDkLTr+c7tP2UjNw: posts big blind $10
*** HOLE CARDS ***
sVocLgrQLp4Ke1DJ2pbNKg: raises $20 to $30
ezwKQeNDkLTr+c7tP2UjNw: raises $70 to $100
sVocLgrQLp4Ke1DJ2pbNKg: folds
ezwKQeNDkLTr+c7tP2UjNw collected $60 from pot
ezwKQeNDkLTr+c7tP2UjNw: doesn't show hand
*** SUMMARY ***
Total pot $60 | Rake $0
Seat 1: sVocLgrQLp4Ke1DJ2pbNKg (button) (small blind) folded before Flop
Seat 2: ezwKQeNDkLTr+c7tP2UjNw (big blind) collected ($60)



PokerStars Game #59959425620:  Hold'em No Limit ($5/$10) - 2009/07/01 10:33:36 ET
Table '2a86NK3xhs21kwGZmbj0QA' 6-max Seat #2 is the button
Seat 1: NczJqEIUdrpEc5Nbd7h1Ig ($583.75 in chips)
Seat 2: Xl+I49lxCJwPGRuegiaHoA ($1000 in chips)
Seat 3: voSAIKXtXUUbJnds83sYfQ ($1000 in chips)
Seat 4: Lne9leXjEzXWbU3BGFWsxQ ($1000 in chips)
Seat 5: jkH6qYMpn8JA/IyBOhQPMw ($2189 in chips)
Seat 6: ZaYCGtNHUeItoUEheoYDMw ($185 in chips)
voSAIKXtXUUbJnds83sYfQ: posts small blind $5
Lne9leXjEzXWbU3BGFWsxQ: posts big blind $10
*** HOLE CARDS ***
jkH6qYMpn8JA/IyBOhQPMw: folds
ZaYCGtNHUeItoUEheoYDMw: raises $10 to $20
NczJqEIUdrpEc5Nbd7h1Ig: calls $20
Xl+I49lxCJwPGRuegiaHoA: folds
voSAIKXtXUUbJnds83sYfQ: folds
Lne9leXjEzXWbU3BGFWsxQ: folds
*** FLOP *** [Kd Ac 4d]
ZaYCGtNHUeItoUEheoYDMw: bets $20
NczJqEIUdrpEc5Nbd7h1Ig: calls $20
*** TURN *** [Kd Ac 4d] [9h]
ZaYCGtNHUeItoUEheoYDMw: checks
NczJqEIUdrpEc5Nbd7h1Ig: bets $70
ZaYCGtNHUeItoUEheoYDMw: raises $75 to $145 and is all-in
NczJqEIUdrpEc5Nbd7h1Ig: folds
ZaYCGtNHUeItoUEheoYDMw collected $232 from pot
*** SUMMARY ***
Total pot $235 | Rake $3
Board [Kd Ac 4d 9h]
Seat 1: NczJqEIUdrpEc5Nbd7h1Ig folded on the Turn
Seat 2: Xl+I49lxCJwPGRuegiaHoA (button) folded before Flop (didn't bet)
Seat 3: voSAIKXtXUUbJnds83sYfQ (small blind) folded before Flop
Seat 4: Lne9leXjEzXWbU3BGFWsxQ (big blind) folded before Flop
Seat 5: jkH6qYMpn8JA/IyBOhQPMw folded before Flop (didn't bet)
Seat 6: ZaYCGtNHUeItoUEheoYDMw collected ($232)



PokerStars Game #59959431636:  Hold'em No Limit ($5/$10) - 2009/07/01 10:33:44 ET
Table 'IyraSBLp+yhyRE6/jd8spA' 2-max Seat #2 is the button
Seat 1: sVocLgrQLp4Ke1DJ2pbNKg ($1364.50 in chips)
Seat 2: ezwKQeNDkLTr+c7tP2UjNw ($2967.25 in chips)
ezwKQeNDkLTr+c7tP2UjNw: posts small blind $5
sVocLgrQLp4Ke1DJ2pbNKg: posts big blind $10
*** HOLE CARDS ***
ezwKQeNDkLTr+c7tP2UjNw: raises $20 to $30
sVocLgrQLp4Ke1DJ2pbNKg: folds
ezwKQeNDkLTr+c7tP2UjNw collected $20 from pot
ezwKQeNDkLTr+c7tP2UjNw: doesn't show hand
*** SUMMARY ***
Total pot $20 | Rake $0
Seat 1: sVocLgrQLp4Ke1DJ2pbNKg (big blind) folded before Flop
Seat 2: ezwKQeNDkLTr+c7tP2UjNw (button) (small blind) collected ($20)



PokerStars Game #59959432564:  Hold'em No Limit ($5/$10) - 2009/07/01 10:33:45 ET
Table '5DMTRmVjl0/Fvn8CWpM59A' 6-max Seat #6 is the button
Seat 1: ovpz8iX9p4XQ/6AFQrnDTw ($490 in chips)
Seat 2: 7SUIdtQak1SCtldWHjwnFA ($229 in chips)
Seat 3: UcFkfWngu95uR8Jhrj+HrQ ($207 in chips)
Seat 4: 2PHCSXghjbGk2qR6jDFe2g ($449.05 in chips)
Seat 5: qK5PPI0zibyu/o2OTOUoSQ ($411 in chips)
Seat 6: 3mTlg4g0FJN2bo939h/0Wg ($49 in chips)
ovpz8iX9p4XQ/6AFQrnDTw: posts small blind $5
7SUIdtQak1SCtldWHjwnFA: posts big blind $10
*** HOLE CARDS ***
UcFkfWngu95uR8Jhrj+HrQ: folds
2PHCSXghjbGk2qR6jDFe2g: folds
qK5PPI0zibyu/o2OTOUoSQ: raises $10 to $20
3mTlg4g0FJN2bo939h/0Wg: folds
ovpz8iX9p4XQ/6AFQrnDTw: calls $15
7SUIdtQak1SCtldWHjwnFA: folds
*** FLOP *** [9c Kc 2s]
ovpz8iX9p4XQ/6AFQrnDTw: checks
qK5PPI0zibyu/o2OTOUoSQ: bets $20
ovpz8iX9p4XQ/6AFQrnDTw: raises $50 to $70
qK5PPI0zibyu/o2OTOUoSQ: raises $50 to $120
ovpz8iX9p4XQ/6AFQrnDTw: folds
qK5PPI0zibyu/o2OTOUoSQ collected $187 from pot
*** SUMMARY ***
Total pot $190 | Rake $3
Board [9c Kc 2s]
Seat 1: ovpz8iX9p4XQ/6AFQrnDTw (small blind) folded on the Flop
Seat 2: 7SUIdtQak1SCtldWHjwnFA (big blind) folded before Flop
Seat 3: UcFkfWngu95uR8Jhrj+HrQ folded before Flop (didn't bet)
Seat 4: 2PHCSXghjbGk2qR6jDFe2g folded before Flop (didn't bet)
Seat 5: qK5PPI0zibyu/o2OTOUoSQ collected ($187)
Seat 6: 3mTlg4g0FJN2bo939h/0Wg (button) folded before Flop (didn't bet)



PokerStars Game #59959438346:  Hold'em No Limit ($5/$10) - 2009/07/01 10:33:53 ET
Table 'IyraSBLp+yhyRE6/jd8spA' 2-max Seat #1 is the button
Seat 1: sVocLgrQLp4Ke1DJ2pbNKg ($1354.50 in chips)
Seat 2: ezwKQeNDkLTr+c7tP2UjNw ($2977.25 in chips)
sVocLgrQLp4Ke1DJ2pbNKg: posts small blind $5
ezwKQeNDkLTr+c7tP2UjNw: posts big blind $10
*** HOLE CARDS ***
sVocLgrQLp4Ke1DJ2pbNKg: raises $20 to $30
ezwKQeNDkLTr+c7tP2UjNw: raises $70 to $100
sVocLgrQLp4Ke1DJ2pbNKg: folds
ezwKQeNDkLTr+c7tP2UjNw collected $60 from pot
ezwKQeNDkLTr+c7tP2UjNw: doesn't show hand
*** SUMMARY ***
Total pot $60 | Rake $0
Seat 1: sVocLgrQLp4Ke1DJ2pbNKg (button) (small blind) folded before Flop
Seat 2: ezwKQeNDkLTr+c7tP2UjNw (big blind) collected ($60)



PokerStars Game #59959441612:  Hold'em No Limit ($5/$10) - 2009/07/01 10:33:57 ET
Table '1Dt9cpcLUVE6HYkx5dUEdQ' 6-max Seat #6 is the button
Seat 1: 2PHCSXghjbGk2qR6jDFe2g ($1826 in chips)
Seat 2: zdS2zKkZYSRe8p+GVcXMgg ($907.50 in chips)
Seat 3: g/z/ANylbdR10I7oPCJdKQ ($715.25 in chips)
Seat 4: voSAIKXtXUUbJnds83sYfQ ($1015 in chips)
Seat 5: 7SUIdtQak1SCtldWHjwnFA ($200 in chips)
Seat 6: 3mTlg4g0FJN2bo939h/0Wg ($583 in chips)
2PHCSXghjbGk2qR6jDFe2g: posts small blind $5
zdS2zKkZYSRe8p+GVcXMgg: posts big blind $10
*** HOLE CARDS ***
g/z/ANylbdR10I7oPCJdKQ: folds
voSAIKXtXUUbJnds83sYfQ: folds
7SUIdtQak1SCtldWHjwnFA: folds
3mTlg4g0FJN2bo939h/0Wg: raises $10 to $20
2PHCSXghjbGk2qR6jDFe2g: folds
zdS2zKkZYSRe8p+GVcXMgg: calls $10
*** FLOP *** [6d 7h Kc]
zdS2zKkZYSRe8p+GVcXMgg: checks
3mTlg4g0FJN2bo939h/0Wg: checks
*** TURN *** [6d 7h Kc] [3h]
zdS2zKkZYSRe8p+GVcXMgg: bets $10
3mTlg4g0FJN2bo939h/0Wg: calls $10
*** RIVER *** [6d 7h Kc 3h] [2c]
zdS2zKkZYSRe8p+GVcXMgg: checks
3mTlg4g0FJN2bo939h/0Wg: bets $40
zdS2zKkZYSRe8p+GVcXMgg: calls $40
*** SHOW DOWN ***
3mTlg4g0FJN2bo939h/0Wg: shows [4h As] (high card Ace)
zdS2zKkZYSRe8p+GVcXMgg: shows [Th 3s] (a pair of Threes)
zdS2zKkZYSRe8p+GVcXMgg collected $142 from pot
*** SUMMARY ***
Total pot $145 | Rake $3
Board [6d 7h Kc 3h 2c]
Seat 1: 2PHCSXghjbGk2qR6jDFe2g (small blind) folded before Flop
Seat 2: zdS2zKkZYSRe8p+GVcXMgg (big blind) showed [Th 3s] and won ($142) with a pair of Threes
Seat 3: g/z/ANylbdR10I7oPCJdKQ folded before Flop (didn't bet)
Seat 4: voSAIKXtXUUbJnds83sYfQ folded before Flop (didn't bet)
Seat 5: 7SUIdtQak1SCtldWHjwnFA folded before Flop (didn't bet)
Seat 6: 3mTlg4g0FJN2bo939h/0Wg (button) showed [4h As] and lost with high card Ace



PokerStars Game #59959445812:  Hold'em No Limit ($5/$10) - 2009/07/01 10:34:02 ET
Table 'IyraSBLp+yhyRE6/jd8spA' 2-max Seat #2 is the button
Seat 1: sVocLgrQLp4Ke1DJ2pbNKg ($1324.50 in chips)
Seat 2: ezwKQeNDkLTr+c7tP2UjNw ($3007.25 in chips)
ezwKQeNDkLTr+c7tP2UjNw: posts small blind $5
sVocLgrQLp4Ke1DJ2pbNKg: posts big blind $10
*** HOLE CARDS ***
ezwKQeNDkLTr+c7tP2UjNw: raises $20 to $30
sVocLgrQLp4Ke1DJ2pbNKg: folds
ezwKQeNDkLTr+c7tP2UjNw collected $20 from pot
ezwKQeNDkLTr+c7tP2UjNw: doesn't show hand
*** SUMMARY ***
Total pot $20 | Rake $0
Seat 1: sVocLgrQLp4Ke1DJ2pbNKg (big blind) folded before Flop
Seat 2: ezwKQeNDkLTr+c7tP2UjNw (button) (small blind) collected ($20)



PokerStars Game #59959453118:  Hold'em No Limit ($5/$10) - 2009/07/01 10:34:11 ET
Table 'IyraSBLp+yhyRE6/jd8spA' 2-max Seat #1 is the button
Seat 1: sVocLgrQLp4Ke1DJ2pbNKg ($1314.50 in chips)
Seat 2: ezwKQeNDkLTr+c7tP2UjNw ($3017.25 in chips)
sVocLgrQLp4Ke1DJ2pbNKg: posts small blind $5
ezwKQeNDkLTr+c7tP2UjNw: posts big blind $10
*** HOLE CARDS ***
sVocLgrQLp4Ke1DJ2pbNKg: folds
ezwKQeNDkLTr+c7tP2UjNw collected $10 from pot
ezwKQeNDkLTr+c7tP2UjNw: doesn't show hand
*** SUMMARY ***
Total pot $10 | Rake $0
Seat 1: sVocLgrQLp4Ke1DJ2pbNKg (button) (small blind) folded before Flop
Seat 2: ezwKQeNDkLTr+c7tP2UjNw (big blind) collected ($10)



PokerStars Game #59959457650:  Hold'em No Limit ($5/$10) - 2009/07/01 10:34:16 ET
Table 'IyraSBLp+yhyRE6/jd8spA' 2-max Seat #2 is the button
Seat 1: sVocLgrQLp4Ke1DJ2pbNKg ($1309.50 in chips)
Seat 2: ezwKQeNDkLTr+c7tP2UjNw ($3022.25 in chips)
ezwKQeNDkLTr+c7tP2UjNw: posts small blind $5
sVocLgrQLp4Ke1DJ2pbNKg: posts big blind $10
*** HOLE CARDS ***
ezwKQeNDkLTr+c7tP2UjNw: raises $20 to $30
sVocLgrQLp4Ke1DJ2pbNKg: calls $20
*** FLOP *** [Ts Qc Th]
sVocLgrQLp4Ke1DJ2pbNKg: checks
ezwKQeNDkLTr+c7tP2UjNw: bets $40
sVocLgrQLp4Ke1DJ2pbNKg: calls $40
*** TURN *** [Ts Qc Th] [4h]
sVocLgrQLp4Ke1DJ2pbNKg: checks
ezwKQeNDkLTr+c7tP2UjNw: bets $100
sVocLgrQLp4Ke1DJ2pbNKg: calls $100
*** RIVER *** [Ts Qc Th 4h] [7s]
sVocLgrQLp4Ke1DJ2pbNKg: checks
ezwKQeNDkLTr+c7tP2UjNw: bets $277
sVocLgrQLp4Ke1DJ2pbNKg: calls $277
*** SHOW DOWN ***
ezwKQeNDkLTr+c7tP2UjNw: shows [Tc 5c] (three of a kind, Tens)
sVocLgrQLp4Ke1DJ2pbNKg: mucks hand
ezwKQeNDkLTr+c7tP2UjNw collected $893.50 from pot
*** SUMMARY ***
Total pot $894 | Rake $0.50
Board [Ts Qc Th 4h 7s]
Seat 1: sVocLgrQLp4Ke1DJ2pbNKg (big blind) mucked
Seat 2: ezwKQeNDkLTr+c7tP2UjNw (button) (small blind) showed [Tc 5c] and won ($893.50) with three of a kind, Tens



PokerStars Game #59959458072:  Hold'em No Limit ($5/$10) - 2009/07/01 10:34:17 ET
Table '5DMTRmVjl0/Fvn8CWpM59A' 6-max Seat #1 is the button
Seat 1: ovpz8iX9p4XQ/6AFQrnDTw ($400 in chips)
Seat 2: 7SUIdtQak1SCtldWHjwnFA ($219 in chips)
Seat 3: UcFkfWngu95uR8Jhrj+HrQ ($207 in chips)
Seat 4: 2PHCSXghjbGk2qR6jDFe2g ($449.05 in chips)
Seat 5: qK5PPI0zibyu/o2OTOUoSQ ($508 in chips)
Seat 6: 3mTlg4g0FJN2bo939h/0Wg ($49 in chips)
7SUIdtQak1SCtldWHjwnFA: posts small blind $5
UcFkfWngu95uR8Jhrj+HrQ: posts big blind $10
*** HOLE CARDS ***
2PHCSXghjbGk2qR6jDFe2g: folds
qK5PPI0zibyu/o2OTOUoSQ: folds
3mTlg4g0FJN2bo939h/0Wg: folds
ovpz8iX9p4XQ/6AFQrnDTw: folds
7SUIdtQak1SCtldWHjwnFA: folds
UcFkfWngu95uR8Jhrj+HrQ collected $10 from pot
UcFkfWngu95uR8Jhrj+HrQ: doesn't show hand
*** SUMMARY ***
Total pot $10 | Rake $0
Seat 1: ovpz8iX9p4XQ/6AFQrnDTw (button) folded before Flop (didn't bet)
Seat 2: 7SUIdtQak1SCtldWHjwnFA (small blind) folded before Flop
Seat 3: UcFkfWngu95uR8Jhrj+HrQ (big blind) collected ($10)
Seat 4: 2PHCSXghjbGk2qR6jDFe2g folded before Flop (didn't bet)
Seat 5: qK5PPI0zibyu/o2OTOUoSQ folded before Flop (didn't bet)
Seat 6: 3mTlg4g0FJN2bo939h/0Wg folded before Flop (didn't bet)



PokerStars Game #59959466466:  Hold'em No Limit ($5/$10) - 2009/07/01 10:34:27 ET
Table '5DMTRmVjl0/Fvn8CWpM59A' 6-max Seat #2 is the button
Seat 1: ovpz8iX9p4XQ/6AFQrnDTw ($400 in chips)
Seat 2: 7SUIdtQak1SCtldWHjwnFA ($214 in chips)
Seat 3: UcFkfWngu95uR8Jhrj+HrQ ($212 in chips)
Seat 4: 2PHCSXghjbGk2qR6jDFe2g ($449.05 in chips)
Seat 5: qK5PPI0zibyu/o2OTOUoSQ ($508 in chips)
Seat 6: 3mTlg4g0FJN2bo939h/0Wg ($49 in chips)
UcFkfWngu95uR8Jhrj+HrQ: posts small blind $5
2PHCSXghjbGk2qR6jDFe2g: posts big blind $10
*** HOLE CARDS ***
qK5PPI0zibyu/o2OTOUoSQ: raises $10 to $20
3mTlg4g0FJN2bo939h/0Wg: folds
ovpz8iX9p4XQ/6AFQrnDTw: calls $20
7SUIdtQak1SCtldWHjwnFA: folds
UcFkfWngu95uR8Jhrj+HrQ: folds
2PHCSXghjbGk2qR6jDFe2g: calls $10
*** FLOP *** [Qh 8s 3c]
2PHCSXghjbGk2qR6jDFe2g: checks
qK5PPI0zibyu/o2OTOUoSQ: bets $20
ovpz8iX9p4XQ/6AFQrnDTw: calls $20
2PHCSXghjbGk2qR6jDFe2g: folds
*** TURN *** [Qh 8s 3c] [9s]
qK5PPI0zibyu/o2OTOUoSQ: bets $20
ovpz8iX9p4XQ/6AFQrnDTw: calls $20
*** RIVER *** [Qh 8s 3c 9s] [Ks]
qK5PPI0zibyu/o2OTOUoSQ: bets $20
ovpz8iX9p4XQ/6AFQrnDTw: calls $20
*** SHOW DOWN ***
qK5PPI0zibyu/o2OTOUoSQ: shows [Tc Qc] (a pair of Queens)
ovpz8iX9p4XQ/6AFQrnDTw: mucks hand
qK5PPI0zibyu/o2OTOUoSQ collected $182 from pot
*** SUMMARY ***
Total pot $185 | Rake $3
Board [Qh 8s 3c 9s Ks]
Seat 1: ovpz8iX9p4XQ/6AFQrnDTw mucked
Seat 2: 7SUIdtQak1SCtldWHjwnFA (button) folded before Flop (didn't bet)
Seat 3: UcFkfWngu95uR8Jhrj+HrQ (small blind) folded before Flop
Seat 4: 2PHCSXghjbGk2qR6jDFe2g (big blind) folded on the Flop
Seat 5: qK5PPI0zibyu/o2OTOUoSQ showed [Tc Qc] and won ($182) with a pair of Queens
Seat 6: 3mTlg4g0FJN2bo939h/0Wg folded before Flop (didn't bet)



PokerStars Game #59959473222:  Hold'em No Limit ($5/$10) - 2009/07/01 10:34:36 ET
Table '1Dt9cpcLUVE6HYkx5dUEdQ' 6-max Seat #1 is the button
Seat 1: 2PHCSXghjbGk2qR6jDFe2g ($1821 in chips)
Seat 2: zdS2zKkZYSRe8p+GVcXMgg ($979.50 in chips)
Seat 3: g/z/ANylbdR10I7oPCJdKQ ($715.25 in chips)
Seat 4: voSAIKXtXUUbJnds83sYfQ ($1015 in chips)
Seat 5: 7SUIdtQak1SCtldWHjwnFA ($200 in chips)
Seat 6: 3mTlg4g0FJN2bo939h/0Wg ($513 in chips)
zdS2zKkZYSRe8p+GVcXMgg: posts small blind $5
g/z/ANylbdR10I7oPCJdKQ: posts big blind $10
*** HOLE CARDS ***
voSAIKXtXUUbJnds83sYfQ: raises $20 to $30
7SUIdtQak1SCtldWHjwnFA: raises $170 to $200 and is all-in
3mTlg4g0FJN2bo939h/0Wg: folds
2PHCSXghjbGk2qR6jDFe2g: folds
zdS2zKkZYSRe8p+GVcXMgg: folds
g/z/ANylbdR10I7oPCJdKQ: folds
voSAIKXtXUUbJnds83sYfQ: folds
7SUIdtQak1SCtldWHjwnFA collected $75 from pot
*** SUMMARY ***
Total pot $75 | Rake $0
Seat 1: 2PHCSXghjbGk2qR6jDFe2g (button) folded before Flop (didn't bet)
Seat 2: zdS2zKkZYSRe8p+GVcXMgg (small blind) folded before Flop
Seat 3: g/z/ANylbdR10I7oPCJdKQ (big blind) folded before Flop
Seat 4: voSAIKXtXUUbJnds83sYfQ folded before Flop
Seat 5: 7SUIdtQak1SCtldWHjwnFA collected ($75)
Seat 6: 3mTlg4g0FJN2bo939h/0Wg folded before Flop (didn't bet)



PokerStars Game #59959480240:  Hold'em No Limit ($5/$10) - 2009/07/01 10:34:44 ET
Table 'IyraSBLp+yhyRE6/jd8spA' 2-max Seat #1 is the button
Seat 1: sVocLgrQLp4Ke1DJ2pbNKg ($1000 in chips)
Seat 2: ezwKQeNDkLTr+c7tP2UjNw ($3468.75 in chips)
sVocLgrQLp4Ke1DJ2pbNKg: posts small blind $5
ezwKQeNDkLTr+c7tP2UjNw: posts big blind $10
*** HOLE CARDS ***
sVocLgrQLp4Ke1DJ2pbNKg: raises $20 to $30
ezwKQeNDkLTr+c7tP2UjNw: folds
sVocLgrQLp4Ke1DJ2pbNKg collected $20 from pot
*** SUMMARY ***
Total pot $20 | Rake $0
Seat 1: sVocLgrQLp4Ke1DJ2pbNKg (button) (small blind) collected ($20)
Seat 2: ezwKQeNDkLTr+c7tP2UjNw (big blind) folded before Flop



PokerStars Game #59959485266:  Hold'em No Limit ($5/$10) - 2009/07/01 10:34:51 ET
Table 'IyraSBLp+yhyRE6/jd8spA' 2-max Seat #2 is the button
Seat 1: sVocLgrQLp4Ke1DJ2pbNKg ($1010 in chips)
Seat 2: ezwKQeNDkLTr+c7tP2UjNw ($3458.75 in chips)
ezwKQeNDkLTr+c7tP2UjNw: posts small blind $5
sVocLgrQLp4Ke1DJ2pbNKg: posts big blind $10
*** HOLE CARDS ***
ezwKQeNDkLTr+c7tP2UjNw: folds
sVocLgrQLp4Ke1DJ2pbNKg collected $10 from pot
sVocLgrQLp4Ke1DJ2pbNKg: doesn't show hand
*** SUMMARY ***
Total pot $10 | Rake $0
Seat 1: sVocLgrQLp4Ke1DJ2pbNKg (big blind) collected ($10)
Seat 2: ezwKQeNDkLTr+c7tP2UjNw (button) (small blind) folded before Flop



PokerStars Game #59959488480:  Hold'em No Limit ($5/$10) - 2009/07/01 10:34:55 ET
Table '2a86NK3xhs21kwGZmbj0QA' 6-max Seat #3 is the button
Seat 1: NczJqEIUdrpEc5Nbd7h1Ig ($473.75 in chips)
Seat 2: Xl+I49lxCJwPGRuegiaHoA ($1000 in chips)
Seat 3: voSAIKXtXUUbJnds83sYfQ ($1000 in chips)
Seat 4: Lne9leXjEzXWbU3BGFWsxQ ($1000 in chips)
Seat 5: jkH6qYMpn8JA/IyBOhQPMw ($2189 in chips)
Seat 6: ZaYCGtNHUeItoUEheoYDMw ($307 in chips)
Lne9leXjEzXWbU3BGFWsxQ: posts small blind $5
jkH6qYMpn8JA/IyBOhQPMw: posts big blind $10
*** HOLE CARDS ***
ZaYCGtNHUeItoUEheoYDMw: folds
NczJqEIUdrpEc5Nbd7h1Ig: folds
ZaYCGtNHUeItoUEheoYDMw leaves the table
Xl+I49lxCJwPGRuegiaHoA: folds
voSAIKXtXUUbJnds83sYfQ: folds
Lne9leXjEzXWbU3BGFWsxQ: folds
UcFkfWngu95uR8Jhrj+HrQ joins the table at seat #6
jkH6qYMpn8JA/IyBOhQPMw collected $10 from pot
jkH6qYMpn8JA/IyBOhQPMw: doesn't show hand
*** SUMMARY ***
Total pot $10 | Rake $0
Seat 1: NczJqEIUdrpEc5Nbd7h1Ig folded before Flop (didn't bet)
Seat 2: Xl+I49lxCJwPGRuegiaHoA folded before Flop (didn't bet)
Seat 3: voSAIKXtXUUbJnds83sYfQ (button) folded before Flop (didn't bet)
Seat 4: Lne9leXjEzXWbU3BGFWsxQ (small blind) folded before Flop
Seat 5: jkH6qYMpn8JA/IyBOhQPMw (big blind) collected ($10)
Seat 6: ZaYCGtNHUeItoUEheoYDMw folded before Flop (didn't bet)



PokerStars Game #59959489466:  Hold'em No Limit ($5/$10) - 2009/07/01 10:34:56 ET
Table 'IyraSBLp+yhyRE6/jd8spA' 2-max Seat #1 is the button
Seat 1: sVocLgrQLp4Ke1DJ2pbNKg ($1015 in chips)
Seat 2: ezwKQeNDkLTr+c7tP2UjNw ($3453.75 in chips)
sVocLgrQLp4Ke1DJ2pbNKg: posts small blind $5
ezwKQeNDkLTr+c7tP2UjNw: posts big blind $10
*** HOLE CARDS ***
sVocLgrQLp4Ke1DJ2pbNKg: raises $20 to $30
ezwKQeNDkLTr+c7tP2UjNw: folds
sVocLgrQLp4Ke1DJ2pbNKg collected $20 from pot
*** SUMMARY ***
Total pot $20 | Rake $0
Seat 1: sVocLgrQLp4Ke1DJ2pbNKg (button) (small blind) collected ($20)
Seat 2: ezwKQeNDkLTr+c7tP2UjNw (big blind) folded before Flop



PokerStars Game #59959494158:  Hold'em No Limit ($5/$10) - 2009/07/01 10:35:02 ET
Table 'IyraSBLp+yhyRE6/jd8spA' 2-max Seat #2 is the button
Seat 1: sVocLgrQLp4Ke1DJ2pbNKg ($1025 in chips)
Seat 2: ezwKQeNDkLTr+c7tP2UjNw ($3443.75 in chips)
ezwKQeNDkLTr+c7tP2UjNw: posts small blind $5
sVocLgrQLp4Ke1DJ2pbNKg: posts big blind $10
*** HOLE CARDS ***
ezwKQeNDkLTr+c7tP2UjNw: raises $20 to $30
sVocLgrQLp4Ke1DJ2pbNKg: raises $70 to $100
ezwKQeNDkLTr+c7tP2UjNw: folds
sVocLgrQLp4Ke1DJ2pbNKg collected $60 from pot
sVocLgrQLp4Ke1DJ2pbNKg: doesn't show hand
*** SUMMARY ***
Total pot $60 | Rake $0
Seat 1: sVocLgrQLp4Ke1DJ2pbNKg (big blind) collected ($60)
Seat 2: ezwKQeNDkLTr+c7tP2UjNw (button) (small blind) folded before Flop



PokerStars Game #59959495854:  Hold'em No Limit ($5/$10) - 2009/07/01 10:35:04 ET
Table '1Dt9cpcLUVE6HYkx5dUEdQ' 6-max Seat #2 is the button
Seat 1: 2PHCSXghjbGk2qR6jDFe2g ($1821 in chips)
Seat 2: zdS2zKkZYSRe8p+GVcXMgg ($974.50 in chips)
Seat 3: g/z/ANylbdR10I7oPCJdKQ ($705.25 in chips)
Seat 4: voSAIKXtXUUbJnds83sYfQ ($1000 in chips)
Seat 5: 7SUIdtQak1SCtldWHjwnFA ($245 in chips)
Seat 6: 3mTlg4g0FJN2bo939h/0Wg ($513 in chips)
g/z/ANylbdR10I7oPCJdKQ: posts small blind $5
voSAIKXtXUUbJnds83sYfQ: posts big blind $10
*** HOLE CARDS ***
7SUIdtQak1SCtldWHjwnFA: folds
3mTlg4g0FJN2bo939h/0Wg: folds
2PHCSXghjbGk2qR6jDFe2g: folds
zdS2zKkZYSRe8p+GVcXMgg: calls $10
g/z/ANylbdR10I7oPCJdKQ: calls $5
voSAIKXtXUUbJnds83sYfQ: checks
*** FLOP *** [4h 9h 6s]
g/z/ANylbdR10I7oPCJdKQ: checks
voSAIKXtXUUbJnds83sYfQ: bets $30
zdS2zKkZYSRe8p+GVcXMgg: calls $30
g/z/ANylbdR10I7oPCJdKQ: folds
*** TURN *** [4h 9h 6s] [7s]
voSAIKXtXUUbJnds83sYfQ: bets $70
zdS2zKkZYSRe8p+GVcXMgg: folds
voSAIKXtXUUbJnds83sYfQ collected $87 from pot
*** SUMMARY ***
Total pot $90 | Rake $3
Board [4h 9h 6s 7s]
Seat 1: 2PHCSXghjbGk2qR6jDFe2g folded before Flop (didn't bet)
Seat 2: zdS2zKkZYSRe8p+GVcXMgg (button) folded on the Turn
Seat 3: g/z/ANylbdR10I7oPCJdKQ (small blind) folded on the Flop
Seat 4: voSAIKXtXUUbJnds83sYfQ (big blind) collected ($87)
Seat 5: 7SUIdtQak1SCtldWHjwnFA folded before Flop (didn't bet)
Seat 6: 3mTlg4g0FJN2bo939h/0Wg folded before Flop (didn't bet)



PokerStars Game #59959498420:  Hold'em No Limit ($5/$10) - 2009/07/01 10:35:07 ET
Table '2a86NK3xhs21kwGZmbj0QA' 6-max Seat #4 is the button
Seat 1: NczJqEIUdrpEc5Nbd7h1Ig ($473.75 in chips)
Seat 2: Xl+I49lxCJwPGRuegiaHoA ($1000 in chips)
Seat 3: voSAIKXtXUUbJnds83sYfQ ($1000 in chips)
Seat 4: Lne9leXjEzXWbU3BGFWsxQ ($1000 in chips)
Seat 5: jkH6qYMpn8JA/IyBOhQPMw ($2194 in chips)
Seat 6: UcFkfWngu95uR8Jhrj+HrQ ($200 in chips)
jkH6qYMpn8JA/IyBOhQPMw: posts small blind $5
UcFkfWngu95uR8Jhrj+HrQ: posts big blind $10
*** HOLE CARDS ***
NczJqEIUdrpEc5Nbd7h1Ig: calls $10
Xl+I49lxCJwPGRuegiaHoA: folds
voSAIKXtXUUbJnds83sYfQ: folds
Lne9leXjEzXWbU3BGFWsxQ: folds
jkH6qYMpn8JA/IyBOhQPMw: calls $5
UcFkfWngu95uR8Jhrj+HrQ: checks
*** FLOP *** [4s 5h Ks]
jkH6qYMpn8JA/IyBOhQPMw: bets $20
UcFkfWngu95uR8Jhrj+HrQ: calls $20
NczJqEIUdrpEc5Nbd7h1Ig: folds
*** TURN *** [4s 5h Ks] [4d]
jkH6qYMpn8JA/IyBOhQPMw: checks
UcFkfWngu95uR8Jhrj+HrQ: checks
*** RIVER *** [4s 5h Ks 4d] [Js]
jkH6qYMpn8JA/IyBOhQPMw: checks
UcFkfWngu95uR8Jhrj+HrQ: checks
*** SHOW DOWN ***
jkH6qYMpn8JA/IyBOhQPMw: shows [3d 6d] (a pair of Fours)
UcFkfWngu95uR8Jhrj+HrQ: shows [7s Kc] (two pair, Kings and Fours)
UcFkfWngu95uR8Jhrj+HrQ collected $67 from pot
*** SUMMARY ***
Total pot $70 | Rake $3
Board [4s 5h Ks 4d Js]
Seat 1: NczJqEIUdrpEc5Nbd7h1Ig folded on the Flop
Seat 2: Xl+I49lxCJwPGRuegiaHoA folded before Flop (didn't bet)
Seat 3: voSAIKXtXUUbJnds83sYfQ folded before Flop (didn't bet)
Seat 4: Lne9leXjEzXWbU3BGFWsxQ (button) folded before Flop (didn't bet)
Seat 5: jkH6qYMpn8JA/IyBOhQPMw (small blind) showed [3d 6d] and lost with a pair of Fours
Seat 6: UcFkfWngu95uR8Jhrj+HrQ (big blind) showed [7s Kc] and won ($67) with two pair, Kings and Fours



PokerStars Game #59959500006:  Hold'em No Limit ($5/$10) - 2009/07/01 10:35:08 ET
Table '5DMTRmVjl0/Fvn8CWpM59A' 6-max Seat #3 is the button
Seat 1: ovpz8iX9p4XQ/6AFQrnDTw ($320 in chips)
Seat 2: 7SUIdtQak1SCtldWHjwnFA ($214 in chips)
Seat 3: UcFkfWngu95uR8Jhrj+HrQ ($207 in chips)
Seat 4: 2PHCSXghjbGk2qR6jDFe2g ($429.05 in chips)
Seat 5: qK5PPI0zibyu/o2OTOUoSQ ($610 in chips)
Seat 6: 3mTlg4g0FJN2bo939h/0Wg ($49 in chips)
2PHCSXghjbGk2qR6jDFe2g: posts small blind $5
qK5PPI0zibyu/o2OTOUoSQ: posts big blind $10
*** HOLE CARDS ***
3mTlg4g0FJN2bo939h/0Wg: folds
ovpz8iX9p4XQ/6AFQrnDTw: folds
7SUIdtQak1SCtldWHjwnFA: folds
UcFkfWngu95uR8Jhrj+HrQ: folds
2PHCSXghjbGk2qR6jDFe2g: folds
qK5PPI0zibyu/o2OTOUoSQ collected $10 from pot
*** SUMMARY ***
Total pot $10 | Rake $0
Seat 1: ovpz8iX9p4XQ/6AFQrnDTw folded before Flop (didn't bet)
Seat 2: 7SUIdtQak1SCtldWHjwnFA folded before Flop (didn't bet)
Seat 3: UcFkfWngu95uR8Jhrj+HrQ (button) folded before Flop (didn't bet)
Seat 4: 2PHCSXghjbGk2qR6jDFe2g (small blind) folded before Flop
Seat 5: qK5PPI0zibyu/o2OTOUoSQ (big blind) collected ($10)
Seat 6: 3mTlg4g0FJN2bo939h/0Wg folded before Flop (didn't bet)



PokerStars Game #59959503732:  Hold'em No Limit ($5/$10) - 2009/07/01 10:35:13 ET
Table 'IyraSBLp+yhyRE6/jd8spA' 2-max Seat #1 is the button
Seat 1: sVocLgrQLp4Ke1DJ2pbNKg ($1055 in chips)
Seat 2: ezwKQeNDkLTr+c7tP2UjNw ($3413.75 in chips)
sVocLgrQLp4Ke1DJ2pbNKg: posts small blind $5
ezwKQeNDkLTr+c7tP2UjNw: posts big blind $10
*** HOLE CARDS ***
sVocLgrQLp4Ke1DJ2pbNKg: raises $20 to $30
ezwKQeNDkLTr+c7tP2UjNw: raises $70 to $100
sVocLgrQLp4Ke1DJ2pbNKg: folds
ezwKQeNDkLTr+c7tP2UjNw collected $60 from pot
ezwKQeNDkLTr+c7tP2UjNw: doesn't show hand
*** SUMMARY ***
Total pot $60 | Rake $0
Seat 1: sVocLgrQLp4Ke1DJ2pbNKg (button) (small blind) folded before Flop
Seat 2: ezwKQeNDkLTr+c7tP2UjNw (big blind) collected ($60)



PokerStars Game #59959508922:  Hold'em No Limit ($5/$10) - 2009/07/01 10:35:20 ET
Table '5DMTRmVjl0/Fvn8CWpM59A' 6-max Seat #4 is the button
Seat 1: ovpz8iX9p4XQ/6AFQrnDTw ($320 in chips)
Seat 2: 7SUIdtQak1SCtldWHjwnFA ($214 in chips)
Seat 3: UcFkfWngu95uR8Jhrj+HrQ ($207 in chips)
Seat 4: 2PHCSXghjbGk2qR6jDFe2g ($424.05 in chips)
Seat 5: qK5PPI0zibyu/o2OTOUoSQ ($615 in chips)
Seat 6: 3mTlg4g0FJN2bo939h/0Wg ($49 in chips)
qK5PPI0zibyu/o2OTOUoSQ: posts small blind $5
3mTlg4g0FJN2bo939h/0Wg: posts big blind $10
*** HOLE CARDS ***
ovpz8iX9p4XQ/6AFQrnDTw: folds
7SUIdtQak1SCtldWHjwnFA: folds
UcFkfWngu95uR8Jhrj+HrQ: folds
2PHCSXghjbGk2qR6jDFe2g: folds
qK5PPI0zibyu/o2OTOUoSQ: calls $5
3mTlg4g0FJN2bo939h/0Wg: checks
*** FLOP *** [Qc 6h 8d]
qK5PPI0zibyu/o2OTOUoSQ: checks
3mTlg4g0FJN2bo939h/0Wg: bets $39 and is all-in
qK5PPI0zibyu/o2OTOUoSQ: calls $39
*** TURN *** [Qc 6h 8d] [9h]
*** RIVER *** [Qc 6h 8d 9h] [Kc]
*** SHOW DOWN ***
qK5PPI0zibyu/o2OTOUoSQ: shows [3s Qd] (a pair of Queens)
3mTlg4g0FJN2bo939h/0Wg: mucks hand
qK5PPI0zibyu/o2OTOUoSQ collected $95 from pot
*** SUMMARY ***
Total pot $98 | Rake $3
Board [Qc 6h 8d 9h Kc]
Seat 1: ovpz8iX9p4XQ/6AFQrnDTw folded before Flop (didn't bet)
Seat 2: 7SUIdtQak1SCtldWHjwnFA folded before Flop (didn't bet)
Seat 3: UcFkfWngu95uR8Jhrj+HrQ folded before Flop (didn't bet)
Seat 4: 2PHCSXghjbGk2qR6jDFe2g (button) folded before Flop (didn't bet)
Seat 5: qK5PPI0zibyu/o2OTOUoSQ (small blind) showed [3s Qd] and won ($95) with a pair of Queens
Seat 6: 3mTlg4g0FJN2bo939h/0Wg (big blind) mucked



PokerStars Game #59959513748:  Hold'em No Limit ($5/$10) - 2009/07/01 10:35:25 ET
Table 'IyraSBLp+yhyRE6/jd8spA' 2-max Seat #2 is the button
Seat 1: sVocLgrQLp4Ke1DJ2pbNKg ($1025 in chips)
Seat 2: ezwKQeNDkLTr+c7tP2UjNw ($3443.75 in chips)
ezwKQeNDkLTr+c7tP2UjNw: posts small blind $5
sVocLgrQLp4Ke1DJ2pbNKg: posts big blind $10
*** HOLE CARDS ***
ezwKQeNDkLTr+c7tP2UjNw: raises $20 to $30
sVocLgrQLp4Ke1DJ2pbNKg: folds
ezwKQeNDkLTr+c7tP2UjNw collected $20 from pot
ezwKQeNDkLTr+c7tP2UjNw: doesn't show hand
*** SUMMARY ***
Total pot $20 | Rake $0
Seat 1: sVocLgrQLp4Ke1DJ2pbNKg (big blind) folded before Flop
Seat 2: ezwKQeNDkLTr+c7tP2UjNw (button) (small blind) collected ($20)



PokerStars Game #59959518728:  Hold'em No Limit ($5/$10) - 2009/07/01 10:35:31 ET
Table 'IyraSBLp+yhyRE6/jd8spA' 2-max Seat #1 is the button
Seat 1: sVocLgrQLp4Ke1DJ2pbNKg ($1015 in chips)
Seat 2: ezwKQeNDkLTr+c7tP2UjNw ($3453.75 in chips)
sVocLgrQLp4Ke1DJ2pbNKg: posts small blind $5
ezwKQeNDkLTr+c7tP2UjNw: posts big blind $10
*** HOLE CARDS ***
sVocLgrQLp4Ke1DJ2pbNKg: raises $20 to $30
ezwKQeNDkLTr+c7tP2UjNw: calls $20
*** FLOP *** [Kd Qh Kh]
ezwKQeNDkLTr+c7tP2UjNw: checks
sVocLgrQLp4Ke1DJ2pbNKg: bets $44
ezwKQeNDkLTr+c7tP2UjNw: folds
sVocLgrQLp4Ke1DJ2pbNKg collected $59.50 from pot
sVocLgrQLp4Ke1DJ2pbNKg: doesn't show hand
*** SUMMARY ***
Total pot $60 | Rake $0.50
Board [Kd Qh Kh]
Seat 1: sVocLgrQLp4Ke1DJ2pbNKg (button) (small blind) collected ($59.50)
Seat 2: ezwKQeNDkLTr+c7tP2UjNw (big blind) folded on the Flop



PokerStars Game #59959528054:  Hold'em No Limit ($5/$10) - 2009/07/01 10:35:42 ET
Table 'IyraSBLp+yhyRE6/jd8spA' 2-max Seat #2 is the button
Seat 1: sVocLgrQLp4Ke1DJ2pbNKg ($1044.50 in chips)
Seat 2: ezwKQeNDkLTr+c7tP2UjNw ($3423.75 in chips)
ezwKQeNDkLTr+c7tP2UjNw: posts small blind $5
sVocLgrQLp4Ke1DJ2pbNKg: posts big blind $10
*** HOLE CARDS ***
ezwKQeNDkLTr+c7tP2UjNw: folds
sVocLgrQLp4Ke1DJ2pbNKg collected $10 from pot
sVocLgrQLp4Ke1DJ2pbNKg: doesn't show hand
*** SUMMARY ***
Total pot $10 | Rake $0
Seat 1: sVocLgrQLp4Ke1DJ2pbNKg (big blind) collected ($10)
Seat 2: ezwKQeNDkLTr+c7tP2UjNw (button) (small blind) folded before Flop



PokerStars Game #59959532572:  Hold'em No Limit ($5/$10) - 2009/07/01 10:35:48 ET
Table 'IyraSBLp+yhyRE6/jd8spA' 2-max Seat #1 is the button
Seat 1: sVocLgrQLp4Ke1DJ2pbNKg ($1049.50 in chips)
Seat 2: ezwKQeNDkLTr+c7tP2UjNw ($3418.75 in chips)
sVocLgrQLp4Ke1DJ2pbNKg: posts small blind $5
ezwKQeNDkLTr+c7tP2UjNw: posts big blind $10
*** HOLE CARDS ***
sVocLgrQLp4Ke1DJ2pbNKg: raises $20 to $30
ezwKQeNDkLTr+c7tP2UjNw: raises $70 to $100
sVocLgrQLp4Ke1DJ2pbNKg: folds
ezwKQeNDkLTr+c7tP2UjNw collected $60 from pot
ezwKQeNDkLTr+c7tP2UjNw: doesn't show hand
*** SUMMARY ***
Total pot $60 | Rake $0
Seat 1: sVocLgrQLp4Ke1DJ2pbNKg (button) (small blind) folded before Flop
Seat 2: ezwKQeNDkLTr+c7tP2UjNw (big blind) collected ($60)



PokerStars Game #59959542924:  Hold'em No Limit ($5/$10) - 2009/07/01 10:36:00 ET
Table 'IyraSBLp+yhyRE6/jd8spA' 2-max Seat #2 is the button
Seat 1: sVocLgrQLp4Ke1DJ2pbNKg ($1019.50 in chips)
Seat 2: ezwKQeNDkLTr+c7tP2UjNw ($3448.75 in chips)
ezwKQeNDkLTr+c7tP2UjNw: posts small blind $5
sVocLgrQLp4Ke1DJ2pbNKg: posts big blind $10
*** HOLE CARDS ***
ezwKQeNDkLTr+c7tP2UjNw: folds
sVocLgrQLp4Ke1DJ2pbNKg collected $10 from pot
sVocLgrQLp4Ke1DJ2pbNKg: doesn't show hand
*** SUMMARY ***
Total pot $10 | Rake $0
Seat 1: sVocLgrQLp4Ke1DJ2pbNKg (big blind) collected ($10)
Seat 2: ezwKQeNDkLTr+c7tP2UjNw (button) (small blind) folded before Flop



PokerStars Game #59959545094:  Hold'em No Limit ($5/$10) - 2009/07/01 10:36:03 ET
Table '5DMTRmVjl0/Fvn8CWpM59A' 6-max Seat #5 is the button
Seat 1: ovpz8iX9p4XQ/6AFQrnDTw ($363.30 in chips)
Seat 2: 7SUIdtQak1SCtldWHjwnFA ($214 in chips)
Seat 3: UcFkfWngu95uR8Jhrj+HrQ ($207 in chips)
Seat 4: 2PHCSXghjbGk2qR6jDFe2g ($424.05 in chips)
Seat 5: qK5PPI0zibyu/o2OTOUoSQ ($661 in chips)
ovpz8iX9p4XQ/6AFQrnDTw: posts small blind $5
7SUIdtQak1SCtldWHjwnFA: posts big blind $10
*** HOLE CARDS ***
3mTlg4g0FJN2bo939h/0Wg leaves the table
UcFkfWngu95uR8Jhrj+HrQ: folds
2PHCSXghjbGk2qR6jDFe2g: folds
qK5PPI0zibyu/o2OTOUoSQ: folds
ovpz8iX9p4XQ/6AFQrnDTw: raises $20 to $30
Xl+I49lxCJwPGRuegiaHoA joins the table at seat #6
7SUIdtQak1SCtldWHjwnFA: calls $20
*** FLOP *** [2s 8d 8c]
ovpz8iX9p4XQ/6AFQrnDTw: checks
7SUIdtQak1SCtldWHjwnFA: checks
*** TURN *** [2s 8d 8c] [Qd]
ovpz8iX9p4XQ/6AFQrnDTw: bets $30
7SUIdtQak1SCtldWHjwnFA: raises $30 to $60
ovpz8iX9p4XQ/6AFQrnDTw: raises $30 to $90
7SUIdtQak1SCtldWHjwnFA: calls $30
*** RIVER *** [2s 8d 8c Qd] [Jh]
ovpz8iX9p4XQ/6AFQrnDTw: bets $100
7SUIdtQak1SCtldWHjwnFA: calls $94 and is all-in
*** SHOW DOWN ***
ovpz8iX9p4XQ/6AFQrnDTw: shows [8h Ah] (three of a kind, Eights)
7SUIdtQak1SCtldWHjwnFA: mucks hand
ovpz8iX9p4XQ/6AFQrnDTw collected $426 from pot
*** SUMMARY ***
Total pot $428 | Rake $2
Board [2s 8d 8c Qd Jh]
Seat 1: ovpz8iX9p4XQ/6AFQrnDTw (small blind) showed [8h Ah] and won ($426) with three of a kind, Eights
Seat 2: 7SUIdtQak1SCtldWHjwnFA (big blind) mucked
Seat 3: UcFkfWngu95uR8Jhrj+HrQ folded before Flop (didn't bet)
Seat 4: 2PHCSXghjbGk2qR6jDFe2g folded before Flop (didn't bet)
Seat 5: qK5PPI0zibyu/o2OTOUoSQ (button) folded before Flop (didn't bet)



PokerStars Game #59959547310:  Hold'em No Limit ($5/$10) - 2009/07/01 10:36:05 ET
Table 'IyraSBLp+yhyRE6/jd8spA' 2-max Seat #1 is the button
Seat 1: sVocLgrQLp4Ke1DJ2pbNKg ($1024.50 in chips)
Seat 2: ezwKQeNDkLTr+c7tP2UjNw ($3443.75 in chips)
sVocLgrQLp4Ke1DJ2pbNKg: posts small blind $5
ezwKQeNDkLTr+c7tP2UjNw: posts big blind $10
*** HOLE CARDS ***
sVocLgrQLp4Ke1DJ2pbNKg: raises $20 to $30
ezwKQeNDkLTr+c7tP2UjNw: calls $20
*** FLOP *** [3d Jd 2c]
ezwKQeNDkLTr+c7tP2UjNw: checks
sVocLgrQLp4Ke1DJ2pbNKg: bets $40
ezwKQeNDkLTr+c7tP2UjNw: raises $80 to $120
sVocLgrQLp4Ke1DJ2pbNKg: folds
ezwKQeNDkLTr+c7tP2UjNw collected $139.50 from pot
ezwKQeNDkLTr+c7tP2UjNw: doesn't show hand
*** SUMMARY ***
Total pot $140 | Rake $0.50
Board [3d Jd 2c]
Seat 1: sVocLgrQLp4Ke1DJ2pbNKg (button) (small blind) folded on the Flop
Seat 2: ezwKQeNDkLTr+c7tP2UjNw (big blind) collected ($139.50)



PokerStars Game #59959548548:  Hold'em No Limit ($5/$10) - 2009/07/01 10:36:07 ET
Table '1Dt9cpcLUVE6HYkx5dUEdQ' 6-max Seat #3 is the button
Seat 1: 2PHCSXghjbGk2qR6jDFe2g ($1821 in chips)
Seat 2: zdS2zKkZYSRe8p+GVcXMgg ($934.50 in chips)
Seat 3: g/z/ANylbdR10I7oPCJdKQ ($695.25 in chips)
Seat 4: voSAIKXtXUUbJnds83sYfQ ($1047 in chips)
Seat 5: 7SUIdtQak1SCtldWHjwnFA ($245 in chips)
Seat 6: 3mTlg4g0FJN2bo939h/0Wg ($513 in chips)
voSAIKXtXUUbJnds83sYfQ: posts small blind $5
7SUIdtQak1SCtldWHjwnFA: posts big blind $10
*** HOLE CARDS ***
3mTlg4g0FJN2bo939h/0Wg: raises $10 to $20
2PHCSXghjbGk2qR6jDFe2g: folds
zdS2zKkZYSRe8p+GVcXMgg: calls $20
g/z/ANylbdR10I7oPCJdKQ: folds
voSAIKXtXUUbJnds83sYfQ: folds
7SUIdtQak1SCtldWHjwnFA: calls $10
*** FLOP *** [Qc Jh 6d]
7SUIdtQak1SCtldWHjwnFA: checks
3mTlg4g0FJN2bo939h/0Wg: checks
zdS2zKkZYSRe8p+GVcXMgg: checks
*** TURN *** [Qc Jh 6d] [Jc]
7SUIdtQak1SCtldWHjwnFA: checks
3mTlg4g0FJN2bo939h/0Wg: checks
zdS2zKkZYSRe8p+GVcXMgg: bets $60
7SUIdtQak1SCtldWHjwnFA: raises $60 to $120
3mTlg4g0FJN2bo939h/0Wg: folds
zdS2zKkZYSRe8p+GVcXMgg: calls $60
*** RIVER *** [Qc Jh 6d Jc] [3h]
7SUIdtQak1SCtldWHjwnFA: bets $30
zdS2zKkZYSRe8p+GVcXMgg: raises $100 to $130
7SUIdtQak1SCtldWHjwnFA: calls $75 and is all-in
*** SHOW DOWN ***
zdS2zKkZYSRe8p+GVcXMgg: shows [Js 3s] (a full house, Jacks full of Threes)
7SUIdtQak1SCtldWHjwnFA: mucks hand
zdS2zKkZYSRe8p+GVcXMgg collected $512 from pot
*** SUMMARY ***
Total pot $515 | Rake $3
Board [Qc Jh 6d Jc 3h]
Seat 1: 2PHCSXghjbGk2qR6jDFe2g folded before Flop (didn't bet)
Seat 2: zdS2zKkZYSRe8p+GVcXMgg showed [Js 3s] and won ($512) with a full house, Jacks full of Threes
Seat 3: g/z/ANylbdR10I7oPCJdKQ (button) folded before Flop (didn't bet)
Seat 4: voSAIKXtXUUbJnds83sYfQ (small blind) folded before Flop
Seat 5: 7SUIdtQak1SCtldWHjwnFA (big blind) mucked
Seat 6: 3mTlg4g0FJN2bo939h/0Wg folded on the Turn



PokerStars Game #59959549658:  Hold'em No Limit ($5/$10) - 2009/07/01 10:36:08 ET
Table '2a86NK3xhs21kwGZmbj0QA' 6-max Seat #5 is the button
Seat 1: NczJqEIUdrpEc5Nbd7h1Ig ($463.75 in chips)
Seat 2: Xl+I49lxCJwPGRuegiaHoA ($1000 in chips)
Seat 3: voSAIKXtXUUbJnds83sYfQ ($1000 in chips)
Seat 4: Lne9leXjEzXWbU3BGFWsxQ ($1000 in chips)
Seat 5: jkH6qYMpn8JA/IyBOhQPMw ($2164 in chips)
Seat 6: UcFkfWngu95uR8Jhrj+HrQ ($237 in chips)
UcFkfWngu95uR8Jhrj+HrQ: posts small blind $5
NczJqEIUdrpEc5Nbd7h1Ig: posts big blind $10
*** HOLE CARDS ***
Xl+I49lxCJwPGRuegiaHoA: folds
voSAIKXtXUUbJnds83sYfQ: folds
Lne9leXjEzXWbU3BGFWsxQ: raises $20 to $30
jkH6qYMpn8JA/IyBOhQPMw: folds
UcFkfWngu95uR8Jhrj+HrQ: folds
NczJqEIUdrpEc5Nbd7h1Ig: calls $20
*** FLOP *** [3h Ah 7h]
NczJqEIUdrpEc5Nbd7h1Ig: checks
Lne9leXjEzXWbU3BGFWsxQ: bets $40
NczJqEIUdrpEc5Nbd7h1Ig: calls $40
*** TURN *** [3h Ah 7h] [2s]
NczJqEIUdrpEc5Nbd7h1Ig: checks
Lne9leXjEzXWbU3BGFWsxQ: checks
*** RIVER *** [3h Ah 7h 2s] [6h]
NczJqEIUdrpEc5Nbd7h1Ig: bets $110
Lne9leXjEzXWbU3BGFWsxQ: folds
NczJqEIUdrpEc5Nbd7h1Ig collected $142 from pot
*** SUMMARY ***
Total pot $145 | Rake $3
Board [3h Ah 7h 2s 6h]
Seat 1: NczJqEIUdrpEc5Nbd7h1Ig (big blind) collected ($142)
Seat 2: Xl+I49lxCJwPGRuegiaHoA folded before Flop (didn't bet)
Seat 3: voSAIKXtXUUbJnds83sYfQ folded before Flop (didn't bet)
Seat 4: Lne9leXjEzXWbU3BGFWsxQ folded on the River
Seat 5: jkH6qYMpn8JA/IyBOhQPMw (button) folded before Flop (didn't bet)
Seat 6: UcFkfWngu95uR8Jhrj+HrQ (small blind) folded before Flop



PokerStars Game #59959560770:  Hold'em No Limit ($5/$10) - 2009/07/01 10:36:21 ET
Table 'IyraSBLp+yhyRE6/jd8spA' 2-max Seat #2 is the button
Seat 1: sVocLgrQLp4Ke1DJ2pbNKg ($1000 in chips)
Seat 2: ezwKQeNDkLTr+c7tP2UjNw ($3513.25 in chips)
ezwKQeNDkLTr+c7tP2UjNw: posts small blind $5
sVocLgrQLp4Ke1DJ2pbNKg: posts big blind $10
*** HOLE CARDS ***
ezwKQeNDkLTr+c7tP2UjNw: raises $20 to $30
sVocLgrQLp4Ke1DJ2pbNKg: calls $20
*** FLOP *** [5s 7h 6s]
sVocLgrQLp4Ke1DJ2pbNKg: checks
ezwKQeNDkLTr+c7tP2UjNw: bets $30
sVocLgrQLp4Ke1DJ2pbNKg: raises $90 to $120
ezwKQeNDkLTr+c7tP2UjNw: calls $90
*** TURN *** [5s 7h 6s] [Qh]
sVocLgrQLp4Ke1DJ2pbNKg: bets $180
ezwKQeNDkLTr+c7tP2UjNw: calls $180
*** RIVER *** [5s 7h 6s Qh] [Qs]
sVocLgrQLp4Ke1DJ2pbNKg: checks
ezwKQeNDkLTr+c7tP2UjNw: checks
*** SHOW DOWN ***
sVocLgrQLp4Ke1DJ2pbNKg: shows [6c Tc] (two pair, Queens and Sixes)
ezwKQeNDkLTr+c7tP2UjNw: mucks hand
sVocLgrQLp4Ke1DJ2pbNKg collected $659.50 from pot
*** SUMMARY ***
Total pot $660 | Rake $0.50
Board [5s 7h 6s Qh Qs]
Seat 1: sVocLgrQLp4Ke1DJ2pbNKg (big blind) showed [6c Tc] and won ($659.50) with two pair, Queens and Sixes
Seat 2: ezwKQeNDkLTr+c7tP2UjNw (button) (small blind) mucked



PokerStars Game #59959578004:  Hold'em No Limit ($5/$10) - 2009/07/01 10:36:42 ET
Table 'IyraSBLp+yhyRE6/jd8spA' 2-max Seat #1 is the button
Seat 1: sVocLgrQLp4Ke1DJ2pbNKg ($1329.50 in chips)
Seat 2: ezwKQeNDkLTr+c7tP2UjNw ($3183.25 in chips)
sVocLgrQLp4Ke1DJ2pbNKg: posts small blind $5
ezwKQeNDkLTr+c7tP2UjNw: posts big blind $10
*** HOLE CARDS ***
sVocLgrQLp4Ke1DJ2pbNKg: raises $20 to $30
ezwKQeNDkLTr+c7tP2UjNw: folds
sVocLgrQLp4Ke1DJ2pbNKg collected $20 from pot
sVocLgrQLp4Ke1DJ2pbNKg: doesn't show hand
*** SUMMARY ***
Total pot $20 | Rake $0
Seat 1: sVocLgrQLp4Ke1DJ2pbNKg (button) (small blind) collected ($20)
Seat 2: ezwKQeNDkLTr+c7tP2UjNw (big blind) folded before Flop



PokerStars Game #59959583502:  Hold'em No Limit ($5/$10) - 2009/07/01 10:36:48 ET
Table 'IyraSBLp+yhyRE6/jd8spA' 2-max Seat #2 is the button
Seat 1: sVocLgrQLp4Ke1DJ2pbNKg ($1339.50 in chips)
Seat 2: ezwKQeNDkLTr+c7tP2UjNw ($3173.25 in chips)
ezwKQeNDkLTr+c7tP2UjNw: posts small blind $5
sVocLgrQLp4Ke1DJ2pbNKg: posts big blind $10
*** HOLE CARDS ***
ezwKQeNDkLTr+c7tP2UjNw: raises $20 to $30
sVocLgrQLp4Ke1DJ2pbNKg: folds
ezwKQeNDkLTr+c7tP2UjNw collected $20 from pot
ezwKQeNDkLTr+c7tP2UjNw: doesn't show hand
*** SUMMARY ***
Total pot $20 | Rake $0
Seat 1: sVocLgrQLp4Ke1DJ2pbNKg (big blind) folded before Flop
Seat 2: ezwKQeNDkLTr+c7tP2UjNw (button) (small blind) collected ($20)



PokerStars Game #59959588172:  Hold'em No Limit ($5/$10) - 2009/07/01 10:36:54 ET
Table 'IyraSBLp+yhyRE6/jd8spA' 2-max Seat #1 is the button
Seat 1: sVocLgrQLp4Ke1DJ2pbNKg ($1329.50 in chips)
Seat 2: ezwKQeNDkLTr+c7tP2UjNw ($3183.25 in chips)
sVocLgrQLp4Ke1DJ2pbNKg: posts small blind $5
ezwKQeNDkLTr+c7tP2UjNw: posts big blind $10
*** HOLE CARDS ***
sVocLgrQLp4Ke1DJ2pbNKg: raises $20 to $30
ezwKQeNDkLTr+c7tP2UjNw: calls $20
*** FLOP *** [4s 4h 6h]
ezwKQeNDkLTr+c7tP2UjNw: bets $30
sVocLgrQLp4Ke1DJ2pbNKg: calls $30
*** TURN *** [4s 4h 6h] [Td]
ezwKQeNDkLTr+c7tP2UjNw: checks
sVocLgrQLp4Ke1DJ2pbNKg: checks
*** RIVER *** [4s 4h 6h Td] [5c]
ezwKQeNDkLTr+c7tP2UjNw: checks
sVocLgrQLp4Ke1DJ2pbNKg: checks
*** SHOW DOWN ***
ezwKQeNDkLTr+c7tP2UjNw: shows [Ah 2d] (a pair of Fours)
sVocLgrQLp4Ke1DJ2pbNKg: shows [Jc Ad] (a pair of Fours - Ace+Jack kicker)
sVocLgrQLp4Ke1DJ2pbNKg collected $119.50 from pot
*** SUMMARY ***
Total pot $120 | Rake $0.50
Board [4s 4h 6h Td 5c]
Seat 1: sVocLgrQLp4Ke1DJ2pbNKg (button) (small blind) showed [Jc Ad] and won ($119.50) with a pair of Fours
Seat 2: ezwKQeNDkLTr+c7tP2UjNw (big blind) showed [Ah 2d] and lost with a pair of Fours



PokerStars Game #59959588230:  Hold'em No Limit ($5/$10) - 2009/07/01 10:36:54 ET
Table '5DMTRmVjl0/Fvn8CWpM59A' 6-max Seat #1 is the button
Seat 1: ovpz8iX9p4XQ/6AFQrnDTw ($575.30 in chips)
Seat 2: 7SUIdtQak1SCtldWHjwnFA ($200 in chips)
Seat 3: UcFkfWngu95uR8Jhrj+HrQ ($207 in chips)
Seat 4: 2PHCSXghjbGk2qR6jDFe2g ($424.05 in chips)
Seat 5: qK5PPI0zibyu/o2OTOUoSQ ($661 in chips)
7SUIdtQak1SCtldWHjwnFA: posts small blind $5
UcFkfWngu95uR8Jhrj+HrQ: posts big blind $10
Xl+I49lxCJwPGRuegiaHoA: sits out
*** HOLE CARDS ***
2PHCSXghjbGk2qR6jDFe2g: folds
qK5PPI0zibyu/o2OTOUoSQ: folds
ovpz8iX9p4XQ/6AFQrnDTw: raises $20 to $30
7SUIdtQak1SCtldWHjwnFA: folds
UcFkfWngu95uR8Jhrj+HrQ: folds
ovpz8iX9p4XQ/6AFQrnDTw collected $25 from pot
ovpz8iX9p4XQ/6AFQrnDTw: doesn't show hand
*** SUMMARY ***
Total pot $25 | Rake $0
Seat 1: ovpz8iX9p4XQ/6AFQrnDTw (button) collected ($25)
Seat 2: 7SUIdtQak1SCtldWHjwnFA (small blind) folded before Flop
Seat 3: UcFkfWngu95uR8Jhrj+HrQ (big blind) folded before Flop
Seat 4: 2PHCSXghjbGk2qR6jDFe2g folded before Flop (didn't bet)
Seat 5: qK5PPI0zibyu/o2OTOUoSQ folded before Flop (didn't bet)



PokerStars Game #59959589626:  Hold'em No Limit ($5/$10) - 2009/07/01 10:36:55 ET
Table '2a86NK3xhs21kwGZmbj0QA' 6-max Seat #6 is the button
Seat 1: NczJqEIUdrpEc5Nbd7h1Ig ($535.75 in chips)
Seat 2: Xl+I49lxCJwPGRuegiaHoA ($1000 in chips)
Seat 3: voSAIKXtXUUbJnds83sYfQ ($1000 in chips)
Seat 4: Lne9leXjEzXWbU3BGFWsxQ ($1000 in chips)
Seat 5: jkH6qYMpn8JA/IyBOhQPMw ($2164 in chips)
Seat 6: UcFkfWngu95uR8Jhrj+HrQ ($232 in chips)
NczJqEIUdrpEc5Nbd7h1Ig: posts small blind $5
Xl+I49lxCJwPGRuegiaHoA: posts big blind $10
*** HOLE CARDS ***
voSAIKXtXUUbJnds83sYfQ: folds
Lne9leXjEzXWbU3BGFWsxQ: folds
jkH6qYMpn8JA/IyBOhQPMw: folds
UcFkfWngu95uR8Jhrj+HrQ: folds
NczJqEIUdrpEc5Nbd7h1Ig: calls $5
Xl+I49lxCJwPGRuegiaHoA: raises $20 to $30
NczJqEIUdrpEc5Nbd7h1Ig: calls $20
*** FLOP *** [9d 6c Kd]
NczJqEIUdrpEc5Nbd7h1Ig: checks
Xl+I49lxCJwPGRuegiaHoA: bets $40
NczJqEIUdrpEc5Nbd7h1Ig: calls $40
*** TURN *** [9d 6c Kd] [Qh]
NczJqEIUdrpEc5Nbd7h1Ig: checks
Xl+I49lxCJwPGRuegiaHoA: bets $90
NczJqEIUdrpEc5Nbd7h1Ig: calls $90
*** RIVER *** [9d 6c Kd Qh] [Ah]
NczJqEIUdrpEc5Nbd7h1Ig: checks
Xl+I49lxCJwPGRuegiaHoA: checks
*** SHOW DOWN ***
NczJqEIUdrpEc5Nbd7h1Ig: shows [4d 6d] (a pair of Sixes)
Xl+I49lxCJwPGRuegiaHoA: mucks hand
NczJqEIUdrpEc5Nbd7h1Ig collected $317 from pot
*** SUMMARY ***
Total pot $320 | Rake $3
Board [9d 6c Kd Qh Ah]
Seat 1: NczJqEIUdrpEc5Nbd7h1Ig (small blind) showed [4d 6d] and won ($317) with a pair of Sixes
Seat 2: Xl+I49lxCJwPGRuegiaHoA (big blind) mucked
Seat 3: voSAIKXtXUUbJnds83sYfQ folded before Flop (didn't bet)
Seat 4: Lne9leXjEzXWbU3BGFWsxQ folded before Flop (didn't bet)
Seat 5: jkH6qYMpn8JA/IyBOhQPMw folded before Flop (didn't bet)
Seat 6: UcFkfWngu95uR8Jhrj+HrQ (button) folded before Flop (didn't bet)



PokerStars Game #59959602770:  Hold'em No Limit ($5/$10) - 2009/07/01 10:37:11 ET
Table '5DMTRmVjl0/Fvn8CWpM59A' 6-max Seat #2 is the button
Seat 1: ovpz8iX9p4XQ/6AFQrnDTw ($590.30 in chips)
Seat 2: 7SUIdtQak1SCtldWHjwnFA ($195 in chips)
Seat 3: UcFkfWngu95uR8Jhrj+HrQ ($197 in chips)
Seat 4: 2PHCSXghjbGk2qR6jDFe2g ($424.05 in chips)
Seat 5: qK5PPI0zibyu/o2OTOUoSQ ($661 in chips)
UcFkfWngu95uR8Jhrj+HrQ: posts small blind $5
2PHCSXghjbGk2qR6jDFe2g: posts big blind $10
Xl+I49lxCJwPGRuegiaHoA: sits out
*** HOLE CARDS ***
qK5PPI0zibyu/o2OTOUoSQ: raises $10 to $20
ovpz8iX9p4XQ/6AFQrnDTw: raises $40 to $60
7SUIdtQak1SCtldWHjwnFA: folds
UcFkfWngu95uR8Jhrj+HrQ: folds
2PHCSXghjbGk2qR6jDFe2g: folds
qK5PPI0zibyu/o2OTOUoSQ: raises $601 to $661 and is all-in
ovpz8iX9p4XQ/6AFQrnDTw: calls $530.30 and is all-in
*** FLOP *** [Ah 9h 4d]
*** TURN *** [Ah 9h 4d] [As]
*** RIVER *** [Ah 9h 4d As] [5d]
*** SHOW DOWN ***
qK5PPI0zibyu/o2OTOUoSQ: shows [Kh Kc] (two pair, Aces and Kings)
ovpz8iX9p4XQ/6AFQrnDTw: mucks hand
qK5PPI0zibyu/o2OTOUoSQ collected $1193.60 from pot
ovpz8iX9p4XQ/6AFQrnDTw leaves the table
*** SUMMARY ***
Total pot $1195.60 | Rake $2
Board [Ah 9h 4d As 5d]
Seat 1: ovpz8iX9p4XQ/6AFQrnDTw mucked
Seat 2: 7SUIdtQak1SCtldWHjwnFA (button) folded before Flop (didn't bet)
Seat 3: UcFkfWngu95uR8Jhrj+HrQ (small blind) folded before Flop
Seat 4: 2PHCSXghjbGk2qR6jDFe2g (big blind) folded before Flop
Seat 5: qK5PPI0zibyu/o2OTOUoSQ showed [Kh Kc] and won ($1193.60) with two pair, Aces and Kings



PokerStars Game #59959603696:  Hold'em No Limit ($5/$10) - 2009/07/01 10:37:12 ET
Table 'IyraSBLp+yhyRE6/jd8spA' 2-max Seat #2 is the button
Seat 1: sVocLgrQLp4Ke1DJ2pbNKg ($1389 in chips)
Seat 2: ezwKQeNDkLTr+c7tP2UjNw ($3123.25 in chips)
ezwKQeNDkLTr+c7tP2UjNw: posts small blind $5
sVocLgrQLp4Ke1DJ2pbNKg: posts big blind $10
*** HOLE CARDS ***
ezwKQeNDkLTr+c7tP2UjNw: raises $20 to $30
sVocLgrQLp4Ke1DJ2pbNKg: folds
ezwKQeNDkLTr+c7tP2UjNw collected $20 from pot
ezwKQeNDkLTr+c7tP2UjNw: doesn't show hand
*** SUMMARY ***
Total pot $20 | Rake $0
Seat 1: sVocLgrQLp4Ke1DJ2pbNKg (big blind) folded before Flop
Seat 2: ezwKQeNDkLTr+c7tP2UjNw (button) (small blind) collected ($20)



PokerStars Game #59959609978:  Hold'em No Limit ($5/$10) - 2009/07/01 10:37:19 ET
Table 'IyraSBLp+yhyRE6/jd8spA' 2-max Seat #1 is the button
Seat 1: sVocLgrQLp4Ke1DJ2pbNKg ($1379 in chips)
Seat 2: ezwKQeNDkLTr+c7tP2UjNw ($3133.25 in chips)
sVocLgrQLp4Ke1DJ2pbNKg: posts small blind $5
ezwKQeNDkLTr+c7tP2UjNw: posts big blind $10
*** HOLE CARDS ***
sVocLgrQLp4Ke1DJ2pbNKg: raises $20 to $30
ezwKQeNDkLTr+c7tP2UjNw: calls $20
*** FLOP *** [9h Qc As]
ezwKQeNDkLTr+c7tP2UjNw: checks
sVocLgrQLp4Ke1DJ2pbNKg: bets $44
ezwKQeNDkLTr+c7tP2UjNw: calls $44
*** TURN *** [9h Qc As] [9s]
ezwKQeNDkLTr+c7tP2UjNw: checks
sVocLgrQLp4Ke1DJ2pbNKg: checks
*** RIVER *** [9h Qc As 9s] [3s]
ezwKQeNDkLTr+c7tP2UjNw: checks
sVocLgrQLp4Ke1DJ2pbNKg: bets $120
ezwKQeNDkLTr+c7tP2UjNw: calls $120
*** SHOW DOWN ***
sVocLgrQLp4Ke1DJ2pbNKg: shows [Ac 7c] (two pair, Aces and Nines)
ezwKQeNDkLTr+c7tP2UjNw: mucks hand
sVocLgrQLp4Ke1DJ2pbNKg collected $387.50 from pot
*** SUMMARY ***
Total pot $388 | Rake $0.50
Board [9h Qc As 9s 3s]
Seat 1: sVocLgrQLp4Ke1DJ2pbNKg (button) (small blind) showed [Ac 7c] and won ($387.50) with two pair, Aces and Nines
Seat 2: ezwKQeNDkLTr+c7tP2UjNw (big blind) mucked



PokerStars Game #59959622650:  Hold'em No Limit ($5/$10) - 2009/07/01 10:37:34 ET
Table '1Dt9cpcLUVE6HYkx5dUEdQ' 6-max Seat #4 is the button
Seat 1: 2PHCSXghjbGk2qR6jDFe2g ($1821 in chips)
Seat 2: zdS2zKkZYSRe8p+GVcXMgg ($1201.50 in chips)
Seat 3: g/z/ANylbdR10I7oPCJdKQ ($695.25 in chips)
Seat 4: voSAIKXtXUUbJnds83sYfQ ($1042 in chips)
Seat 5: 7SUIdtQak1SCtldWHjwnFA ($200 in chips)
Seat 6: 3mTlg4g0FJN2bo939h/0Wg ($493 in chips)
7SUIdtQak1SCtldWHjwnFA: posts small blind $5
3mTlg4g0FJN2bo939h/0Wg: posts big blind $10
*** HOLE CARDS ***
2PHCSXghjbGk2qR6jDFe2g: folds
zdS2zKkZYSRe8p+GVcXMgg: folds
g/z/ANylbdR10I7oPCJdKQ: folds
voSAIKXtXUUbJnds83sYfQ: folds
7SUIdtQak1SCtldWHjwnFA: folds
3mTlg4g0FJN2bo939h/0Wg collected $10 from pot
*** SUMMARY ***
Total pot $10 | Rake $0
Seat 1: 2PHCSXghjbGk2qR6jDFe2g folded before Flop (didn't bet)
Seat 2: zdS2zKkZYSRe8p+GVcXMgg folded before Flop (didn't bet)
Seat 3: g/z/ANylbdR10I7oPCJdKQ folded before Flop (didn't bet)
Seat 4: voSAIKXtXUUbJnds83sYfQ (button) folded before Flop (didn't bet)
Seat 5: 7SUIdtQak1SCtldWHjwnFA (small blind) folded before Flop
Seat 6: 3mTlg4g0FJN2bo939h/0Wg (big blind) collected ($10)



PokerStars Game #59959628246:  Hold'em No Limit ($5/$10) - 2009/07/01 10:37:41 ET
Table 'IyraSBLp+yhyRE6/jd8spA' 2-max Seat #2 is the button
Seat 1: sVocLgrQLp4Ke1DJ2pbNKg ($1572.50 in chips)
Seat 2: ezwKQeNDkLTr+c7tP2UjNw ($2939.25 in chips)
ezwKQeNDkLTr+c7tP2UjNw: posts small blind $5
sVocLgrQLp4Ke1DJ2pbNKg: posts big blind $10
*** HOLE CARDS ***
ezwKQeNDkLTr+c7tP2UjNw: raises $20 to $30
sVocLgrQLp4Ke1DJ2pbNKg: folds
ezwKQeNDkLTr+c7tP2UjNw collected $20 from pot
ezwKQeNDkLTr+c7tP2UjNw: doesn't show hand
*** SUMMARY ***
Total pot $20 | Rake $0
Seat 1: sVocLgrQLp4Ke1DJ2pbNKg (big blind) folded before Flop
Seat 2: ezwKQeNDkLTr+c7tP2UjNw (button) (small blind) collected ($20)



PokerStars Game #59959632094:  Hold'em No Limit ($5/$10) - 2009/07/01 10:37:46 ET
Table '5DMTRmVjl0/Fvn8CWpM59A' 6-max Seat #3 is the button
Seat 2: 7SUIdtQak1SCtldWHjwnFA ($195 in chips)
Seat 3: UcFkfWngu95uR8Jhrj+HrQ ($192 in chips)
Seat 4: 2PHCSXghjbGk2qR6jDFe2g ($414.05 in chips)
Seat 5: qK5PPI0zibyu/o2OTOUoSQ ($1264.30 in chips)
2PHCSXghjbGk2qR6jDFe2g: posts small blind $5
qK5PPI0zibyu/o2OTOUoSQ: posts big blind $10
Xl+I49lxCJwPGRuegiaHoA: sits out
*** HOLE CARDS ***
7SUIdtQak1SCtldWHjwnFA: folds
UcFkfWngu95uR8Jhrj+HrQ: folds
2PHCSXghjbGk2qR6jDFe2g: folds
qK5PPI0zibyu/o2OTOUoSQ collected $10 from pot
*** SUMMARY ***
Total pot $10 | Rake $0
Seat 2: 7SUIdtQak1SCtldWHjwnFA folded before Flop (didn't bet)
Seat 3: UcFkfWngu95uR8Jhrj+HrQ (button) folded before Flop (didn't bet)
Seat 4: 2PHCSXghjbGk2qR6jDFe2g (small blind) folded before Flop
Seat 5: qK5PPI0zibyu/o2OTOUoSQ (big blind) collected ($10)



PokerStars Game #59959634300:  Hold'em No Limit ($5/$10) - 2009/07/01 10:37:49 ET
Table 'IyraSBLp+yhyRE6/jd8spA' 2-max Seat #1 is the button
Seat 1: sVocLgrQLp4Ke1DJ2pbNKg ($1562.50 in chips)
Seat 2: ezwKQeNDkLTr+c7tP2UjNw ($2949.25 in chips)
sVocLgrQLp4Ke1DJ2pbNKg: posts small blind $5
ezwKQeNDkLTr+c7tP2UjNw: posts big blind $10
*** HOLE CARDS ***
sVocLgrQLp4Ke1DJ2pbNKg: raises $20 to $30
ezwKQeNDkLTr+c7tP2UjNw: raises $70 to $100
sVocLgrQLp4Ke1DJ2pbNKg: folds
ezwKQeNDkLTr+c7tP2UjNw collected $60 from pot
ezwKQeNDkLTr+c7tP2UjNw: doesn't show hand
*** SUMMARY ***
Total pot $60 | Rake $0
Seat 1: sVocLgrQLp4Ke1DJ2pbNKg (button) (small blind) folded before Flop
Seat 2: ezwKQeNDkLTr+c7tP2UjNw (big blind) collected ($60)



PokerStars Game #59959635708:  Hold'em No Limit ($5/$10) - 2009/07/01 10:37:51 ET
Table '1Dt9cpcLUVE6HYkx5dUEdQ' 6-max Seat #5 is the button
Seat 1: 2PHCSXghjbGk2qR6jDFe2g ($1821 in chips)
Seat 2: zdS2zKkZYSRe8p+GVcXMgg ($1201.50 in chips)
Seat 3: g/z/ANylbdR10I7oPCJdKQ ($695.25 in chips)
Seat 4: voSAIKXtXUUbJnds83sYfQ ($1042 in chips)
Seat 5: 7SUIdtQak1SCtldWHjwnFA ($195 in chips)
Seat 6: 3mTlg4g0FJN2bo939h/0Wg ($498 in chips)
3mTlg4g0FJN2bo939h/0Wg: posts small blind $5
2PHCSXghjbGk2qR6jDFe2g: posts big blind $10
*** HOLE CARDS ***
zdS2zKkZYSRe8p+GVcXMgg: calls $10
g/z/ANylbdR10I7oPCJdKQ: calls $10
voSAIKXtXUUbJnds83sYfQ: folds
7SUIdtQak1SCtldWHjwnFA: raises $30 to $40
3mTlg4g0FJN2bo939h/0Wg: folds
2PHCSXghjbGk2qR6jDFe2g: folds
zdS2zKkZYSRe8p+GVcXMgg: calls $30
g/z/ANylbdR10I7oPCJdKQ: calls $30
*** FLOP *** [Qc 3d 9s]
zdS2zKkZYSRe8p+GVcXMgg: checks
g/z/ANylbdR10I7oPCJdKQ: bets $55
7SUIdtQak1SCtldWHjwnFA: raises $100 to $155 and is all-in
zdS2zKkZYSRe8p+GVcXMgg: folds
g/z/ANylbdR10I7oPCJdKQ: calls $100
*** TURN *** [Qc 3d 9s] [Qd]
*** RIVER *** [Qc 3d 9s Qd] [Qs]
*** SHOW DOWN ***
g/z/ANylbdR10I7oPCJdKQ: shows [Ah Js] (three of a kind, Queens)
7SUIdtQak1SCtldWHjwnFA: mucks hand
g/z/ANylbdR10I7oPCJdKQ collected $442 from pot
*** SUMMARY ***
Total pot $445 | Rake $3
Board [Qc 3d 9s Qd Qs]
Seat 1: 2PHCSXghjbGk2qR6jDFe2g (big blind) folded before Flop
Seat 2: zdS2zKkZYSRe8p+GVcXMgg folded on the Flop
Seat 3: g/z/ANylbdR10I7oPCJdKQ showed [Ah Js] and won ($442) with three of a kind, Queens
Seat 4: voSAIKXtXUUbJnds83sYfQ folded before Flop (didn't bet)
Seat 5: 7SUIdtQak1SCtldWHjwnFA (button) mucked
Seat 6: 3mTlg4g0FJN2bo939h/0Wg (small blind) folded before Flop



PokerStars Game #59959641174:  Hold'em No Limit ($5/$10) - 2009/07/01 10:37:57 ET
Table '5DMTRmVjl0/Fvn8CWpM59A' 6-max Seat #4 is the button
Seat 2: 7SUIdtQak1SCtldWHjwnFA ($195 in chips)
Seat 3: UcFkfWngu95uR8Jhrj+HrQ ($192 in chips)
Seat 4: 2PHCSXghjbGk2qR6jDFe2g ($409.05 in chips)
Seat 5: qK5PPI0zibyu/o2OTOUoSQ ($1269.30 in chips)
Seat 6: Xl+I49lxCJwPGRuegiaHoA ($1000 in chips)
qK5PPI0zibyu/o2OTOUoSQ: posts small blind $5
Xl+I49lxCJwPGRuegiaHoA: posts big blind $10
*** HOLE CARDS ***
jkH6qYMpn8JA/IyBOhQPMw joins the table at seat #1
7SUIdtQak1SCtldWHjwnFA: folds
UcFkfWngu95uR8Jhrj+HrQ: raises $10 to $20
2PHCSXghjbGk2qR6jDFe2g: calls $20
qK5PPI0zibyu/o2OTOUoSQ: folds
Xl+I49lxCJwPGRuegiaHoA: calls $10
*** FLOP *** [8h Th 8d]
Xl+I49lxCJwPGRuegiaHoA: bets $20
UcFkfWngu95uR8Jhrj+HrQ: raises $60 to $80
2PHCSXghjbGk2qR6jDFe2g: calls $80
Xl+I49lxCJwPGRuegiaHoA: folds
*** TURN *** [8h Th 8d] [7h]
UcFkfWngu95uR8Jhrj+HrQ: checks
2PHCSXghjbGk2qR6jDFe2g: bets $90
UcFkfWngu95uR8Jhrj+HrQ: folds
2PHCSXghjbGk2qR6jDFe2g collected $243 from pot
2PHCSXghjbGk2qR6jDFe2g: doesn't show hand
*** SUMMARY ***
Total pot $245 | Rake $2
Board [8h Th 8d 7h]
Seat 2: 7SUIdtQak1SCtldWHjwnFA folded before Flop (didn't bet)
Seat 3: UcFkfWngu95uR8Jhrj+HrQ folded on the Turn
Seat 4: 2PHCSXghjbGk2qR6jDFe2g (button) collected ($243)
Seat 5: qK5PPI0zibyu/o2OTOUoSQ (small blind) folded before Flop
Seat 6: Xl+I49lxCJwPGRuegiaHoA (big blind) folded on the Flop



PokerStars Game #59959652554:  Hold'em No Limit ($5/$10) - 2009/07/01 10:38:10 ET
Table '2a86NK3xhs21kwGZmbj0QA' 6-max Seat #1 is the button
Seat 1: NczJqEIUdrpEc5Nbd7h1Ig ($692.75 in chips)
Seat 2: Xl+I49lxCJwPGRuegiaHoA ($1000 in chips)
Seat 3: voSAIKXtXUUbJnds83sYfQ ($1000 in chips)
Seat 4: Lne9leXjEzXWbU3BGFWsxQ ($1000 in chips)
Seat 5: jkH6qYMpn8JA/IyBOhQPMw ($2164 in chips)
Seat 6: UcFkfWngu95uR8Jhrj+HrQ ($232 in chips)
Xl+I49lxCJwPGRuegiaHoA: posts small blind $5
voSAIKXtXUUbJnds83sYfQ: posts big blind $10
*** HOLE CARDS ***
Lne9leXjEzXWbU3BGFWsxQ: folds
jkH6qYMpn8JA/IyBOhQPMw: folds
UcFkfWngu95uR8Jhrj+HrQ: folds
NczJqEIUdrpEc5Nbd7h1Ig: raises $20 to $30
Xl+I49lxCJwPGRuegiaHoA: folds
voSAIKXtXUUbJnds83sYfQ: folds
NczJqEIUdrpEc5Nbd7h1Ig collected $25 from pot
*** SUMMARY ***
Total pot $25 | Rake $0
Seat 1: NczJqEIUdrpEc5Nbd7h1Ig (button) collected ($25)
Seat 2: Xl+I49lxCJwPGRuegiaHoA (small blind) folded before Flop
Seat 3: voSAIKXtXUUbJnds83sYfQ (big blind) folded before Flop
Seat 4: Lne9leXjEzXWbU3BGFWsxQ folded before Flop (didn't bet)
Seat 5: jkH6qYMpn8JA/IyBOhQPMw folded before Flop (didn't bet)
Seat 6: UcFkfWngu95uR8Jhrj+HrQ folded before Flop (didn't bet)



PokerStars Game #59959669474:  Hold'em No Limit ($5/$10) - 2009/07/01 10:38:30 ET
Table '2a86NK3xhs21kwGZmbj0QA' 6-max Seat #2 is the button
Seat 1: NczJqEIUdrpEc5Nbd7h1Ig ($707.75 in chips)
Seat 2: Xl+I49lxCJwPGRuegiaHoA ($1000 in chips)
Seat 3: voSAIKXtXUUbJnds83sYfQ ($1000 in chips)
Seat 4: Lne9leXjEzXWbU3BGFWsxQ ($1000 in chips)
Seat 5: jkH6qYMpn8JA/IyBOhQPMw ($2164 in chips)
Seat 6: UcFkfWngu95uR8Jhrj+HrQ ($232 in chips)
voSAIKXtXUUbJnds83sYfQ: posts small blind $5
Lne9leXjEzXWbU3BGFWsxQ: posts big blind $10
*** HOLE CARDS ***
jkH6qYMpn8JA/IyBOhQPMw: folds
UcFkfWngu95uR8Jhrj+HrQ: raises $20 to $30
NczJqEIUdrpEc5Nbd7h1Ig: calls $30
Xl+I49lxCJwPGRuegiaHoA: raises $100 to $130
voSAIKXtXUUbJnds83sYfQ: folds
Lne9leXjEzXWbU3BGFWsxQ: folds
UcFkfWngu95uR8Jhrj+HrQ: folds
NczJqEIUdrpEc5Nbd7h1Ig: folds
Xl+I49lxCJwPGRuegiaHoA collected $105 from pot
Xl+I49lxCJwPGRuegiaHoA: doesn't show hand
*** SUMMARY ***
Total pot $105 | Rake $0
Seat 1: NczJqEIUdrpEc5Nbd7h1Ig folded before Flop
Seat 2: Xl+I49lxCJwPGRuegiaHoA (button) collected ($105)
Seat 3: voSAIKXtXUUbJnds83sYfQ (small blind) folded before Flop
Seat 4: Lne9leXjEzXWbU3BGFWsxQ (big blind) folded before Flop
Seat 5: jkH6qYMpn8JA/IyBOhQPMw folded before Flop (didn't bet)
Seat 6: UcFkfWngu95uR8Jhrj+HrQ folded before Flop



PokerStars Game #59959690746:  Hold'em No Limit ($5/$10) - 2009/07/01 10:38:56 ET
Table '2a86NK3xhs21kwGZmbj0QA' 6-max Seat #3 is the button
Seat 1: NczJqEIUdrpEc5Nbd7h1Ig ($677.75 in chips)
Seat 2: Xl+I49lxCJwPGRuegiaHoA ($1075 in chips)
Seat 3: voSAIKXtXUUbJnds83sYfQ ($1000 in chips)
Seat 4: Lne9leXjEzXWbU3BGFWsxQ ($1000 in chips)
Seat 5: jkH6qYMpn8JA/IyBOhQPMw ($2164 in chips)
Seat 6: UcFkfWngu95uR8Jhrj+HrQ ($202 in chips)
Lne9leXjEzXWbU3BGFWsxQ: posts small blind $5
jkH6qYMpn8JA/IyBOhQPMw: posts big blind $10
*** HOLE CARDS ***
UcFkfWngu95uR8Jhrj+HrQ: folds
NczJqEIUdrpEc5Nbd7h1Ig: calls $10
Xl+I49lxCJwPGRuegiaHoA: raises $30 to $40
voSAIKXtXUUbJnds83sYfQ: folds
Lne9leXjEzXWbU3BGFWsxQ: folds
jkH6qYMpn8JA/IyBOhQPMw: folds
NczJqEIUdrpEc5Nbd7h1Ig: calls $30
*** FLOP *** [Jd Jh Qs]
NczJqEIUdrpEc5Nbd7h1Ig: checks
Xl+I49lxCJwPGRuegiaHoA: bets $45
NczJqEIUdrpEc5Nbd7h1Ig: folds
Xl+I49lxCJwPGRuegiaHoA collected $92 from pot
Xl+I49lxCJwPGRuegiaHoA: doesn't show hand
*** SUMMARY ***
Total pot $95 | Rake $3
Board [Jd Jh Qs]
Seat 1: NczJqEIUdrpEc5Nbd7h1Ig folded on the Flop
Seat 2: Xl+I49lxCJwPGRuegiaHoA collected ($92)
Seat 3: voSAIKXtXUUbJnds83sYfQ (button) folded before Flop (didn't bet)
Seat 4: Lne9leXjEzXWbU3BGFWsxQ (small blind) folded before Flop
Seat 5: jkH6qYMpn8JA/IyBOhQPMw (big blind) folded before Flop
Seat 6: UcFkfWngu95uR8Jhrj+HrQ folded before Flop (didn't bet)



PokerStars Game #59959701686:  Hold'em No Limit ($5/$10) - 2009/07/01 10:39:09 ET
Table '5DMTRmVjl0/Fvn8CWpM59A' 6-max Seat #5 is the button
Seat 1: jkH6qYMpn8JA/IyBOhQPMw ($1000 in chips)
Seat 2: 7SUIdtQak1SCtldWHjwnFA ($195 in chips)
Seat 3: UcFkfWngu95uR8Jhrj+HrQ ($92 in chips)
Seat 4: 2PHCSXghjbGk2qR6jDFe2g ($552.05 in chips)
Seat 5: qK5PPI0zibyu/o2OTOUoSQ ($1264.30 in chips)
Seat 6: Xl+I49lxCJwPGRuegiaHoA ($1000 in chips)
Xl+I49lxCJwPGRuegiaHoA: posts small blind $5
jkH6qYMpn8JA/IyBOhQPMw: posts big blind $10
*** HOLE CARDS ***
7SUIdtQak1SCtldWHjwnFA: raises $12 to $22
UcFkfWngu95uR8Jhrj+HrQ: folds
2PHCSXghjbGk2qR6jDFe2g: folds
qK5PPI0zibyu/o2OTOUoSQ: raises $28 to $50
Xl+I49lxCJwPGRuegiaHoA: folds
jkH6qYMpn8JA/IyBOhQPMw: calls $40
7SUIdtQak1SCtldWHjwnFA: folds
*** FLOP *** [2d 8d 5d]
jkH6qYMpn8JA/IyBOhQPMw: checks
qK5PPI0zibyu/o2OTOUoSQ: bets $40
jkH6qYMpn8JA/IyBOhQPMw: folds
qK5PPI0zibyu/o2OTOUoSQ collected $124 from pot
*** SUMMARY ***
Total pot $127 | Rake $3
Board [2d 8d 5d]
Seat 1: jkH6qYMpn8JA/IyBOhQPMw (big blind) folded on the Flop
Seat 2: 7SUIdtQak1SCtldWHjwnFA folded before Flop
Seat 3: UcFkfWngu95uR8Jhrj+HrQ folded before Flop (didn't bet)
Seat 4: 2PHCSXghjbGk2qR6jDFe2g folded before Flop (didn't bet)
Seat 5: qK5PPI0zibyu/o2OTOUoSQ (button) collected ($124)
Seat 6: Xl+I49lxCJwPGRuegiaHoA (small blind) folded before Flop



PokerStars Game #59959705734:  Hold'em No Limit ($5/$10) - 2009/07/01 10:39:14 ET
Table 'dwLGEw3aoH/cOAI7JsLdmw' 6-max Seat #4 is the button
Seat 1: xNrvKa8pDLb8LKHUI3AbhQ ($1054 in chips)
Seat 2: 7SUIdtQak1SCtldWHjwnFA ($200 in chips)
Seat 3: LM7rbnKcNcdtchNuEDebUw ($160 in chips)
Seat 4: kykGjpk/IjfbH8Gi6SIm5w ($211 in chips)
Seat 5: g/z/ANylbdR10I7oPCJdKQ ($220 in chips)
Seat 6: 3mTlg4g0FJN2bo939h/0Wg ($345 in chips)
g/z/ANylbdR10I7oPCJdKQ: posts small blind $5
3mTlg4g0FJN2bo939h/0Wg: posts big blind $10
*** HOLE CARDS ***
xNrvKa8pDLb8LKHUI3AbhQ: folds
7SUIdtQak1SCtldWHjwnFA: folds
LM7rbnKcNcdtchNuEDebUw: folds
kykGjpk/IjfbH8Gi6SIm5w: folds
g/z/ANylbdR10I7oPCJdKQ: folds
3mTlg4g0FJN2bo939h/0Wg collected $10 from pot
*** SUMMARY ***
Total pot $10 | Rake $0
Seat 1: xNrvKa8pDLb8LKHUI3AbhQ folded before Flop (didn't bet)
Seat 2: 7SUIdtQak1SCtldWHjwnFA folded before Flop (didn't bet)
Seat 3: LM7rbnKcNcdtchNuEDebUw folded before Flop (didn't bet)
Seat 4: kykGjpk/IjfbH8Gi6SIm5w (button) folded before Flop (didn't bet)
Seat 5: g/z/ANylbdR10I7oPCJdKQ (small blind) folded before Flop
Seat 6: 3mTlg4g0FJN2bo939h/0Wg (big blind) collected ($10)



PokerStars Game #59959720418:  Hold'em No Limit ($5/$10) - 2009/07/01 10:39:31 ET
Table '1Dt9cpcLUVE6HYkx5dUEdQ' 6-max Seat #6 is the button
Seat 1: 2PHCSXghjbGk2qR6jDFe2g ($1811 in chips)
Seat 2: zdS2zKkZYSRe8p+GVcXMgg ($1161.50 in chips)
Seat 3: g/z/ANylbdR10I7oPCJdKQ ($942.25 in chips)
Seat 4: voSAIKXtXUUbJnds83sYfQ ($1042 in chips)
Seat 5: 7SUIdtQak1SCtldWHjwnFA ($200 in chips)
Seat 6: 3mTlg4g0FJN2bo939h/0Wg ($493 in chips)
2PHCSXghjbGk2qR6jDFe2g: posts small blind $5
zdS2zKkZYSRe8p+GVcXMgg: posts big blind $10
*** HOLE CARDS ***
g/z/ANylbdR10I7oPCJdKQ: folds
voSAIKXtXUUbJnds83sYfQ: folds
7SUIdtQak1SCtldWHjwnFA: raises $12 to $22
3mTlg4g0FJN2bo939h/0Wg: folds
2PHCSXghjbGk2qR6jDFe2g: folds
zdS2zKkZYSRe8p+GVcXMgg: calls $12
*** FLOP *** [5d Kc Ks]
zdS2zKkZYSRe8p+GVcXMgg: checks
7SUIdtQak1SCtldWHjwnFA: checks
*** TURN *** [5d Kc Ks] [Qs]
zdS2zKkZYSRe8p+GVcXMgg: checks
7SUIdtQak1SCtldWHjwnFA: checks
*** RIVER *** [5d Kc Ks Qs] [Ac]
zdS2zKkZYSRe8p+GVcXMgg: checks
7SUIdtQak1SCtldWHjwnFA: checks
*** SHOW DOWN ***
zdS2zKkZYSRe8p+GVcXMgg: shows [4d Qd] (two pair, Kings and Queens)
7SUIdtQak1SCtldWHjwnFA: mucks hand
zdS2zKkZYSRe8p+GVcXMgg collected $46.55 from pot
*** SUMMARY ***
Total pot $49 | Rake $2.45
Board [5d Kc Ks Qs Ac]
Seat 1: 2PHCSXghjbGk2qR6jDFe2g (small blind) folded before Flop
Seat 2: zdS2zKkZYSRe8p+GVcXMgg (big blind) showed [4d Qd] and won ($46.55) with two pair, Kings and Queens
Seat 3: g/z/ANylbdR10I7oPCJdKQ folded before Flop (didn't bet)
Seat 4: voSAIKXtXUUbJnds83sYfQ folded before Flop (didn't bet)
Seat 5: 7SUIdtQak1SCtldWHjwnFA mucked
Seat 6: 3mTlg4g0FJN2bo939h/0Wg (button) folded before Flop (didn't bet)



PokerStars Game #59959721134:  Hold'em No Limit ($5/$10) - 2009/07/01 10:39:32 ET
Table '2a86NK3xhs21kwGZmbj0QA' 6-max Seat #4 is the button
Seat 1: NczJqEIUdrpEc5Nbd7h1Ig ($637.75 in chips)
Seat 2: Xl+I49lxCJwPGRuegiaHoA ($1127 in chips)
Seat 3: voSAIKXtXUUbJnds83sYfQ ($1000 in chips)
Seat 4: Lne9leXjEzXWbU3BGFWsxQ ($1000 in chips)
Seat 5: jkH6qYMpn8JA/IyBOhQPMw ($2154 in chips)
jkH6qYMpn8JA/IyBOhQPMw: posts small blind $5
UcFkfWngu95uR8Jhrj+HrQ: is sitting out
NczJqEIUdrpEc5Nbd7h1Ig: posts big blind $10
*** HOLE CARDS ***
Xl+I49lxCJwPGRuegiaHoA: folds
UcFkfWngu95uR8Jhrj+HrQ has returned
voSAIKXtXUUbJnds83sYfQ: folds
Lne9leXjEzXWbU3BGFWsxQ: folds
jkH6qYMpn8JA/IyBOhQPMw: raises $20 to $30
NczJqEIUdrpEc5Nbd7h1Ig: calls $20
*** FLOP *** [2s Ac 6d]
jkH6qYMpn8JA/IyBOhQPMw: bets $42
NczJqEIUdrpEc5Nbd7h1Ig: folds
jkH6qYMpn8JA/IyBOhQPMw collected $58 from pot
jkH6qYMpn8JA/IyBOhQPMw: doesn't show hand
*** SUMMARY ***
Total pot $60 | Rake $2
Board [2s Ac 6d]
Seat 1: NczJqEIUdrpEc5Nbd7h1Ig (big blind) folded on the Flop
Seat 2: Xl+I49lxCJwPGRuegiaHoA folded before Flop (didn't bet)
Seat 3: voSAIKXtXUUbJnds83sYfQ folded before Flop (didn't bet)
Seat 4: Lne9leXjEzXWbU3BGFWsxQ (button) folded before Flop (didn't bet)
Seat 5: jkH6qYMpn8JA/IyBOhQPMw (small blind) collected ($58)



PokerStars Game #59959739350:  Hold'em No Limit ($5/$10) - 2009/07/01 10:39:54 ET
Table '5DMTRmVjl0/Fvn8CWpM59A' 6-max Seat #6 is the button
Seat 1: jkH6qYMpn8JA/IyBOhQPMw ($1000 in chips)
Seat 2: 7SUIdtQak1SCtldWHjwnFA ($173 in chips)
Seat 3: UcFkfWngu95uR8Jhrj+HrQ ($92 in chips)
Seat 4: 2PHCSXghjbGk2qR6jDFe2g ($552.05 in chips)
Seat 5: qK5PPI0zibyu/o2OTOUoSQ ($1338.30 in chips)
Seat 6: Xl+I49lxCJwPGRuegiaHoA ($1000 in chips)
jkH6qYMpn8JA/IyBOhQPMw: posts small blind $5
7SUIdtQak1SCtldWHjwnFA: posts big blind $10
*** HOLE CARDS ***
UcFkfWngu95uR8Jhrj+HrQ: raises $10 to $20
2PHCSXghjbGk2qR6jDFe2g: folds
qK5PPI0zibyu/o2OTOUoSQ: raises $30 to $50
Xl+I49lxCJwPGRuegiaHoA: folds
jkH6qYMpn8JA/IyBOhQPMw: folds
7SUIdtQak1SCtldWHjwnFA: folds
UcFkfWngu95uR8Jhrj+HrQ: raises $42 to $92 and is all-in
qK5PPI0zibyu/o2OTOUoSQ: calls $42
*** FLOP *** [Js 7d 2d]
*** TURN *** [Js 7d 2d] [Ac]
*** RIVER *** [Js 7d 2d Ac] [2h]
*** SHOW DOWN ***
UcFkfWngu95uR8Jhrj+HrQ: shows [Ah Ts] (two pair, Aces and Deuces)
qK5PPI0zibyu/o2OTOUoSQ: shows [As Ks] (two pair, Aces and Deuces - King kicker)
qK5PPI0zibyu/o2OTOUoSQ collected $196 from pot
*** SUMMARY ***
Total pot $199 | Rake $3
Board [Js 7d 2d Ac 2h]
Seat 1: jkH6qYMpn8JA/IyBOhQPMw (small blind) folded before Flop
Seat 2: 7SUIdtQak1SCtldWHjwnFA (big blind) folded before Flop
Seat 3: UcFkfWngu95uR8Jhrj+HrQ showed [Ah Ts] and lost with two pair, Aces and Deuces
Seat 4: 2PHCSXghjbGk2qR6jDFe2g folded before Flop (didn't bet)
Seat 5: qK5PPI0zibyu/o2OTOUoSQ showed [As Ks] and won ($196) with two pair, Aces and Deuces
Seat 6: Xl+I49lxCJwPGRuegiaHoA (button) folded before Flop (didn't bet)



PokerStars Game #59959739926:  Hold'em No Limit ($5/$10) - 2009/07/01 10:39:55 ET
Table 'dwLGEw3aoH/cOAI7JsLdmw' 6-max Seat #5 is the button
Seat 1: xNrvKa8pDLb8LKHUI3AbhQ ($1054 in chips)
Seat 2: 7SUIdtQak1SCtldWHjwnFA ($200 in chips)
Seat 3: LM7rbnKcNcdtchNuEDebUw ($160 in chips)
Seat 4: kykGjpk/IjfbH8Gi6SIm5w ($211 in chips)
Seat 5: g/z/ANylbdR10I7oPCJdKQ ($215 in chips)
Seat 6: 3mTlg4g0FJN2bo939h/0Wg ($350 in chips)
3mTlg4g0FJN2bo939h/0Wg: posts small blind $5
xNrvKa8pDLb8LKHUI3AbhQ: posts big blind $10
*** HOLE CARDS ***
7SUIdtQak1SCtldWHjwnFA: raises $12 to $22
LM7rbnKcNcdtchNuEDebUw: calls $22
kykGjpk/IjfbH8Gi6SIm5w: calls $22
g/z/ANylbdR10I7oPCJdKQ: folds
3mTlg4g0FJN2bo939h/0Wg: folds
xNrvKa8pDLb8LKHUI3AbhQ: folds
*** FLOP *** [3c 3d 9c]
7SUIdtQak1SCtldWHjwnFA: bets $70
LM7rbnKcNcdtchNuEDebUw: folds
kykGjpk/IjfbH8Gi6SIm5w: folds
7SUIdtQak1SCtldWHjwnFA collected $78 from pot
7SUIdtQak1SCtldWHjwnFA: doesn't show hand
*** SUMMARY ***
Total pot $81 | Rake $3
Board [3c 3d 9c]
Seat 1: xNrvKa8pDLb8LKHUI3AbhQ (big blind) folded before Flop
Seat 2: 7SUIdtQak1SCtldWHjwnFA collected ($78)
Seat 3: LM7rbnKcNcdtchNuEDebUw folded on the Flop
Seat 4: kykGjpk/IjfbH8Gi6SIm5w folded on the Flop
Seat 5: g/z/ANylbdR10I7oPCJdKQ (button) folded before Flop (didn't bet)
Seat 6: 3mTlg4g0FJN2bo939h/0Wg (small blind) folded before Flop



PokerStars Game #59959749620:  Hold'em No Limit ($5/$10) - 2009/07/01 10:40:06 ET
Table '2a86NK3xhs21kwGZmbj0QA' 6-max Seat #5 is the button
Seat 1: NczJqEIUdrpEc5Nbd7h1Ig ($607.75 in chips)
Seat 2: Xl+I49lxCJwPGRuegiaHoA ($1127 in chips)
Seat 3: voSAIKXtXUUbJnds83sYfQ ($1000 in chips)
Seat 4: Lne9leXjEzXWbU3BGFWsxQ ($1000 in chips)
Seat 5: jkH6qYMpn8JA/IyBOhQPMw ($2182 in chips)
UcFkfWngu95uR8Jhrj+HrQ will be allowed to play after the button
NczJqEIUdrpEc5Nbd7h1Ig: posts small blind $5
Xl+I49lxCJwPGRuegiaHoA: posts big blind $10
*** HOLE CARDS ***
voSAIKXtXUUbJnds83sYfQ: folds
Lne9leXjEzXWbU3BGFWsxQ: folds
jkH6qYMpn8JA/IyBOhQPMw: folds
NczJqEIUdrpEc5Nbd7h1Ig: folds
Xl+I49lxCJwPGRuegiaHoA collected $10 from pot
Xl+I49lxCJwPGRuegiaHoA: doesn't show hand
*** SUMMARY ***
Total pot $10 | Rake $0
Seat 1: NczJqEIUdrpEc5Nbd7h1Ig (small blind) folded before Flop
Seat 2: Xl+I49lxCJwPGRuegiaHoA (big blind) collected ($10)
Seat 3: voSAIKXtXUUbJnds83sYfQ folded before Flop (didn't bet)
Seat 4: Lne9leXjEzXWbU3BGFWsxQ folded before Flop (didn't bet)
Seat 5: jkH6qYMpn8JA/IyBOhQPMw (button) folded before Flop (didn't bet)



PokerStars Game #59959755104:  Hold'em No Limit ($5/$10) - 2009/07/01 10:40:13 ET
Table '1Dt9cpcLUVE6HYkx5dUEdQ' 6-max Seat #1 is the button
Seat 1: 2PHCSXghjbGk2qR6jDFe2g ($1806 in chips)
Seat 2: zdS2zKkZYSRe8p+GVcXMgg ($1186.05 in chips)
Seat 3: g/z/ANylbdR10I7oPCJdKQ ($942.25 in chips)
Seat 4: voSAIKXtXUUbJnds83sYfQ ($1042 in chips)
Seat 5: 7SUIdtQak1SCtldWHjwnFA ($178 in chips)
Seat 6: 3mTlg4g0FJN2bo939h/0Wg ($493 in chips)
zdS2zKkZYSRe8p+GVcXMgg: posts small blind $5
g/z/ANylbdR10I7oPCJdKQ: posts big blind $10
*** HOLE CARDS ***
voSAIKXtXUUbJnds83sYfQ: folds
7SUIdtQak1SCtldWHjwnFA: raises $12 to $22
3mTlg4g0FJN2bo939h/0Wg: folds
2PHCSXghjbGk2qR6jDFe2g: folds
zdS2zKkZYSRe8p+GVcXMgg: folds
g/z/ANylbdR10I7oPCJdKQ: folds
7SUIdtQak1SCtldWHjwnFA collected $25 from pot
*** SUMMARY ***
Total pot $25 | Rake $0
Seat 1: 2PHCSXghjbGk2qR6jDFe2g (button) folded before Flop (didn't bet)
Seat 2: zdS2zKkZYSRe8p+GVcXMgg (small blind) folded before Flop
Seat 3: g/z/ANylbdR10I7oPCJdKQ (big blind) folded before Flop
Seat 4: voSAIKXtXUUbJnds83sYfQ folded before Flop (didn't bet)
Seat 5: 7SUIdtQak1SCtldWHjwnFA collected ($25)
Seat 6: 3mTlg4g0FJN2bo939h/0Wg folded before Flop (didn't bet)



PokerStars Game #59959760910:  Hold'em No Limit ($5/$10) - 2009/07/01 10:40:20 ET
Table '2a86NK3xhs21kwGZmbj0QA' 6-max Seat #1 is the button
Seat 1: NczJqEIUdrpEc5Nbd7h1Ig ($602.75 in chips)
Seat 2: Xl+I49lxCJwPGRuegiaHoA ($1132 in chips)
Seat 3: voSAIKXtXUUbJnds83sYfQ ($1000 in chips)
Seat 4: Lne9leXjEzXWbU3BGFWsxQ ($1000 in chips)
Seat 5: jkH6qYMpn8JA/IyBOhQPMw ($2182 in chips)
Xl+I49lxCJwPGRuegiaHoA: posts small blind $5
voSAIKXtXUUbJnds83sYfQ: posts big blind $10
UcFkfWngu95uR8Jhrj+HrQ: sits out
*** HOLE CARDS ***
Lne9leXjEzXWbU3BGFWsxQ: folds
jkH6qYMpn8JA/IyBOhQPMw: folds
NczJqEIUdrpEc5Nbd7h1Ig: calls $10
Xl+I49lxCJwPGRuegiaHoA: folds
voSAIKXtXUUbJnds83sYfQ: checks
*** FLOP *** [3d Ks Jd]
voSAIKXtXUUbJnds83sYfQ: bets $20
NczJqEIUdrpEc5Nbd7h1Ig: folds
voSAIKXtXUUbJnds83sYfQ collected $23.75 from pot
voSAIKXtXUUbJnds83sYfQ: doesn't show hand
*** SUMMARY ***
Total pot $25 | Rake $1.25
Board [3d Ks Jd]
Seat 1: NczJqEIUdrpEc5Nbd7h1Ig (button) folded on the Flop
Seat 2: Xl+I49lxCJwPGRuegiaHoA (small blind) folded before Flop
Seat 3: voSAIKXtXUUbJnds83sYfQ (big blind) collected ($23.75)
Seat 4: Lne9leXjEzXWbU3BGFWsxQ folded before Flop (didn't bet)
Seat 5: jkH6qYMpn8JA/IyBOhQPMw folded before Flop (didn't bet)



PokerStars Game #59959768554:  Hold'em No Limit ($5/$10) - 2009/07/01 10:40:29 ET
Table '5DMTRmVjl0/Fvn8CWpM59A' 6-max Seat #1 is the button
Seat 1: jkH6qYMpn8JA/IyBOhQPMw ($1000 in chips)
Seat 2: 7SUIdtQak1SCtldWHjwnFA ($163 in chips)
Seat 3: UcFkfWngu95uR8Jhrj+HrQ ($200 in chips)
Seat 4: 2PHCSXghjbGk2qR6jDFe2g ($552.05 in chips)
Seat 5: qK5PPI0zibyu/o2OTOUoSQ ($1442.30 in chips)
Seat 6: Xl+I49lxCJwPGRuegiaHoA ($1000 in chips)
7SUIdtQak1SCtldWHjwnFA: posts small blind $5
UcFkfWngu95uR8Jhrj+HrQ: posts big blind $10
*** HOLE CARDS ***
2PHCSXghjbGk2qR6jDFe2g: folds
qK5PPI0zibyu/o2OTOUoSQ: folds
Xl+I49lxCJwPGRuegiaHoA: folds
jkH6qYMpn8JA/IyBOhQPMw: folds
7SUIdtQak1SCtldWHjwnFA: raises $12 to $22
UcFkfWngu95uR8Jhrj+HrQ: folds
7SUIdtQak1SCtldWHjwnFA collected $20 from pot
7SUIdtQak1SCtldWHjwnFA: doesn't show hand
*** SUMMARY ***
Total pot $20 | Rake $0
Seat 1: jkH6qYMpn8JA/IyBOhQPMw (button) folded before Flop (didn't bet)
Seat 2: 7SUIdtQak1SCtldWHjwnFA (small blind) collected ($20)
Seat 3: UcFkfWngu95uR8Jhrj+HrQ (big blind) folded before Flop
Seat 4: 2PHCSXghjbGk2qR6jDFe2g folded before Flop (didn't bet)
Seat 5: qK5PPI0zibyu/o2OTOUoSQ folded before Flop (didn't bet)
Seat 6: Xl+I49lxCJwPGRuegiaHoA folded before Flop (didn't bet)



PokerStars Game #59959776180:  Hold'em No Limit ($5/$10) - 2009/07/01 10:40:38 ET
Table '1Dt9cpcLUVE6HYkx5dUEdQ' 6-max Seat #2 is the button
Seat 1: 2PHCSXghjbGk2qR6jDFe2g ($1806 in chips)
Seat 2: zdS2zKkZYSRe8p+GVcXMgg ($1181.05 in chips)
Seat 3: g/z/ANylbdR10I7oPCJdKQ ($932.25 in chips)
Seat 4: voSAIKXtXUUbJnds83sYfQ ($1042 in chips)
Seat 5: 7SUIdtQak1SCtldWHjwnFA ($193 in chips)
Seat 6: 3mTlg4g0FJN2bo939h/0Wg ($493 in chips)
g/z/ANylbdR10I7oPCJdKQ: posts small blind $5
voSAIKXtXUUbJnds83sYfQ: posts big blind $10
*** HOLE CARDS ***
7SUIdtQak1SCtldWHjwnFA: folds
3mTlg4g0FJN2bo939h/0Wg: folds
2PHCSXghjbGk2qR6jDFe2g: raises $10 to $20
zdS2zKkZYSRe8p+GVcXMgg: folds
g/z/ANylbdR10I7oPCJdKQ: folds
voSAIKXtXUUbJnds83sYfQ: folds
2PHCSXghjbGk2qR6jDFe2g collected $25 from pot
*** SUMMARY ***
Total pot $25 | Rake $0
Seat 1: 2PHCSXghjbGk2qR6jDFe2g collected ($25)
Seat 2: zdS2zKkZYSRe8p+GVcXMgg (button) folded before Flop (didn't bet)
Seat 3: g/z/ANylbdR10I7oPCJdKQ (small blind) folded before Flop
Seat 4: voSAIKXtXUUbJnds83sYfQ (big blind) folded before Flop
Seat 5: 7SUIdtQak1SCtldWHjwnFA folded before Flop (didn't bet)
Seat 6: 3mTlg4g0FJN2bo939h/0Wg folded before Flop (didn't bet)



PokerStars Game #59959776912:  Hold'em No Limit ($5/$10) - 2009/07/01 10:40:39 ET
Table '2a86NK3xhs21kwGZmbj0QA' 6-max Seat #2 is the button
Seat 1: NczJqEIUdrpEc5Nbd7h1Ig ($592.75 in chips)
Seat 2: Xl+I49lxCJwPGRuegiaHoA ($1127 in chips)
Seat 3: voSAIKXtXUUbJnds83sYfQ ($1013.75 in chips)
Seat 4: Lne9leXjEzXWbU3BGFWsxQ ($1000 in chips)
Seat 5: jkH6qYMpn8JA/IyBOhQPMw ($2182 in chips)
voSAIKXtXUUbJnds83sYfQ: posts small blind $5
Lne9leXjEzXWbU3BGFWsxQ: posts big blind $10
UcFkfWngu95uR8Jhrj+HrQ: sits out
*** HOLE CARDS ***
jkH6qYMpn8JA/IyBOhQPMw: folds
NczJqEIUdrpEc5Nbd7h1Ig: calls $10
Xl+I49lxCJwPGRuegiaHoA: raises $30 to $40
voSAIKXtXUUbJnds83sYfQ: folds
Lne9leXjEzXWbU3BGFWsxQ: calls $30
NczJqEIUdrpEc5Nbd7h1Ig: calls $30
*** FLOP *** [Jd Qh 9s]
Lne9leXjEzXWbU3BGFWsxQ: checks
NczJqEIUdrpEc5Nbd7h1Ig: checks
Xl+I49lxCJwPGRuegiaHoA: checks
*** TURN *** [Jd Qh 9s] [2s]
Lne9leXjEzXWbU3BGFWsxQ: checks
NczJqEIUdrpEc5Nbd7h1Ig: checks
Xl+I49lxCJwPGRuegiaHoA: checks
*** RIVER *** [Jd Qh 9s 2s] [Ah]
Lne9leXjEzXWbU3BGFWsxQ: checks
NczJqEIUdrpEc5Nbd7h1Ig: bets $60
Xl+I49lxCJwPGRuegiaHoA: folds
Lne9leXjEzXWbU3BGFWsxQ: folds
NczJqEIUdrpEc5Nbd7h1Ig collected $123 from pot
*** SUMMARY ***
Total pot $125 | Rake $2
Board [Jd Qh 9s 2s Ah]
Seat 1: NczJqEIUdrpEc5Nbd7h1Ig collected ($123)
Seat 2: Xl+I49lxCJwPGRuegiaHoA (button) folded on the River
Seat 3: voSAIKXtXUUbJnds83sYfQ (small blind) folded before Flop
Seat 4: Lne9leXjEzXWbU3BGFWsxQ (big blind) folded on the River
Seat 5: jkH6qYMpn8JA/IyBOhQPMw folded before Flop (didn't bet)



PokerStars Game #59959794140:  Hold'em No Limit ($5/$10) - 2009/07/01 10:41:00 ET
Table '5DMTRmVjl0/Fvn8CWpM59A' 6-max Seat #2 is the button
Seat 1: jkH6qYMpn8JA/IyBOhQPMw ($1000 in chips)
Seat 2: 7SUIdtQak1SCtldWHjwnFA ($173 in chips)
Seat 3: UcFkfWngu95uR8Jhrj+HrQ ($190 in chips)
Seat 4: 2PHCSXghjbGk2qR6jDFe2g ($552.05 in chips)
Seat 5: qK5PPI0zibyu/o2OTOUoSQ ($1442.30 in chips)
Seat 6: Xl+I49lxCJwPGRuegiaHoA ($1000 in chips)
UcFkfWngu95uR8Jhrj+HrQ: posts small blind $5
2PHCSXghjbGk2qR6jDFe2g: posts big blind $10
*** HOLE CARDS ***
qK5PPI0zibyu/o2OTOUoSQ: raises $10 to $20
Xl+I49lxCJwPGRuegiaHoA: calls $20
jkH6qYMpn8JA/IyBOhQPMw: folds
7SUIdtQak1SCtldWHjwnFA: raises $153 to $173 and is all-in
UcFkfWngu95uR8Jhrj+HrQ: folds
2PHCSXghjbGk2qR6jDFe2g: folds
qK5PPI0zibyu/o2OTOUoSQ: folds
Xl+I49lxCJwPGRuegiaHoA: folds
7SUIdtQak1SCtldWHjwnFA collected $75 from pot
7SUIdtQak1SCtldWHjwnFA: doesn't show hand
*** SUMMARY ***
Total pot $75 | Rake $0
Seat 1: jkH6qYMpn8JA/IyBOhQPMw folded before Flop (didn't bet)
Seat 2: 7SUIdtQak1SCtldWHjwnFA (button) collected ($75)
Seat 3: UcFkfWngu95uR8Jhrj+HrQ (small blind) folded before Flop
Seat 4: 2PHCSXghjbGk2qR6jDFe2g (big blind) folded before Flop
Seat 5: qK5PPI0zibyu/o2OTOUoSQ folded before Flop
Seat 6: Xl+I49lxCJwPGRuegiaHoA folded before Flop



PokerStars Game #59959795888:  Hold'em No Limit ($5/$10) - 2009/07/01 10:41:02 ET
Table 'dwLGEw3aoH/cOAI7JsLdmw' 6-max Seat #6 is the button
Seat 1: xNrvKa8pDLb8LKHUI3AbhQ ($1044 in chips)
Seat 2: 7SUIdtQak1SCtldWHjwnFA ($256 in chips)
Seat 3: LM7rbnKcNcdtchNuEDebUw ($138 in chips)
Seat 4: kykGjpk/IjfbH8Gi6SIm5w ($189 in chips)
Seat 5: g/z/ANylbdR10I7oPCJdKQ ($215 in chips)
Seat 6: 3mTlg4g0FJN2bo939h/0Wg ($345 in chips)
xNrvKa8pDLb8LKHUI3AbhQ: posts small blind $5
7SUIdtQak1SCtldWHjwnFA: posts big blind $10
*** HOLE CARDS ***
LM7rbnKcNcdtchNuEDebUw: calls $10
kykGjpk/IjfbH8Gi6SIm5w: folds
g/z/ANylbdR10I7oPCJdKQ: folds
3mTlg4g0FJN2bo939h/0Wg: folds
xNrvKa8pDLb8LKHUI3AbhQ: calls $5
7SUIdtQak1SCtldWHjwnFA: checks
*** FLOP *** [9d 3d 9c]
xNrvKa8pDLb8LKHUI3AbhQ: checks
7SUIdtQak1SCtldWHjwnFA: checks
LM7rbnKcNcdtchNuEDebUw: bets $30
xNrvKa8pDLb8LKHUI3AbhQ: folds
7SUIdtQak1SCtldWHjwnFA: calls $30
*** TURN *** [9d 3d 9c] [Ks]
7SUIdtQak1SCtldWHjwnFA: checks
LM7rbnKcNcdtchNuEDebUw: bets $98 and is all-in
7SUIdtQak1SCtldWHjwnFA: calls $98
*** RIVER *** [9d 3d 9c Ks] [6s]
*** SHOW DOWN ***
7SUIdtQak1SCtldWHjwnFA: shows [9h Qh] (three of a kind, Nines)
LM7rbnKcNcdtchNuEDebUw: mucks hand
7SUIdtQak1SCtldWHjwnFA collected $283 from pot
*** SUMMARY ***
Total pot $286 | Rake $3
Board [9d 3d 9c Ks 6s]
Seat 1: xNrvKa8pDLb8LKHUI3AbhQ (small blind) folded on the Flop
Seat 2: 7SUIdtQak1SCtldWHjwnFA (big blind) showed [9h Qh] and won ($283) with three of a kind, Nines
Seat 3: LM7rbnKcNcdtchNuEDebUw mucked
Seat 4: kykGjpk/IjfbH8Gi6SIm5w folded before Flop (didn't bet)
Seat 5: g/z/ANylbdR10I7oPCJdKQ folded before Flop (didn't bet)
Seat 6: 3mTlg4g0FJN2bo939h/0Wg (button) folded before Flop (didn't bet)



PokerStars Game #59959804102:  Hold'em No Limit ($5/$10) - 2009/07/01 10:41:12 ET
Table '1Dt9cpcLUVE6HYkx5dUEdQ' 6-max Seat #3 is the button
Seat 1: 2PHCSXghjbGk2qR6jDFe2g ($1821 in chips)
Seat 2: zdS2zKkZYSRe8p+GVcXMgg ($1181.05 in chips)
Seat 3: g/z/ANylbdR10I7oPCJdKQ ($927.25 in chips)
Seat 4: voSAIKXtXUUbJnds83sYfQ ($1032 in chips)
Seat 5: 7SUIdtQak1SCtldWHjwnFA ($193 in chips)
Seat 6: 3mTlg4g0FJN2bo939h/0Wg ($493 in chips)
voSAIKXtXUUbJnds83sYfQ: posts small blind $5
7SUIdtQak1SCtldWHjwnFA: posts big blind $10
*** HOLE CARDS ***
3mTlg4g0FJN2bo939h/0Wg: raises $10 to $20
2PHCSXghjbGk2qR6jDFe2g: folds
zdS2zKkZYSRe8p+GVcXMgg: calls $20
g/z/ANylbdR10I7oPCJdKQ: folds
voSAIKXtXUUbJnds83sYfQ: folds
7SUIdtQak1SCtldWHjwnFA: raises $173 to $193 and is all-in
3mTlg4g0FJN2bo939h/0Wg: folds
zdS2zKkZYSRe8p+GVcXMgg: folds
7SUIdtQak1SCtldWHjwnFA collected $65 from pot
7SUIdtQak1SCtldWHjwnFA: doesn't show hand
*** SUMMARY ***
Total pot $65 | Rake $0
Seat 1: 2PHCSXghjbGk2qR6jDFe2g folded before Flop (didn't bet)
Seat 2: zdS2zKkZYSRe8p+GVcXMgg folded before Flop
Seat 3: g/z/ANylbdR10I7oPCJdKQ (button) folded before Flop (didn't bet)
Seat 4: voSAIKXtXUUbJnds83sYfQ (small blind) folded before Flop
Seat 5: 7SUIdtQak1SCtldWHjwnFA (big blind) collected ($65)
Seat 6: 3mTlg4g0FJN2bo939h/0Wg folded before Flop



PokerStars Game #59959830306:  Hold'em No Limit ($5/$10) - 2009/07/01 10:41:44 ET
Table '5DMTRmVjl0/Fvn8CWpM59A' 6-max Seat #3 is the button
Seat 1: jkH6qYMpn8JA/IyBOhQPMw ($1000 in chips)
Seat 2: 7SUIdtQak1SCtldWHjwnFA ($228 in chips)
Seat 3: UcFkfWngu95uR8Jhrj+HrQ ($185 in chips)
Seat 4: 2PHCSXghjbGk2qR6jDFe2g ($542.05 in chips)
Seat 5: qK5PPI0zibyu/o2OTOUoSQ ($1422.30 in chips)
Seat 6: Xl+I49lxCJwPGRuegiaHoA ($1000 in chips)
2PHCSXghjbGk2qR6jDFe2g: posts small blind $5
qK5PPI0zibyu/o2OTOUoSQ: posts big blind $10
*** HOLE CARDS ***
Xl+I49lxCJwPGRuegiaHoA: folds
jkH6qYMpn8JA/IyBOhQPMw: folds
7SUIdtQak1SCtldWHjwnFA: raises $12 to $22
UcFkfWngu95uR8Jhrj+HrQ: folds
2PHCSXghjbGk2qR6jDFe2g: folds
qK5PPI0zibyu/o2OTOUoSQ: calls $12
*** FLOP *** [9c 2c 2h]
qK5PPI0zibyu/o2OTOUoSQ: checks
7SUIdtQak1SCtldWHjwnFA: bets $24
qK5PPI0zibyu/o2OTOUoSQ: raises $24 to $48
7SUIdtQak1SCtldWHjwnFA: raises $52 to $100
qK5PPI0zibyu/o2OTOUoSQ: folds
7SUIdtQak1SCtldWHjwnFA collected $142 from pot
7SUIdtQak1SCtldWHjwnFA: doesn't show hand
*** SUMMARY ***
Total pot $145 | Rake $3
Board [9c 2c 2h]
Seat 1: jkH6qYMpn8JA/IyBOhQPMw folded before Flop (didn't bet)
Seat 2: 7SUIdtQak1SCtldWHjwnFA collected ($142)
Seat 3: UcFkfWngu95uR8Jhrj+HrQ (button) folded before Flop (didn't bet)
Seat 4: 2PHCSXghjbGk2qR6jDFe2g (small blind) folded before Flop
Seat 5: qK5PPI0zibyu/o2OTOUoSQ (big blind) folded on the Flop
Seat 6: Xl+I49lxCJwPGRuegiaHoA folded before Flop (didn't bet)



PokerStars Game #59959831002:  Hold'em No Limit ($5/$10) - 2009/07/01 10:41:45 ET
Table '1Dt9cpcLUVE6HYkx5dUEdQ' 6-max Seat #4 is the button
Seat 1: 2PHCSXghjbGk2qR6jDFe2g ($1821 in chips)
Seat 2: zdS2zKkZYSRe8p+GVcXMgg ($1161.05 in chips)
Seat 3: g/z/ANylbdR10I7oPCJdKQ ($927.25 in chips)
Seat 4: voSAIKXtXUUbJnds83sYfQ ($1027 in chips)
Seat 5: 7SUIdtQak1SCtldWHjwnFA ($238 in chips)
Seat 6: 3mTlg4g0FJN2bo939h/0Wg ($473 in chips)
7SUIdtQak1SCtldWHjwnFA: posts small blind $5
3mTlg4g0FJN2bo939h/0Wg: posts big blind $10
*** HOLE CARDS ***
2PHCSXghjbGk2qR6jDFe2g: folds
zdS2zKkZYSRe8p+GVcXMgg: raises $30 to $40
g/z/ANylbdR10I7oPCJdKQ: folds
voSAIKXtXUUbJnds83sYfQ: calls $40
7SUIdtQak1SCtldWHjwnFA: folds
3mTlg4g0FJN2bo939h/0Wg: folds
*** FLOP *** [Js 5s 7c]
zdS2zKkZYSRe8p+GVcXMgg: bets $60
voSAIKXtXUUbJnds83sYfQ: folds
zdS2zKkZYSRe8p+GVcXMgg collected $92 from pot
*** SUMMARY ***
Total pot $95 | Rake $3
Board [Js 5s 7c]
Seat 1: 2PHCSXghjbGk2qR6jDFe2g folded before Flop (didn't bet)
Seat 2: zdS2zKkZYSRe8p+GVcXMgg collected ($92)
Seat 3: g/z/ANylbdR10I7oPCJdKQ folded before Flop (didn't bet)
Seat 4: voSAIKXtXUUbJnds83sYfQ (button) folded on the Flop
Seat 5: 7SUIdtQak1SCtldWHjwnFA (small blind) folded before Flop
Seat 6: 3mTlg4g0FJN2bo939h/0Wg (big blind) folded before Flop



PokerStars Game #59959847062:  Hold'em No Limit ($5/$10) - 2009/07/01 10:42:02 ET
Table 'dwLGEw3aoH/cOAI7JsLdmw' 6-max Seat #1 is the button
Seat 1: xNrvKa8pDLb8LKHUI3AbhQ ($1034 in chips)
Seat 2: 7SUIdtQak1SCtldWHjwnFA ($401 in chips)
Seat 4: kykGjpk/IjfbH8Gi6SIm5w ($189 in chips)
Seat 5: g/z/ANylbdR10I7oPCJdKQ ($215 in chips)
Seat 6: 3mTlg4g0FJN2bo939h/0Wg ($345 in chips)
7SUIdtQak1SCtldWHjwnFA: posts small blind $5
kykGjpk/IjfbH8Gi6SIm5w: posts big blind $10
*** HOLE CARDS ***
g/z/ANylbdR10I7oPCJdKQ: folds
3mTlg4g0FJN2bo939h/0Wg: folds
xNrvKa8pDLb8LKHUI3AbhQ: folds
7SUIdtQak1SCtldWHjwnFA: folds
kykGjpk/IjfbH8Gi6SIm5w collected $10 from pot
*** SUMMARY ***
Total pot $10 | Rake $0
Seat 1: xNrvKa8pDLb8LKHUI3AbhQ (button) folded before Flop (didn't bet)
Seat 2: 7SUIdtQak1SCtldWHjwnFA (small blind) folded before Flop
Seat 4: kykGjpk/IjfbH8Gi6SIm5w (big blind) collected ($10)
Seat 5: g/z/ANylbdR10I7oPCJdKQ folded before Flop (didn't bet)
Seat 6: 3mTlg4g0FJN2bo939h/0Wg folded before Flop (didn't bet)



PokerStars Game #59959868750:  Hold'em No Limit ($5/$10) - 2009/07/01 10:42:28 ET
Table '2a86NK3xhs21kwGZmbj0QA' 6-max Seat #3 is the button
Seat 1: NczJqEIUdrpEc5Nbd7h1Ig ($675.75 in chips)
Seat 2: Xl+I49lxCJwPGRuegiaHoA ($1087 in chips)
Seat 3: voSAIKXtXUUbJnds83sYfQ ($1008.75 in chips)
Seat 4: Lne9leXjEzXWbU3BGFWsxQ ($1000 in chips)
Seat 5: jkH6qYMpn8JA/IyBOhQPMw ($2182 in chips)
Lne9leXjEzXWbU3BGFWsxQ: posts small blind $5
jkH6qYMpn8JA/IyBOhQPMw: posts big blind $10
UcFkfWngu95uR8Jhrj+HrQ: sits out
*** HOLE CARDS ***
NczJqEIUdrpEc5Nbd7h1Ig: raises $20 to $30
Xl+I49lxCJwPGRuegiaHoA: folds
voSAIKXtXUUbJnds83sYfQ has timed out
voSAIKXtXUUbJnds83sYfQ: folds
voSAIKXtXUUbJnds83sYfQ is sitting out
voSAIKXtXUUbJnds83sYfQ has returned
Lne9leXjEzXWbU3BGFWsxQ: folds
jkH6qYMpn8JA/IyBOhQPMw: folds
NczJqEIUdrpEc5Nbd7h1Ig collected $25 from pot
*** SUMMARY ***
Total pot $25 | Rake $0
Seat 1: NczJqEIUdrpEc5Nbd7h1Ig collected ($25)
Seat 2: Xl+I49lxCJwPGRuegiaHoA folded before Flop (didn't bet)
Seat 3: voSAIKXtXUUbJnds83sYfQ (button) folded before Flop (didn't bet)
Seat 4: Lne9leXjEzXWbU3BGFWsxQ (small blind) folded before Flop
Seat 5: jkH6qYMpn8JA/IyBOhQPMw (big blind) folded before Flop



PokerStars Game #59959870868:  Hold'em No Limit ($5/$10) - 2009/07/01 10:42:31 ET
Table '1Dt9cpcLUVE6HYkx5dUEdQ' 6-max Seat #5 is the button
Seat 2: zdS2zKkZYSRe8p+GVcXMgg ($1213.05 in chips)
Seat 3: g/z/ANylbdR10I7oPCJdKQ ($927.25 in chips)
Seat 4: voSAIKXtXUUbJnds83sYfQ ($1000 in chips)
Seat 5: 7SUIdtQak1SCtldWHjwnFA ($233 in chips)
Seat 6: 3mTlg4g0FJN2bo939h/0Wg ($463 in chips)
3mTlg4g0FJN2bo939h/0Wg: posts small blind $5
2PHCSXghjbGk2qR6jDFe2g: is sitting out
zdS2zKkZYSRe8p+GVcXMgg: posts big blind $10
*** HOLE CARDS ***
2PHCSXghjbGk2qR6jDFe2g leaves the table
Xl+I49lxCJwPGRuegiaHoA joins the table at seat #1
g/z/ANylbdR10I7oPCJdKQ: folds
g/z/ANylbdR10I7oPCJdKQ leaves the table
voSAIKXtXUUbJnds83sYfQ: folds
7SUIdtQak1SCtldWHjwnFA: raises $12 to $22
3mTlg4g0FJN2bo939h/0Wg: folds
zdS2zKkZYSRe8p+GVcXMgg: raises $28 to $50
7SUIdtQak1SCtldWHjwnFA: raises $183 to $233 and is all-in
Lne9leXjEzXWbU3BGFWsxQ joins the table at seat #3
zdS2zKkZYSRe8p+GVcXMgg: calls $183
*** FLOP *** [3s Kh Ts]
*** TURN *** [3s Kh Ts] [Kd]
*** RIVER *** [3s Kh Ts Kd] [Ks]
*** SHOW DOWN ***
zdS2zKkZYSRe8p+GVcXMgg: shows [Qc Qs] (a full house, Kings full of Queens)
7SUIdtQak1SCtldWHjwnFA: mucks hand
zdS2zKkZYSRe8p+GVcXMgg collected $469 from pot
*** SUMMARY ***
Total pot $471 | Rake $2
Board [3s Kh Ts Kd Ks]
Seat 2: zdS2zKkZYSRe8p+GVcXMgg (big blind) showed [Qc Qs] and won ($469) with a full house, Kings full of Queens
Seat 3: g/z/ANylbdR10I7oPCJdKQ folded before Flop (didn't bet)
Seat 4: voSAIKXtXUUbJnds83sYfQ folded before Flop (didn't bet)
Seat 5: 7SUIdtQak1SCtldWHjwnFA (button) mucked
Seat 6: 3mTlg4g0FJN2bo939h/0Wg (small blind) folded before Flop



PokerStars Game #59959871730:  Hold'em No Limit ($5/$10) - 2009/07/01 10:42:32 ET
Table 'dwLGEw3aoH/cOAI7JsLdmw' 6-max Seat #2 is the button
Seat 1: xNrvKa8pDLb8LKHUI3AbhQ ($1034 in chips)
Seat 2: 7SUIdtQak1SCtldWHjwnFA ($396 in chips)
Seat 4: kykGjpk/IjfbH8Gi6SIm5w ($194 in chips)
Seat 5: g/z/ANylbdR10I7oPCJdKQ ($215 in chips)
Seat 6: 3mTlg4g0FJN2bo939h/0Wg ($345 in chips)
kykGjpk/IjfbH8Gi6SIm5w: posts small blind $5
g/z/ANylbdR10I7oPCJdKQ: posts big blind $10
*** HOLE CARDS ***
voSAIKXtXUUbJnds83sYfQ joins the table at seat #3
3mTlg4g0FJN2bo939h/0Wg: raises $10 to $20
xNrvKa8pDLb8LKHUI3AbhQ: folds
7SUIdtQak1SCtldWHjwnFA: calls $20
kykGjpk/IjfbH8Gi6SIm5w: folds
g/z/ANylbdR10I7oPCJdKQ: folds
*** FLOP *** [6h 7c 4d]
3mTlg4g0FJN2bo939h/0Wg: bets $30
7SUIdtQak1SCtldWHjwnFA: calls $30
*** TURN *** [6h 7c 4d] [As]
3mTlg4g0FJN2bo939h/0Wg: checks
7SUIdtQak1SCtldWHjwnFA: checks
*** RIVER *** [6h 7c 4d As] [Ac]
3mTlg4g0FJN2bo939h/0Wg: bets $70
7SUIdtQak1SCtldWHjwnFA: folds
3mTlg4g0FJN2bo939h/0Wg collected $113 from pot
*** SUMMARY ***
Total pot $115 | Rake $2
Board [6h 7c 4d As Ac]
Seat 1: xNrvKa8pDLb8LKHUI3AbhQ folded before Flop (didn't bet)
Seat 2: 7SUIdtQak1SCtldWHjwnFA (button) folded on the River
Seat 4: kykGjpk/IjfbH8Gi6SIm5w (small blind) folded before Flop
Seat 5: g/z/ANylbdR10I7oPCJdKQ (big blind) folded before Flop
Seat 6: 3mTlg4g0FJN2bo939h/0Wg collected ($113)



PokerStars Game #59959875006:  Hold'em No Limit ($5/$10) - 2009/07/01 10:42:36 ET
Table '5DMTRmVjl0/Fvn8CWpM59A' 6-max Seat #4 is the button
Seat 1: jkH6qYMpn8JA/IyBOhQPMw ($1000 in chips)
Seat 2: 7SUIdtQak1SCtldWHjwnFA ($300 in chips)
Seat 3: UcFkfWngu95uR8Jhrj+HrQ ($185 in chips)
Seat 4: 2PHCSXghjbGk2qR6jDFe2g ($537.05 in chips)
Seat 5: qK5PPI0zibyu/o2OTOUoSQ ($1352.30 in chips)
Seat 6: Xl+I49lxCJwPGRuegiaHoA ($1000 in chips)
qK5PPI0zibyu/o2OTOUoSQ: posts small blind $5
Xl+I49lxCJwPGRuegiaHoA: posts big blind $10
*** HOLE CARDS ***
jkH6qYMpn8JA/IyBOhQPMw: folds
7SUIdtQak1SCtldWHjwnFA: raises $20 to $30
UcFkfWngu95uR8Jhrj+HrQ: folds
2PHCSXghjbGk2qR6jDFe2g: folds
qK5PPI0zibyu/o2OTOUoSQ: folds
Xl+I49lxCJwPGRuegiaHoA: folds
qK5PPI0zibyu/o2OTOUoSQ leaves the table
7SUIdtQak1SCtldWHjwnFA collected $25 from pot
7SUIdtQak1SCtldWHjwnFA: doesn't show hand
*** SUMMARY ***
Total pot $25 | Rake $0
Seat 1: jkH6qYMpn8JA/IyBOhQPMw folded before Flop (didn't bet)
Seat 2: 7SUIdtQak1SCtldWHjwnFA collected ($25)
Seat 3: UcFkfWngu95uR8Jhrj+HrQ folded before Flop (didn't bet)
Seat 4: 2PHCSXghjbGk2qR6jDFe2g (button) folded before Flop (didn't bet)
Seat 5: qK5PPI0zibyu/o2OTOUoSQ (small blind) folded before Flop
Seat 6: Xl+I49lxCJwPGRuegiaHoA (big blind) folded before Flop



PokerStars Game #59959890260:  Hold'em No Limit ($5/$10) - 2009/07/01 10:42:54 ET
Table '5DMTRmVjl0/Fvn8CWpM59A' 6-max Seat #6 is the button
Seat 1: jkH6qYMpn8JA/IyBOhQPMw ($1000 in chips)
Seat 2: 7SUIdtQak1SCtldWHjwnFA ($315 in chips)
Seat 3: UcFkfWngu95uR8Jhrj+HrQ ($185 in chips)
Seat 4: 2PHCSXghjbGk2qR6jDFe2g ($537.05 in chips)
Seat 6: Xl+I49lxCJwPGRuegiaHoA ($1000 in chips)
jkH6qYMpn8JA/IyBOhQPMw: posts small blind $5
7SUIdtQak1SCtldWHjwnFA: posts big blind $10
*** HOLE CARDS ***
UcFkfWngu95uR8Jhrj+HrQ: folds
2PHCSXghjbGk2qR6jDFe2g: folds
voSAIKXtXUUbJnds83sYfQ joins the table at seat #5
Xl+I49lxCJwPGRuegiaHoA: raises $20 to $30
jkH6qYMpn8JA/IyBOhQPMw: folds
7SUIdtQak1SCtldWHjwnFA: folds
Xl+I49lxCJwPGRuegiaHoA collected $25 from pot
Xl+I49lxCJwPGRuegiaHoA: doesn't show hand
*** SUMMARY ***
Total pot $25 | Rake $0
Seat 1: jkH6qYMpn8JA/IyBOhQPMw (small blind) folded before Flop
Seat 2: 7SUIdtQak1SCtldWHjwnFA (big blind) folded before Flop
Seat 3: UcFkfWngu95uR8Jhrj+HrQ folded before Flop (didn't bet)
Seat 4: 2PHCSXghjbGk2qR6jDFe2g folded before Flop (didn't bet)
Seat 6: Xl+I49lxCJwPGRuegiaHoA (button) collected ($25)



PokerStars Game #59959904698:  Hold'em No Limit ($5/$10) - 2009/07/01 10:43:12 ET
Table '2a86NK3xhs21kwGZmbj0QA' 6-max Seat #4 is the button
Seat 1: NczJqEIUdrpEc5Nbd7h1Ig ($690.75 in chips)
Seat 2: Xl+I49lxCJwPGRuegiaHoA ($1087 in chips)
Seat 3: voSAIKXtXUUbJnds83sYfQ ($1008.75 in chips)
Seat 4: Lne9leXjEzXWbU3BGFWsxQ ($1000 in chips)
Seat 5: jkH6qYMpn8JA/IyBOhQPMw ($2172 in chips)
Seat 6: UcFkfWngu95uR8Jhrj+HrQ ($202 in chips)
jkH6qYMpn8JA/IyBOhQPMw: posts small blind $5
UcFkfWngu95uR8Jhrj+HrQ: posts big blind $10
*** HOLE CARDS ***
NczJqEIUdrpEc5Nbd7h1Ig: calls $10
Xl+I49lxCJwPGRuegiaHoA: folds
voSAIKXtXUUbJnds83sYfQ: folds
Lne9leXjEzXWbU3BGFWsxQ: folds
jkH6qYMpn8JA/IyBOhQPMw: folds
UcFkfWngu95uR8Jhrj+HrQ: checks
*** FLOP *** [7d 7c 5s]
UcFkfWngu95uR8Jhrj+HrQ: checks
NczJqEIUdrpEc5Nbd7h1Ig: checks
*** TURN *** [7d 7c 5s] [Ah]
UcFkfWngu95uR8Jhrj+HrQ: checks
NczJqEIUdrpEc5Nbd7h1Ig: bets $30
UcFkfWngu95uR8Jhrj+HrQ: folds
NczJqEIUdrpEc5Nbd7h1Ig collected $23.75 from pot
*** SUMMARY ***
Total pot $25 | Rake $1.25
Board [7d 7c 5s Ah]
Seat 1: NczJqEIUdrpEc5Nbd7h1Ig collected ($23.75)
Seat 2: Xl+I49lxCJwPGRuegiaHoA folded before Flop (didn't bet)
Seat 3: voSAIKXtXUUbJnds83sYfQ folded before Flop (didn't bet)
Seat 4: Lne9leXjEzXWbU3BGFWsxQ (button) folded before Flop (didn't bet)
Seat 5: jkH6qYMpn8JA/IyBOhQPMw (small blind) folded before Flop
Seat 6: UcFkfWngu95uR8Jhrj+HrQ (big blind) folded on the Turn



PokerStars Game #59959906152:  Hold'em No Limit ($5/$10) - 2009/07/01 10:43:14 ET
Table '5DMTRmVjl0/Fvn8CWpM59A' 6-max Seat #1 is the button
Seat 1: jkH6qYMpn8JA/IyBOhQPMw ($1000 in chips)
Seat 2: 7SUIdtQak1SCtldWHjwnFA ($305 in chips)
Seat 3: UcFkfWngu95uR8Jhrj+HrQ ($185 in chips)
Seat 4: 2PHCSXghjbGk2qR6jDFe2g ($537.05 in chips)
Seat 6: Xl+I49lxCJwPGRuegiaHoA ($1015 in chips)
7SUIdtQak1SCtldWHjwnFA: posts small blind $5
UcFkfWngu95uR8Jhrj+HrQ: posts big blind $10
voSAIKXtXUUbJnds83sYfQ: sits out
*** HOLE CARDS ***
2PHCSXghjbGk2qR6jDFe2g: folds
2PHCSXghjbGk2qR6jDFe2g leaves the table
Xl+I49lxCJwPGRuegiaHoA: folds
jkH6qYMpn8JA/IyBOhQPMw: folds
7SUIdtQak1SCtldWHjwnFA: raises $20 to $30
UcFkfWngu95uR8Jhrj+HrQ: folds
7SUIdtQak1SCtldWHjwnFA collected $20 from pot
7SUIdtQak1SCtldWHjwnFA: doesn't show hand
*** SUMMARY ***
Total pot $20 | Rake $0
Seat 1: jkH6qYMpn8JA/IyBOhQPMw (button) folded before Flop (didn't bet)
Seat 2: 7SUIdtQak1SCtldWHjwnFA (small blind) collected ($20)
Seat 3: UcFkfWngu95uR8Jhrj+HrQ (big blind) folded before Flop
Seat 4: 2PHCSXghjbGk2qR6jDFe2g folded before Flop (didn't bet)
Seat 6: Xl+I49lxCJwPGRuegiaHoA folded before Flop (didn't bet)



PokerStars Game #59959922174:  Hold'em No Limit ($5/$10) - 2009/07/01 10:43:33 ET
Table 'dwLGEw3aoH/cOAI7JsLdmw' 6-max Seat #4 is the button
Seat 1: xNrvKa8pDLb8LKHUI3AbhQ ($1034 in chips)
Seat 2: 7SUIdtQak1SCtldWHjwnFA ($346 in chips)
Seat 4: kykGjpk/IjfbH8Gi6SIm5w ($189 in chips)
Seat 5: g/z/ANylbdR10I7oPCJdKQ ($205 in chips)
Seat 6: 3mTlg4g0FJN2bo939h/0Wg ($408 in chips)
g/z/ANylbdR10I7oPCJdKQ: posts small blind $5
3mTlg4g0FJN2bo939h/0Wg: posts big blind $10
voSAIKXtXUUbJnds83sYfQ: sits out
*** HOLE CARDS ***
xNrvKa8pDLb8LKHUI3AbhQ: raises $10 to $20
7SUIdtQak1SCtldWHjwnFA: folds
kykGjpk/IjfbH8Gi6SIm5w: folds
g/z/ANylbdR10I7oPCJdKQ: folds
3mTlg4g0FJN2bo939h/0Wg: calls $10
*** FLOP *** [Qd 6s 9s]
3mTlg4g0FJN2bo939h/0Wg: bets $20
xNrvKa8pDLb8LKHUI3AbhQ: folds
3mTlg4g0FJN2bo939h/0Wg collected $43 from pot
*** SUMMARY ***
Total pot $45 | Rake $2
Board [Qd 6s 9s]
Seat 1: xNrvKa8pDLb8LKHUI3AbhQ folded on the Flop
Seat 2: 7SUIdtQak1SCtldWHjwnFA folded before Flop (didn't bet)
Seat 4: kykGjpk/IjfbH8Gi6SIm5w (button) folded before Flop (didn't bet)
Seat 5: g/z/ANylbdR10I7oPCJdKQ (small blind) folded before Flop
Seat 6: 3mTlg4g0FJN2bo939h/0Wg (big blind) collected ($43)



PokerStars Game #59959923020:  Hold'em No Limit ($5/$10) - 2009/07/01 10:43:34 ET
Table '5DMTRmVjl0/Fvn8CWpM59A' 6-max Seat #2 is the button
Seat 1: jkH6qYMpn8JA/IyBOhQPMw ($1000 in chips)
Seat 2: 7SUIdtQak1SCtldWHjwnFA ($315 in chips)
Seat 3: UcFkfWngu95uR8Jhrj+HrQ ($175 in chips)
Seat 5: voSAIKXtXUUbJnds83sYfQ ($1000 in chips)
Seat 6: Xl+I49lxCJwPGRuegiaHoA ($1015 in chips)
UcFkfWngu95uR8Jhrj+HrQ: posts small blind $5
voSAIKXtXUUbJnds83sYfQ: posts big blind $10
*** HOLE CARDS ***
Xl+I49lxCJwPGRuegiaHoA: folds
jkH6qYMpn8JA/IyBOhQPMw: raises $20 to $30
7SUIdtQak1SCtldWHjwnFA: folds
1ScqYmNf7/uWx1XSBgPTBw joins the table at seat #4
UcFkfWngu95uR8Jhrj+HrQ: folds
voSAIKXtXUUbJnds83sYfQ: raises $80 to $110
jkH6qYMpn8JA/IyBOhQPMw: folds
voSAIKXtXUUbJnds83sYfQ collected $65 from pot
voSAIKXtXUUbJnds83sYfQ: doesn't show hand
*** SUMMARY ***
Total pot $65 | Rake $0
Seat 1: jkH6qYMpn8JA/IyBOhQPMw folded before Flop
Seat 2: 7SUIdtQak1SCtldWHjwnFA (button) folded before Flop (didn't bet)
Seat 3: UcFkfWngu95uR8Jhrj+HrQ (small blind) folded before Flop
Seat 5: voSAIKXtXUUbJnds83sYfQ (big blind) collected ($65)
Seat 6: Xl+I49lxCJwPGRuegiaHoA folded before Flop (didn't bet)



PokerStars Game #59959922808:  Hold'em No Limit ($5/$10) - 2009/07/01 10:43:34 ET
Table 'AiNa6yyp/njJVRYl/Lz1KQ' 6-max Seat #3 is the button
Seat 1: 7nu3NHCN2s0uUleNuVaGww ($874 in chips)
Seat 3: I1u3BrIcnPwCmkxtD03Q9A ($514 in chips)
Seat 4: /cJ8s40IT8d8TOJFu/vvGw ($764.20 in chips)
Seat 5: jkH6qYMpn8JA/IyBOhQPMw ($1000 in chips)
/cJ8s40IT8d8TOJFu/vvGw: posts small blind $5
jkH6qYMpn8JA/IyBOhQPMw: posts big blind $10
Xl+I49lxCJwPGRuegiaHoA: sits out
1ScqYmNf7/uWx1XSBgPTBw: sits out
*** HOLE CARDS ***
7nu3NHCN2s0uUleNuVaGww: folds
I1u3BrIcnPwCmkxtD03Q9A: folds
/cJ8s40IT8d8TOJFu/vvGw: folds
jkH6qYMpn8JA/IyBOhQPMw collected $10 from pot
*** SUMMARY ***
Total pot $10 | Rake $0
Seat 1: 7nu3NHCN2s0uUleNuVaGww folded before Flop (didn't bet)
Seat 3: I1u3BrIcnPwCmkxtD03Q9A (button) folded before Flop (didn't bet)
Seat 4: /cJ8s40IT8d8TOJFu/vvGw (small blind) folded before Flop
Seat 5: jkH6qYMpn8JA/IyBOhQPMw (big blind) collected ($10)



PokerStars Game #59959929618:  Hold'em No Limit ($5/$10) - 2009/07/01 10:43:42 ET
Table 'AiNa6yyp/njJVRYl/Lz1KQ' 6-max Seat #4 is the button
Seat 1: 7nu3NHCN2s0uUleNuVaGww ($874 in chips)
Seat 3: I1u3BrIcnPwCmkxtD03Q9A ($514 in chips)
Seat 4: /cJ8s40IT8d8TOJFu/vvGw ($759.20 in chips)
Seat 5: jkH6qYMpn8JA/IyBOhQPMw ($1005 in chips)
Seat 6: Xl+I49lxCJwPGRuegiaHoA ($1000 in chips)
jkH6qYMpn8JA/IyBOhQPMw: posts small blind $5
Xl+I49lxCJwPGRuegiaHoA: posts big blind $10
1ScqYmNf7/uWx1XSBgPTBw: sits out
*** HOLE CARDS ***
7nu3NHCN2s0uUleNuVaGww: raises $20 to $30
I1u3BrIcnPwCmkxtD03Q9A: folds
/cJ8s40IT8d8TOJFu/vvGw: folds
jkH6qYMpn8JA/IyBOhQPMw: folds
Xl+I49lxCJwPGRuegiaHoA: folds
7nu3NHCN2s0uUleNuVaGww collected $25 from pot
*** SUMMARY ***
Total pot $25 | Rake $0
Seat 1: 7nu3NHCN2s0uUleNuVaGww collected ($25)
Seat 3: I1u3BrIcnPwCmkxtD03Q9A folded before Flop (didn't bet)
Seat 4: /cJ8s40IT8d8TOJFu/vvGw (button) folded before Flop (didn't bet)
Seat 5: jkH6qYMpn8JA/IyBOhQPMw (small blind) folded before Flop
Seat 6: Xl+I49lxCJwPGRuegiaHoA (big blind) folded before Flop



PokerStars Game #59959935032:  Hold'em No Limit ($5/$10) - 2009/07/01 10:43:49 ET
Table '2a86NK3xhs21kwGZmbj0QA' 6-max Seat #5 is the button
Seat 1: NczJqEIUdrpEc5Nbd7h1Ig ($704.50 in chips)
Seat 2: Xl+I49lxCJwPGRuegiaHoA ($1087 in chips)
Seat 3: voSAIKXtXUUbJnds83sYfQ ($1008.75 in chips)
Seat 4: Lne9leXjEzXWbU3BGFWsxQ ($1000 in chips)
Seat 5: jkH6qYMpn8JA/IyBOhQPMw ($2167 in chips)
Seat 6: UcFkfWngu95uR8Jhrj+HrQ ($192 in chips)
UcFkfWngu95uR8Jhrj+HrQ: posts small blind $5
NczJqEIUdrpEc5Nbd7h1Ig: posts big blind $10
*** HOLE CARDS ***
Xl+I49lxCJwPGRuegiaHoA: raises $20 to $30
voSAIKXtXUUbJnds83sYfQ: folds
Lne9leXjEzXWbU3BGFWsxQ: folds
jkH6qYMpn8JA/IyBOhQPMw: folds
UcFkfWngu95uR8Jhrj+HrQ: folds
NczJqEIUdrpEc5Nbd7h1Ig: calls $20
*** FLOP *** [4s 9s 4d]
NczJqEIUdrpEc5Nbd7h1Ig: checks
Xl+I49lxCJwPGRuegiaHoA: bets $40
NczJqEIUdrpEc5Nbd7h1Ig: calls $40
*** TURN *** [4s 9s 4d] [4c]
NczJqEIUdrpEc5Nbd7h1Ig: checks
Xl+I49lxCJwPGRuegiaHoA: bets $130
NczJqEIUdrpEc5Nbd7h1Ig: calls $130
*** RIVER *** [4s 9s 4d 4c] [3d]
NczJqEIUdrpEc5Nbd7h1Ig: bets $120
Xl+I49lxCJwPGRuegiaHoA: raises $767 to $887 and is all-in
NczJqEIUdrpEc5Nbd7h1Ig: folds
Xl+I49lxCJwPGRuegiaHoA collected $642 from pot
Xl+I49lxCJwPGRuegiaHoA: doesn't show hand
*** SUMMARY ***
Total pot $645 | Rake $3
Board [4s 9s 4d 4c 3d]
Seat 1: NczJqEIUdrpEc5Nbd7h1Ig (big blind) folded on the River
Seat 2: Xl+I49lxCJwPGRuegiaHoA collected ($642)
Seat 3: voSAIKXtXUUbJnds83sYfQ folded before Flop (didn't bet)
Seat 4: Lne9leXjEzXWbU3BGFWsxQ folded before Flop (didn't bet)
Seat 5: jkH6qYMpn8JA/IyBOhQPMw (button) folded before Flop (didn't bet)
Seat 6: UcFkfWngu95uR8Jhrj+HrQ (small blind) folded before Flop



PokerStars Game #59959941174:  Hold'em No Limit ($5/$10) - 2009/07/01 10:43:56 ET
Table 'AiNa6yyp/njJVRYl/Lz1KQ' 6-max Seat #5 is the button
Seat 2: 1ScqYmNf7/uWx1XSBgPTBw ($200 in chips)
Seat 3: I1u3BrIcnPwCmkxtD03Q9A ($514 in chips)
Seat 4: /cJ8s40IT8d8TOJFu/vvGw ($759.20 in chips)
Seat 5: jkH6qYMpn8JA/IyBOhQPMw ($1000 in chips)
Seat 6: Xl+I49lxCJwPGRuegiaHoA ($1000 in chips)
Xl+I49lxCJwPGRuegiaHoA: posts small blind $5
7nu3NHCN2s0uUleNuVaGww: is sitting out
1ScqYmNf7/uWx1XSBgPTBw: posts big blind $10
*** HOLE CARDS ***
I1u3BrIcnPwCmkxtD03Q9A: folds
/cJ8s40IT8d8TOJFu/vvGw: folds
7nu3NHCN2s0uUleNuVaGww leaves the table
jkH6qYMpn8JA/IyBOhQPMw: folds
Xl+I49lxCJwPGRuegiaHoA: folds
1ScqYmNf7/uWx1XSBgPTBw collected $10 from pot
1ScqYmNf7/uWx1XSBgPTBw: doesn't show hand
*** SUMMARY ***
Total pot $10 | Rake $0
Seat 2: 1ScqYmNf7/uWx1XSBgPTBw (big blind) collected ($10)
Seat 3: I1u3BrIcnPwCmkxtD03Q9A folded before Flop (didn't bet)
Seat 4: /cJ8s40IT8d8TOJFu/vvGw folded before Flop (didn't bet)
Seat 5: jkH6qYMpn8JA/IyBOhQPMw (button) folded before Flop (didn't bet)
Seat 6: Xl+I49lxCJwPGRuegiaHoA (small blind) folded before Flop



PokerStars Game #59959947952:  Hold'em No Limit ($5/$10) - 2009/07/01 10:44:04 ET
Table 'dwLGEw3aoH/cOAI7JsLdmw' 6-max Seat #5 is the button
Seat 1: xNrvKa8pDLb8LKHUI3AbhQ ($1014 in chips)
Seat 2: 7SUIdtQak1SCtldWHjwnFA ($346 in chips)
Seat 4: kykGjpk/IjfbH8Gi6SIm5w ($189 in chips)
Seat 5: g/z/ANylbdR10I7oPCJdKQ ($200 in chips)
Seat 6: 3mTlg4g0FJN2bo939h/0Wg ($431 in chips)
3mTlg4g0FJN2bo939h/0Wg: posts small blind $5
xNrvKa8pDLb8LKHUI3AbhQ: posts big blind $10
voSAIKXtXUUbJnds83sYfQ: sits out
*** HOLE CARDS ***
7SUIdtQak1SCtldWHjwnFA: folds
kykGjpk/IjfbH8Gi6SIm5w: raises $20 to $30
g/z/ANylbdR10I7oPCJdKQ: folds
3mTlg4g0FJN2bo939h/0Wg: folds
xNrvKa8pDLb8LKHUI3AbhQ: raises $84 to $114
kykGjpk/IjfbH8Gi6SIm5w: calls $84
*** FLOP *** [8s 7d 5h]
xNrvKa8pDLb8LKHUI3AbhQ: bets $900 and is all-in
kykGjpk/IjfbH8Gi6SIm5w: folds
xNrvKa8pDLb8LKHUI3AbhQ collected $231 from pot
*** SUMMARY ***
Total pot $233 | Rake $2
Board [8s 7d 5h]
Seat 1: xNrvKa8pDLb8LKHUI3AbhQ (big blind) collected ($231)
Seat 2: 7SUIdtQak1SCtldWHjwnFA folded before Flop (didn't bet)
Seat 4: kykGjpk/IjfbH8Gi6SIm5w folded on the Flop
Seat 5: g/z/ANylbdR10I7oPCJdKQ (button) folded before Flop (didn't bet)
Seat 6: 3mTlg4g0FJN2bo939h/0Wg (small blind) folded before Flop



PokerStars Game #59959951858:  Hold'em No Limit ($5/$10) - 2009/07/01 10:44:09 ET
Table 'AiNa6yyp/njJVRYl/Lz1KQ' 6-max Seat #6 is the button
Seat 2: 1ScqYmNf7/uWx1XSBgPTBw ($205 in chips)
Seat 3: I1u3BrIcnPwCmkxtD03Q9A ($514 in chips)
Seat 4: /cJ8s40IT8d8TOJFu/vvGw ($759.20 in chips)
Seat 5: jkH6qYMpn8JA/IyBOhQPMw ($1000 in chips)
Seat 6: Xl+I49lxCJwPGRuegiaHoA ($1000 in chips)
1ScqYmNf7/uWx1XSBgPTBw: posts small blind $5
I1u3BrIcnPwCmkxtD03Q9A: posts big blind $10
*** HOLE CARDS ***
/cJ8s40IT8d8TOJFu/vvGw: folds
jkH6qYMpn8JA/IyBOhQPMw: folds
Xl+I49lxCJwPGRuegiaHoA: folds
1ScqYmNf7/uWx1XSBgPTBw: raises $10 to $20
I1u3BrIcnPwCmkxtD03Q9A: calls $10
*** FLOP *** [6d Ah 9c]
1ScqYmNf7/uWx1XSBgPTBw: bets $20
I1u3BrIcnPwCmkxtD03Q9A: calls $20
*** TURN *** [6d Ah 9c] [6s]
1ScqYmNf7/uWx1XSBgPTBw: bets $40
I1u3BrIcnPwCmkxtD03Q9A: raises $130 to $170
1ScqYmNf7/uWx1XSBgPTBw: calls $125 and is all-in
*** RIVER *** [6d Ah 9c 6s] [Ts]
*** SHOW DOWN ***
1ScqYmNf7/uWx1XSBgPTBw: shows [8h Ad] (two pair, Aces and Sixes)
I1u3BrIcnPwCmkxtD03Q9A: mucks hand
1ScqYmNf7/uWx1XSBgPTBw collected $408 from pot
*** SUMMARY ***
Total pot $410 | Rake $2
Board [6d Ah 9c 6s Ts]
Seat 2: 1ScqYmNf7/uWx1XSBgPTBw (small blind) showed [8h Ad] and won ($408) with two pair, Aces and Sixes
Seat 3: I1u3BrIcnPwCmkxtD03Q9A (big blind) mucked
Seat 4: /cJ8s40IT8d8TOJFu/vvGw folded before Flop (didn't bet)
Seat 5: jkH6qYMpn8JA/IyBOhQPMw folded before Flop (didn't bet)
Seat 6: Xl+I49lxCJwPGRuegiaHoA (button) folded before Flop (didn't bet)



PokerStars Game #59959954484:  Hold'em No Limit ($5/$10) - 2009/07/01 10:44:12 ET
Table '5DMTRmVjl0/Fvn8CWpM59A' 6-max Seat #3 is the button
Seat 1: jkH6qYMpn8JA/IyBOhQPMw ($1000 in chips)
Seat 2: 7SUIdtQak1SCtldWHjwnFA ($315 in chips)
Seat 3: UcFkfWngu95uR8Jhrj+HrQ ($170 in chips)
Seat 5: voSAIKXtXUUbJnds83sYfQ ($1035 in chips)
Seat 6: Xl+I49lxCJwPGRuegiaHoA ($1015 in chips)
1ScqYmNf7/uWx1XSBgPTBw will be allowed to play after the button
voSAIKXtXUUbJnds83sYfQ: posts small blind $5
Xl+I49lxCJwPGRuegiaHoA: posts big blind $10
*** HOLE CARDS ***
jkH6qYMpn8JA/IyBOhQPMw: folds
7SUIdtQak1SCtldWHjwnFA: folds
UcFkfWngu95uR8Jhrj+HrQ: folds
voSAIKXtXUUbJnds83sYfQ: folds
Xl+I49lxCJwPGRuegiaHoA collected $10 from pot
Xl+I49lxCJwPGRuegiaHoA: doesn't show hand
*** SUMMARY ***
Total pot $10 | Rake $0
Seat 1: jkH6qYMpn8JA/IyBOhQPMw folded before Flop (didn't bet)
Seat 2: 7SUIdtQak1SCtldWHjwnFA folded before Flop (didn't bet)
Seat 3: UcFkfWngu95uR8Jhrj+HrQ (button) folded before Flop (didn't bet)
Seat 5: voSAIKXtXUUbJnds83sYfQ (small blind) folded before Flop
Seat 6: Xl+I49lxCJwPGRuegiaHoA (big blind) collected ($10)



PokerStars Game #59959961788:  Hold'em No Limit ($5/$10) - 2009/07/01 10:44:21 ET
Table '1Dt9cpcLUVE6HYkx5dUEdQ' 6-max Seat #6 is the button
Seat 2: zdS2zKkZYSRe8p+GVcXMgg ($1449.05 in chips)
Seat 3: Lne9leXjEzXWbU3BGFWsxQ ($1000 in chips)
Seat 4: voSAIKXtXUUbJnds83sYfQ ($1000 in chips)
Seat 5: 7SUIdtQak1SCtldWHjwnFA ($200 in chips)
Seat 6: 3mTlg4g0FJN2bo939h/0Wg ($458 in chips)
Xl+I49lxCJwPGRuegiaHoA will be allowed to play after the button
zdS2zKkZYSRe8p+GVcXMgg: posts small blind $5
Lne9leXjEzXWbU3BGFWsxQ: posts big blind $10
*** HOLE CARDS ***
voSAIKXtXUUbJnds83sYfQ: folds
7SUIdtQak1SCtldWHjwnFA: folds
3mTlg4g0FJN2bo939h/0Wg: raises $10 to $20
zdS2zKkZYSRe8p+GVcXMgg: calls $15
Lne9leXjEzXWbU3BGFWsxQ: calls $10
*** FLOP *** [Qs Jh 7h]
zdS2zKkZYSRe8p+GVcXMgg: checks
Lne9leXjEzXWbU3BGFWsxQ: checks
3mTlg4g0FJN2bo939h/0Wg: bets $30
zdS2zKkZYSRe8p+GVcXMgg: raises $40 to $70
Lne9leXjEzXWbU3BGFWsxQ: folds
3mTlg4g0FJN2bo939h/0Wg: calls $40
*** TURN *** [Qs Jh 7h] [5s]
zdS2zKkZYSRe8p+GVcXMgg: bets $100
3mTlg4g0FJN2bo939h/0Wg: calls $100
*** RIVER *** [Qs Jh 7h 5s] [7s]
zdS2zKkZYSRe8p+GVcXMgg: checks
3mTlg4g0FJN2bo939h/0Wg: checks
*** SHOW DOWN ***
zdS2zKkZYSRe8p+GVcXMgg: shows [5h Qh] (two pair, Queens and Sevens)
3mTlg4g0FJN2bo939h/0Wg: shows [Qd Jd] (two pair, Queens and Jacks)
3mTlg4g0FJN2bo939h/0Wg collected $398 from pot
*** SUMMARY ***
Total pot $400 | Rake $2
Board [Qs Jh 7h 5s 7s]
Seat 2: zdS2zKkZYSRe8p+GVcXMgg (small blind) showed [5h Qh] and lost with two pair, Queens and Sevens
Seat 3: Lne9leXjEzXWbU3BGFWsxQ (big blind) folded on the Flop
Seat 4: voSAIKXtXUUbJnds83sYfQ folded before Flop (didn't bet)
Seat 5: 7SUIdtQak1SCtldWHjwnFA folded before Flop (didn't bet)
Seat 6: 3mTlg4g0FJN2bo939h/0Wg (button) showed [Qd Jd] and won ($398) with two pair, Queens and Jacks



PokerStars Game #59959971114:  Hold'em No Limit ($5/$10) - 2009/07/01 10:44:32 ET
Table '5DMTRmVjl0/Fvn8CWpM59A' 6-max Seat #5 is the button
Seat 1: jkH6qYMpn8JA/IyBOhQPMw ($1000 in chips)
Seat 2: 7SUIdtQak1SCtldWHjwnFA ($315 in chips)
Seat 3: UcFkfWngu95uR8Jhrj+HrQ ($170 in chips)
Seat 5: voSAIKXtXUUbJnds83sYfQ ($1030 in chips)
Seat 6: Xl+I49lxCJwPGRuegiaHoA ($1020 in chips)
Xl+I49lxCJwPGRuegiaHoA: posts small blind $5
jkH6qYMpn8JA/IyBOhQPMw: posts big blind $10
1ScqYmNf7/uWx1XSBgPTBw: sits out
*** HOLE CARDS ***
7SUIdtQak1SCtldWHjwnFA: folds
UcFkfWngu95uR8Jhrj+HrQ: folds
voSAIKXtXUUbJnds83sYfQ: raises $20 to $30
Xl+I49lxCJwPGRuegiaHoA: folds
jkH6qYMpn8JA/IyBOhQPMw: folds
voSAIKXtXUUbJnds83sYfQ collected $25 from pot
voSAIKXtXUUbJnds83sYfQ: doesn't show hand
*** SUMMARY ***
Total pot $25 | Rake $0
Seat 1: jkH6qYMpn8JA/IyBOhQPMw (big blind) folded before Flop
Seat 2: 7SUIdtQak1SCtldWHjwnFA folded before Flop (didn't bet)
Seat 3: UcFkfWngu95uR8Jhrj+HrQ folded before Flop (didn't bet)
Seat 5: voSAIKXtXUUbJnds83sYfQ (button) collected ($25)
Seat 6: Xl+I49lxCJwPGRuegiaHoA (small blind) folded before Flop



PokerStars Game #59959975670:  Hold'em No Limit ($5/$10) - 2009/07/01 10:44:38 ET
Table 'dwLGEw3aoH/cOAI7JsLdmw' 6-max Seat #6 is the button
Seat 1: xNrvKa8pDLb8LKHUI3AbhQ ($1131 in chips)
Seat 2: 7SUIdtQak1SCtldWHjwnFA ($346 in chips)
Seat 4: kykGjpk/IjfbH8Gi6SIm5w ($75 in chips)
Seat 5: g/z/ANylbdR10I7oPCJdKQ ($200 in chips)
Seat 6: 3mTlg4g0FJN2bo939h/0Wg ($426 in chips)
xNrvKa8pDLb8LKHUI3AbhQ: posts small blind $5
7SUIdtQak1SCtldWHjwnFA: posts big blind $10
voSAIKXtXUUbJnds83sYfQ: sits out
*** HOLE CARDS ***
kykGjpk/IjfbH8Gi6SIm5w: folds
g/z/ANylbdR10I7oPCJdKQ: folds
3mTlg4g0FJN2bo939h/0Wg: raises $10 to $20
xNrvKa8pDLb8LKHUI3AbhQ: folds
7SUIdtQak1SCtldWHjwnFA: folds
3mTlg4g0FJN2bo939h/0Wg collected $25 from pot
*** SUMMARY ***
Total pot $25 | Rake $0
Seat 1: xNrvKa8pDLb8LKHUI3AbhQ (small blind) folded before Flop
Seat 2: 7SUIdtQak1SCtldWHjwnFA (big blind) folded before Flop
Seat 4: kykGjpk/IjfbH8Gi6SIm5w folded before Flop (didn't bet)
Seat 5: g/z/ANylbdR10I7oPCJdKQ folded before Flop (didn't bet)
Seat 6: 3mTlg4g0FJN2bo939h/0Wg (button) collected ($25)



PokerStars Game #59959981434:  Hold'em No Limit ($5/$10) - 2009/07/01 10:44:45 ET
Table 'AiNa6yyp/njJVRYl/Lz1KQ' 6-max Seat #2 is the button
Seat 2: 1ScqYmNf7/uWx1XSBgPTBw ($408 in chips)
Seat 3: I1u3BrIcnPwCmkxtD03Q9A ($309 in chips)
Seat 4: /cJ8s40IT8d8TOJFu/vvGw ($759.20 in chips)
Seat 5: jkH6qYMpn8JA/IyBOhQPMw ($1000 in chips)
Seat 6: Xl+I49lxCJwPGRuegiaHoA ($1000 in chips)
I1u3BrIcnPwCmkxtD03Q9A: posts small blind $5
/cJ8s40IT8d8TOJFu/vvGw: posts big blind $10
*** HOLE CARDS ***
jkH6qYMpn8JA/IyBOhQPMw: raises $20 to $30
Xl+I49lxCJwPGRuegiaHoA: folds
1ScqYmNf7/uWx1XSBgPTBw: folds
I1u3BrIcnPwCmkxtD03Q9A: folds
/cJ8s40IT8d8TOJFu/vvGw: folds
jkH6qYMpn8JA/IyBOhQPMw collected $25 from pot
jkH6qYMpn8JA/IyBOhQPMw: doesn't show hand
*** SUMMARY ***
Total pot $25 | Rake $0
Seat 2: 1ScqYmNf7/uWx1XSBgPTBw (button) folded before Flop (didn't bet)
Seat 3: I1u3BrIcnPwCmkxtD03Q9A (small blind) folded before Flop
Seat 4: /cJ8s40IT8d8TOJFu/vvGw (big blind) folded before Flop
Seat 5: jkH6qYMpn8JA/IyBOhQPMw collected ($25)
Seat 6: Xl+I49lxCJwPGRuegiaHoA folded before Flop (didn't bet)



PokerStars Game #59959986496:  Hold'em No Limit ($5/$10) - 2009/07/01 10:44:51 ET
Table '2a86NK3xhs21kwGZmbj0QA' 6-max Seat #6 is the button
Seat 1: NczJqEIUdrpEc5Nbd7h1Ig ($384.50 in chips)
Seat 2: Xl+I49lxCJwPGRuegiaHoA ($1409 in chips)
Seat 3: voSAIKXtXUUbJnds83sYfQ ($1008.75 in chips)
Seat 4: Lne9leXjEzXWbU3BGFWsxQ ($1000 in chips)
Seat 5: jkH6qYMpn8JA/IyBOhQPMw ($2167 in chips)
Seat 6: UcFkfWngu95uR8Jhrj+HrQ ($187 in chips)
NczJqEIUdrpEc5Nbd7h1Ig: posts small blind $5
Xl+I49lxCJwPGRuegiaHoA: posts big blind $10
*** HOLE CARDS ***
voSAIKXtXUUbJnds83sYfQ: folds
Lne9leXjEzXWbU3BGFWsxQ: raises $20 to $30
jkH6qYMpn8JA/IyBOhQPMw: calls $30
UcFkfWngu95uR8Jhrj+HrQ: folds
NczJqEIUdrpEc5Nbd7h1Ig: folds
Xl+I49lxCJwPGRuegiaHoA: folds
*** FLOP *** [Ks Td Ts]
Lne9leXjEzXWbU3BGFWsxQ: bets $50
jkH6qYMpn8JA/IyBOhQPMw: calls $50
*** TURN *** [Ks Td Ts] [7s]
Lne9leXjEzXWbU3BGFWsxQ: bets $120
jkH6qYMpn8JA/IyBOhQPMw: folds
Lne9leXjEzXWbU3BGFWsxQ collected $172 from pot
Lne9leXjEzXWbU3BGFWsxQ: doesn't show hand
*** SUMMARY ***
Total pot $175 | Rake $3
Board [Ks Td Ts 7s]
Seat 1: NczJqEIUdrpEc5Nbd7h1Ig (small blind) folded before Flop
Seat 2: Xl+I49lxCJwPGRuegiaHoA (big blind) folded before Flop
Seat 3: voSAIKXtXUUbJnds83sYfQ folded before Flop (didn't bet)
Seat 4: Lne9leXjEzXWbU3BGFWsxQ collected ($172)
Seat 5: jkH6qYMpn8JA/IyBOhQPMw folded on the Turn
Seat 6: UcFkfWngu95uR8Jhrj+HrQ (button) folded before Flop (didn't bet)



PokerStars Game #59959987956:  Hold'em No Limit ($5/$10) - 2009/07/01 10:44:53 ET
Table '5DMTRmVjl0/Fvn8CWpM59A' 6-max Seat #6 is the button
Seat 1: jkH6qYMpn8JA/IyBOhQPMw ($1000 in chips)
Seat 3: UcFkfWngu95uR8Jhrj+HrQ ($170 in chips)
Seat 5: voSAIKXtXUUbJnds83sYfQ ($1045 in chips)
Seat 6: Xl+I49lxCJwPGRuegiaHoA ($1015 in chips)
jkH6qYMpn8JA/IyBOhQPMw: posts small blind $5
7SUIdtQak1SCtldWHjwnFA: is sitting out
UcFkfWngu95uR8Jhrj+HrQ: posts big blind $10
1ScqYmNf7/uWx1XSBgPTBw: sits out
*** HOLE CARDS ***
voSAIKXtXUUbJnds83sYfQ: folds
7SUIdtQak1SCtldWHjwnFA leaves the table
Xl+I49lxCJwPGRuegiaHoA: folds
efhcaDPhNqQ/H48kMHLa8w joins the table at seat #2
jkH6qYMpn8JA/IyBOhQPMw: raises $190 to $200
UcFkfWngu95uR8Jhrj+HrQ: folds
jkH6qYMpn8JA/IyBOhQPMw collected $20 from pot
jkH6qYMpn8JA/IyBOhQPMw: doesn't show hand
*** SUMMARY ***
Total pot $20 | Rake $0
Seat 1: jkH6qYMpn8JA/IyBOhQPMw (small blind) collected ($20)
Seat 3: UcFkfWngu95uR8Jhrj+HrQ (big blind) folded before Flop
Seat 5: voSAIKXtXUUbJnds83sYfQ folded before Flop (didn't bet)
Seat 6: Xl+I49lxCJwPGRuegiaHoA (button) folded before Flop (didn't bet)



PokerStars Game #59959992224:  Hold'em No Limit ($5/$10) - 2009/07/01 10:44:58 ET
Table 'AiNa6yyp/njJVRYl/Lz1KQ' 6-max Seat #3 is the button
Seat 2: 1ScqYmNf7/uWx1XSBgPTBw ($408 in chips)
Seat 3: I1u3BrIcnPwCmkxtD03Q9A ($304 in chips)
Seat 4: /cJ8s40IT8d8TOJFu/vvGw ($749.20 in chips)
Seat 5: jkH6qYMpn8JA/IyBOhQPMw ($1015 in chips)
Seat 6: Xl+I49lxCJwPGRuegiaHoA ($1000 in chips)
/cJ8s40IT8d8TOJFu/vvGw: posts small blind $5
jkH6qYMpn8JA/IyBOhQPMw: posts big blind $10
*** HOLE CARDS ***
voSAIKXtXUUbJnds83sYfQ joins the table at seat #1
Xl+I49lxCJwPGRuegiaHoA: folds
1ScqYmNf7/uWx1XSBgPTBw: raises $15 to $25
I1u3BrIcnPwCmkxtD03Q9A: calls $25
/cJ8s40IT8d8TOJFu/vvGw: folds
jkH6qYMpn8JA/IyBOhQPMw: calls $15
*** FLOP *** [6d Js 4h]
jkH6qYMpn8JA/IyBOhQPMw: checks
1ScqYmNf7/uWx1XSBgPTBw: bets $40
I1u3BrIcnPwCmkxtD03Q9A: folds
jkH6qYMpn8JA/IyBOhQPMw: calls $40
*** TURN *** [6d Js 4h] [Td]
jkH6qYMpn8JA/IyBOhQPMw: checks
1ScqYmNf7/uWx1XSBgPTBw: checks
*** RIVER *** [6d Js 4h Td] [Tc]
jkH6qYMpn8JA/IyBOhQPMw: bets $400
1ScqYmNf7/uWx1XSBgPTBw: folds
jkH6qYMpn8JA/IyBOhQPMw collected $158 from pot
jkH6qYMpn8JA/IyBOhQPMw: doesn't show hand
*** SUMMARY ***
Total pot $160 | Rake $2
Board [6d Js 4h Td Tc]
Seat 2: 1ScqYmNf7/uWx1XSBgPTBw folded on the River
Seat 3: I1u3BrIcnPwCmkxtD03Q9A (button) folded on the Flop
Seat 4: /cJ8s40IT8d8TOJFu/vvGw (small blind) folded before Flop
Seat 5: jkH6qYMpn8JA/IyBOhQPMw (big blind) collected ($158)
Seat 6: Xl+I49lxCJwPGRuegiaHoA folded before Flop (didn't bet)



PokerStars Game #59959995126:  Hold'em No Limit ($5/$10) - 2009/07/01 10:45:02 ET
Table 'TZNsQF5dmhiUCPez59P02g' 2-max Seat #2 is the button
Seat 1: F6fbz9LFDPboPu34o1gpig ($400 in chips)
Seat 2: lhkk4tvkAIWjBBrsHuNe/A ($1000 in chips)
lhkk4tvkAIWjBBrsHuNe/A: posts small blind $5
F6fbz9LFDPboPu34o1gpig: posts big blind $10
*** HOLE CARDS ***
lhkk4tvkAIWjBBrsHuNe/A has timed out
lhkk4tvkAIWjBBrsHuNe/A: folds
lhkk4tvkAIWjBBrsHuNe/A is sitting out
F6fbz9LFDPboPu34o1gpig collected $10 from pot
F6fbz9LFDPboPu34o1gpig: doesn't show hand
*** SUMMARY ***
Total pot $10 | Rake $0
Seat 1: F6fbz9LFDPboPu34o1gpig (big blind) collected ($10)
Seat 2: lhkk4tvkAIWjBBrsHuNe/A (button) (small blind) folded before Flop



PokerStars Game #59960003438:  Hold'em No Limit ($5/$10) - 2009/07/01 10:45:12 ET
Table 'dwLGEw3aoH/cOAI7JsLdmw' 6-max Seat #1 is the button
Seat 1: xNrvKa8pDLb8LKHUI3AbhQ ($1126 in chips)
Seat 2: 7SUIdtQak1SCtldWHjwnFA ($336 in chips)
Seat 3: voSAIKXtXUUbJnds83sYfQ ($1000 in chips)
Seat 4: kykGjpk/IjfbH8Gi6SIm5w ($75 in chips)
Seat 5: g/z/ANylbdR10I7oPCJdKQ ($200 in chips)
Seat 6: 3mTlg4g0FJN2bo939h/0Wg ($441 in chips)
7SUIdtQak1SCtldWHjwnFA: posts small blind $5
voSAIKXtXUUbJnds83sYfQ: posts big blind $10
*** HOLE CARDS ***
kykGjpk/IjfbH8Gi6SIm5w: folds
g/z/ANylbdR10I7oPCJdKQ: folds
3mTlg4g0FJN2bo939h/0Wg: folds
xNrvKa8pDLb8LKHUI3AbhQ: raises $26 to $36
7SUIdtQak1SCtldWHjwnFA: folds
voSAIKXtXUUbJnds83sYfQ: folds
xNrvKa8pDLb8LKHUI3AbhQ collected $25 from pot
*** SUMMARY ***
Total pot $25 | Rake $0
Seat 1: xNrvKa8pDLb8LKHUI3AbhQ (button) collected ($25)
Seat 2: 7SUIdtQak1SCtldWHjwnFA (small blind) folded before Flop
Seat 3: voSAIKXtXUUbJnds83sYfQ (big blind) folded before Flop
Seat 4: kykGjpk/IjfbH8Gi6SIm5w folded before Flop (didn't bet)
Seat 5: g/z/ANylbdR10I7oPCJdKQ folded before Flop (didn't bet)
Seat 6: 3mTlg4g0FJN2bo939h/0Wg folded before Flop (didn't bet)



PokerStars Game #59960004416:  Hold'em No Limit ($5/$10) - 2009/07/01 10:45:13 ET
Table '5DMTRmVjl0/Fvn8CWpM59A' 6-max Seat #1 is the button
Seat 1: jkH6qYMpn8JA/IyBOhQPMw ($1010 in chips)
Seat 3: UcFkfWngu95uR8Jhrj+HrQ ($160 in chips)
Seat 4: 1ScqYmNf7/uWx1XSBgPTBw ($200 in chips)
Seat 5: voSAIKXtXUUbJnds83sYfQ ($1045 in chips)
Seat 6: Xl+I49lxCJwPGRuegiaHoA ($1015 in chips)
efhcaDPhNqQ/H48kMHLa8w will be allowed to play after the button
UcFkfWngu95uR8Jhrj+HrQ: posts small blind $5
1ScqYmNf7/uWx1XSBgPTBw: posts big blind $10
*** HOLE CARDS ***
voSAIKXtXUUbJnds83sYfQ: folds
Xl+I49lxCJwPGRuegiaHoA: folds
jkH6qYMpn8JA/IyBOhQPMw: folds
UcFkfWngu95uR8Jhrj+HrQ: raises $10 to $20
1ScqYmNf7/uWx1XSBgPTBw: folds
UcFkfWngu95uR8Jhrj+HrQ collected $20 from pot
UcFkfWngu95uR8Jhrj+HrQ: doesn't show hand
*** SUMMARY ***
Total pot $20 | Rake $0
Seat 1: jkH6qYMpn8JA/IyBOhQPMw (button) folded before Flop (didn't bet)
Seat 3: UcFkfWngu95uR8Jhrj+HrQ (small blind) collected ($20)
Seat 4: 1ScqYmNf7/uWx1XSBgPTBw (big blind) folded before Flop
Seat 5: voSAIKXtXUUbJnds83sYfQ folded before Flop (didn't bet)
Seat 6: Xl+I49lxCJwPGRuegiaHoA folded before Flop (didn't bet)



PokerStars Game #59960021138:  Hold'em No Limit ($5/$10) - 2009/07/01 10:45:33 ET
Table '5DMTRmVjl0/Fvn8CWpM59A' 6-max Seat #3 is the button
Seat 1: jkH6qYMpn8JA/IyBOhQPMw ($1010 in chips)
Seat 3: UcFkfWngu95uR8Jhrj+HrQ ($170 in chips)
Seat 4: 1ScqYmNf7/uWx1XSBgPTBw ($190 in chips)
Seat 5: voSAIKXtXUUbJnds83sYfQ ($1045 in chips)
Seat 6: Xl+I49lxCJwPGRuegiaHoA ($1015 in chips)
1ScqYmNf7/uWx1XSBgPTBw: posts small blind $5
voSAIKXtXUUbJnds83sYfQ: posts big blind $10
efhcaDPhNqQ/H48kMHLa8w: sits out
*** HOLE CARDS ***
Xl+I49lxCJwPGRuegiaHoA: folds
jkH6qYMpn8JA/IyBOhQPMw: folds
UcFkfWngu95uR8Jhrj+HrQ: raises $10 to $20
1ScqYmNf7/uWx1XSBgPTBw: folds
voSAIKXtXUUbJnds83sYfQ: folds
UcFkfWngu95uR8Jhrj+HrQ collected $25 from pot
UcFkfWngu95uR8Jhrj+HrQ: doesn't show hand
*** SUMMARY ***
Total pot $25 | Rake $0
Seat 1: jkH6qYMpn8JA/IyBOhQPMw folded before Flop (didn't bet)
Seat 3: UcFkfWngu95uR8Jhrj+HrQ (button) collected ($25)
Seat 4: 1ScqYmNf7/uWx1XSBgPTBw (small blind) folded before Flop
Seat 5: voSAIKXtXUUbJnds83sYfQ (big blind) folded before Flop
Seat 6: Xl+I49lxCJwPGRuegiaHoA folded before Flop (didn't bet)



PokerStars Game #59960021458:  Hold'em No Limit ($5/$10) - 2009/07/01 10:45:34 ET
Table '1Dt9cpcLUVE6HYkx5dUEdQ' 6-max Seat #2 is the button
Seat 2: zdS2zKkZYSRe8p+GVcXMgg ($1259.05 in chips)
Seat 3: Lne9leXjEzXWbU3BGFWsxQ ($1000 in chips)
Seat 4: voSAIKXtXUUbJnds83sYfQ ($1000 in chips)
Seat 5: 7SUIdtQak1SCtldWHjwnFA ($200 in chips)
Seat 6: 3mTlg4g0FJN2bo939h/0Wg ($666 in chips)
Lne9leXjEzXWbU3BGFWsxQ: posts small blind $5
voSAIKXtXUUbJnds83sYfQ: posts big blind $10
Xl+I49lxCJwPGRuegiaHoA: sits out
*** HOLE CARDS ***
7SUIdtQak1SCtldWHjwnFA: raises $12 to $22
3mTlg4g0FJN2bo939h/0Wg: folds
zdS2zKkZYSRe8p+GVcXMgg: folds
Lne9leXjEzXWbU3BGFWsxQ: folds
voSAIKXtXUUbJnds83sYfQ: calls $12
*** FLOP *** [9c Qh Ac]
voSAIKXtXUUbJnds83sYfQ: checks
7SUIdtQak1SCtldWHjwnFA: bets $25
voSAIKXtXUUbJnds83sYfQ: folds
7SUIdtQak1SCtldWHjwnFA collected $47 from pot
*** SUMMARY ***
Total pot $49 | Rake $2
Board [9c Qh Ac]
Seat 2: zdS2zKkZYSRe8p+GVcXMgg (button) folded before Flop (didn't bet)
Seat 3: Lne9leXjEzXWbU3BGFWsxQ (small blind) folded before Flop
Seat 4: voSAIKXtXUUbJnds83sYfQ (big blind) folded on the Flop
Seat 5: 7SUIdtQak1SCtldWHjwnFA collected ($47)
Seat 6: 3mTlg4g0FJN2bo939h/0Wg folded before Flop (didn't bet)



PokerStars Game #59960028536:  Hold'em No Limit ($5/$10) - 2009/07/01 10:45:42 ET
Table '2a86NK3xhs21kwGZmbj0QA' 6-max Seat #1 is the button
Seat 1: NczJqEIUdrpEc5Nbd7h1Ig ($379.50 in chips)
Seat 2: Xl+I49lxCJwPGRuegiaHoA ($1399 in chips)
Seat 3: voSAIKXtXUUbJnds83sYfQ ($1008.75 in chips)
Seat 4: Lne9leXjEzXWbU3BGFWsxQ ($1092 in chips)
Seat 5: jkH6qYMpn8JA/IyBOhQPMw ($2087 in chips)
Seat 6: UcFkfWngu95uR8Jhrj+HrQ ($187 in chips)
Xl+I49lxCJwPGRuegiaHoA: posts small blind $5
voSAIKXtXUUbJnds83sYfQ: posts big blind $10
*** HOLE CARDS ***
Lne9leXjEzXWbU3BGFWsxQ: folds
jkH6qYMpn8JA/IyBOhQPMw: folds
UcFkfWngu95uR8Jhrj+HrQ: raises $10 to $20
NczJqEIUdrpEc5Nbd7h1Ig: calls $20
Xl+I49lxCJwPGRuegiaHoA: folds
voSAIKXtXUUbJnds83sYfQ: folds
*** FLOP *** [4d 3h 5h]
UcFkfWngu95uR8Jhrj+HrQ: bets $50
NczJqEIUdrpEc5Nbd7h1Ig: folds
UcFkfWngu95uR8Jhrj+HrQ collected $52.25 from pot
UcFkfWngu95uR8Jhrj+HrQ: doesn't show hand
*** SUMMARY ***
Total pot $55 | Rake $2.75
Board [4d 3h 5h]
Seat 1: NczJqEIUdrpEc5Nbd7h1Ig (button) folded on the Flop
Seat 2: Xl+I49lxCJwPGRuegiaHoA (small blind) folded before Flop
Seat 3: voSAIKXtXUUbJnds83sYfQ (big blind) folded before Flop
Seat 4: Lne9leXjEzXWbU3BGFWsxQ folded before Flop (didn't bet)
Seat 5: jkH6qYMpn8JA/IyBOhQPMw folded before Flop (didn't bet)
Seat 6: UcFkfWngu95uR8Jhrj+HrQ collected ($52.25)



PokerStars Game #59960037738:  Hold'em No Limit ($5/$10) - 2009/07/01 10:45:53 ET
Table 'dwLGEw3aoH/cOAI7JsLdmw' 6-max Seat #2 is the button
Seat 1: xNrvKa8pDLb8LKHUI3AbhQ ($1141 in chips)
Seat 2: 7SUIdtQak1SCtldWHjwnFA ($331 in chips)
Seat 3: voSAIKXtXUUbJnds83sYfQ ($1000 in chips)
Seat 4: kykGjpk/IjfbH8Gi6SIm5w ($75 in chips)
Seat 5: g/z/ANylbdR10I7oPCJdKQ ($200 in chips)
Seat 6: 3mTlg4g0FJN2bo939h/0Wg ($441 in chips)
voSAIKXtXUUbJnds83sYfQ: posts small blind $5
kykGjpk/IjfbH8Gi6SIm5w: posts big blind $10
*** HOLE CARDS ***
g/z/ANylbdR10I7oPCJdKQ: folds
3mTlg4g0FJN2bo939h/0Wg: folds
xNrvKa8pDLb8LKHUI3AbhQ: folds
7SUIdtQak1SCtldWHjwnFA: folds
voSAIKXtXUUbJnds83sYfQ: raises $610 to $620
kykGjpk/IjfbH8Gi6SIm5w: folds
voSAIKXtXUUbJnds83sYfQ collected $20 from pot
*** SUMMARY ***
Total pot $20 | Rake $0
Seat 1: xNrvKa8pDLb8LKHUI3AbhQ folded before Flop (didn't bet)
Seat 2: 7SUIdtQak1SCtldWHjwnFA (button) folded before Flop (didn't bet)
Seat 3: voSAIKXtXUUbJnds83sYfQ (small blind) collected ($20)
Seat 4: kykGjpk/IjfbH8Gi6SIm5w (big blind) folded before Flop
Seat 5: g/z/ANylbdR10I7oPCJdKQ folded before Flop (didn't bet)
Seat 6: 3mTlg4g0FJN2bo939h/0Wg folded before Flop (didn't bet)



PokerStars Game #59960037268:  Hold'em No Limit ($5/$10) - 2009/07/01 10:45:53 ET
Table '5DMTRmVjl0/Fvn8CWpM59A' 6-max Seat #4 is the button
Seat 2: efhcaDPhNqQ/H48kMHLa8w ($1000 in chips)
Seat 3: UcFkfWngu95uR8Jhrj+HrQ ($185 in chips)
Seat 4: 1ScqYmNf7/uWx1XSBgPTBw ($185 in chips)
Seat 5: voSAIKXtXUUbJnds83sYfQ ($1035 in chips)
voSAIKXtXUUbJnds83sYfQ: posts small blind $5
Xl+I49lxCJwPGRuegiaHoA: is sitting out
jkH6qYMpn8JA/IyBOhQPMw: is sitting out
efhcaDPhNqQ/H48kMHLa8w: posts big blind $10
*** HOLE CARDS ***
UcFkfWngu95uR8Jhrj+HrQ: folds
1ScqYmNf7/uWx1XSBgPTBw: folds
Xl+I49lxCJwPGRuegiaHoA leaves the table
voSAIKXtXUUbJnds83sYfQ: folds
efhcaDPhNqQ/H48kMHLa8w collected $10 from pot
efhcaDPhNqQ/H48kMHLa8w: doesn't show hand
*** SUMMARY ***
Total pot $10 | Rake $0
Seat 2: efhcaDPhNqQ/H48kMHLa8w (big blind) collected ($10)
Seat 3: UcFkfWngu95uR8Jhrj+HrQ folded before Flop (didn't bet)
Seat 4: 1ScqYmNf7/uWx1XSBgPTBw (button) folded before Flop (didn't bet)
Seat 5: voSAIKXtXUUbJnds83sYfQ (small blind) folded before Flop



PokerStars Game #59960045078:  Hold'em No Limit ($5/$10) - 2009/07/01 10:46:02 ET
Table '5DMTRmVjl0/Fvn8CWpM59A' 6-max Seat #5 is the button
Seat 2: efhcaDPhNqQ/H48kMHLa8w ($1005 in chips)
Seat 3: UcFkfWngu95uR8Jhrj+HrQ ($185 in chips)
Seat 4: 1ScqYmNf7/uWx1XSBgPTBw ($185 in chips)
Seat 5: voSAIKXtXUUbJnds83sYfQ ($1030 in chips)
efhcaDPhNqQ/H48kMHLa8w: posts small blind $5
UcFkfWngu95uR8Jhrj+HrQ: posts big blind $10
*** HOLE CARDS ***
1ScqYmNf7/uWx1XSBgPTBw: folds
voSAIKXtXUUbJnds83sYfQ: raises $10 to $20
efhcaDPhNqQ/H48kMHLa8w: folds
UcFkfWngu95uR8Jhrj+HrQ: raises $165 to $185 and is all-in
voSAIKXtXUUbJnds83sYfQ: folds
UcFkfWngu95uR8Jhrj+HrQ collected $45 from pot
UcFkfWngu95uR8Jhrj+HrQ: doesn't show hand
*** SUMMARY ***
Total pot $45 | Rake $0
Seat 2: efhcaDPhNqQ/H48kMHLa8w (small blind) folded before Flop
Seat 3: UcFkfWngu95uR8Jhrj+HrQ (big blind) collected ($45)
Seat 4: 1ScqYmNf7/uWx1XSBgPTBw folded before Flop (didn't bet)
Seat 5: voSAIKXtXUUbJnds83sYfQ (button) folded before Flop



PokerStars Game #59960047602:  Hold'em No Limit ($5/$10) - 2009/07/01 10:46:06 ET
Table '2a86NK3xhs21kwGZmbj0QA' 6-max Seat #2 is the button
Seat 1: NczJqEIUdrpEc5Nbd7h1Ig ($359.50 in chips)
Seat 2: Xl+I49lxCJwPGRuegiaHoA ($1394 in chips)
Seat 3: voSAIKXtXUUbJnds83sYfQ ($1000 in chips)
Seat 4: Lne9leXjEzXWbU3BGFWsxQ ($1092 in chips)
Seat 5: jkH6qYMpn8JA/IyBOhQPMw ($2087 in chips)
Seat 6: UcFkfWngu95uR8Jhrj+HrQ ($219.25 in chips)
voSAIKXtXUUbJnds83sYfQ: posts small blind $5
Lne9leXjEzXWbU3BGFWsxQ: posts big blind $10
*** HOLE CARDS ***
jkH6qYMpn8JA/IyBOhQPMw: folds
UcFkfWngu95uR8Jhrj+HrQ: raises $10 to $20
NczJqEIUdrpEc5Nbd7h1Ig: folds
Xl+I49lxCJwPGRuegiaHoA: folds
voSAIKXtXUUbJnds83sYfQ: folds
Lne9leXjEzXWbU3BGFWsxQ: calls $10
*** FLOP *** [Js Qh Ks]
Lne9leXjEzXWbU3BGFWsxQ: checks
UcFkfWngu95uR8Jhrj+HrQ: bets $20
Lne9leXjEzXWbU3BGFWsxQ: raises $30 to $50
UcFkfWngu95uR8Jhrj+HrQ: raises $60 to $110
Lne9leXjEzXWbU3BGFWsxQ: raises $100 to $210
UcFkfWngu95uR8Jhrj+HrQ: calls $89.25 and is all-in
*** TURN *** [Js Qh Ks] [6s]
*** RIVER *** [Js Qh Ks 6s] [8s]
*** SHOW DOWN ***
Lne9leXjEzXWbU3BGFWsxQ: shows [9s Ts] (a flush, King high)
UcFkfWngu95uR8Jhrj+HrQ: mucks hand
Lne9leXjEzXWbU3BGFWsxQ collected $440.50 from pot
*** SUMMARY ***
Total pot $443.50 | Rake $3
Board [Js Qh Ks 6s 8s]
Seat 1: NczJqEIUdrpEc5Nbd7h1Ig folded before Flop (didn't bet)
Seat 2: Xl+I49lxCJwPGRuegiaHoA (button) folded before Flop (didn't bet)
Seat 3: voSAIKXtXUUbJnds83sYfQ (small blind) folded before Flop
Seat 4: Lne9leXjEzXWbU3BGFWsxQ (big blind) showed [9s Ts] and won ($440.50) with a flush, King high
Seat 5: jkH6qYMpn8JA/IyBOhQPMw folded before Flop (didn't bet)
Seat 6: UcFkfWngu95uR8Jhrj+HrQ mucked



PokerStars Game #59960052124:  Hold'em No Limit ($5/$10) - 2009/07/01 10:46:11 ET
Table 'AiNa6yyp/njJVRYl/Lz1KQ' 6-max Seat #4 is the button
Seat 2: 1ScqYmNf7/uWx1XSBgPTBw ($343 in chips)
Seat 3: I1u3BrIcnPwCmkxtD03Q9A ($279 in chips)
Seat 4: /cJ8s40IT8d8TOJFu/vvGw ($744.20 in chips)
Seat 5: jkH6qYMpn8JA/IyBOhQPMw ($1108 in chips)
Seat 6: Xl+I49lxCJwPGRuegiaHoA ($1000 in chips)
jkH6qYMpn8JA/IyBOhQPMw: posts small blind $5
Xl+I49lxCJwPGRuegiaHoA: posts big blind $10
voSAIKXtXUUbJnds83sYfQ: sits out
*** HOLE CARDS ***
1ScqYmNf7/uWx1XSBgPTBw: folds
I1u3BrIcnPwCmkxtD03Q9A: raises $20 to $30
/cJ8s40IT8d8TOJFu/vvGw: folds
jkH6qYMpn8JA/IyBOhQPMw: folds
Xl+I49lxCJwPGRuegiaHoA: folds
I1u3BrIcnPwCmkxtD03Q9A collected $25 from pot
*** SUMMARY ***
Total pot $25 | Rake $0
Seat 2: 1ScqYmNf7/uWx1XSBgPTBw folded before Flop (didn't bet)
Seat 3: I1u3BrIcnPwCmkxtD03Q9A collected ($25)
Seat 4: /cJ8s40IT8d8TOJFu/vvGw (button) folded before Flop (didn't bet)
Seat 5: jkH6qYMpn8JA/IyBOhQPMw (small blind) folded before Flop
Seat 6: Xl+I49lxCJwPGRuegiaHoA (big blind) folded before Flop



PokerStars Game #59960053330:  Hold'em No Limit ($5/$10) - 2009/07/01 10:46:13 ET
Table '1Dt9cpcLUVE6HYkx5dUEdQ' 6-max Seat #3 is the button
Seat 2: zdS2zKkZYSRe8p+GVcXMgg ($1259.05 in chips)
Seat 3: Lne9leXjEzXWbU3BGFWsxQ ($1000 in chips)
Seat 4: voSAIKXtXUUbJnds83sYfQ ($1000 in chips)
Seat 5: 7SUIdtQak1SCtldWHjwnFA ($225 in chips)
Seat 6: 3mTlg4g0FJN2bo939h/0Wg ($666 in chips)
voSAIKXtXUUbJnds83sYfQ: posts small blind $5
7SUIdtQak1SCtldWHjwnFA: posts big blind $10
Xl+I49lxCJwPGRuegiaHoA: sits out
*** HOLE CARDS ***
3mTlg4g0FJN2bo939h/0Wg: folds
zdS2zKkZYSRe8p+GVcXMgg: folds
Lne9leXjEzXWbU3BGFWsxQ: raises $20 to $30
voSAIKXtXUUbJnds83sYfQ: raises $80 to $110
7SUIdtQak1SCtldWHjwnFA: folds
Lne9leXjEzXWbU3BGFWsxQ: folds
voSAIKXtXUUbJnds83sYfQ collected $70 from pot
*** SUMMARY ***
Total pot $70 | Rake $0
Seat 2: zdS2zKkZYSRe8p+GVcXMgg folded before Flop (didn't bet)
Seat 3: Lne9leXjEzXWbU3BGFWsxQ (button) folded before Flop
Seat 4: voSAIKXtXUUbJnds83sYfQ (small blind) collected ($70)
Seat 5: 7SUIdtQak1SCtldWHjwnFA (big blind) folded before Flop
Seat 6: 3mTlg4g0FJN2bo939h/0Wg folded before Flop (didn't bet)



PokerStars Game #59960056550:  Hold'em No Limit ($5/$10) - 2009/07/01 10:46:16 ET
Table 'dwLGEw3aoH/cOAI7JsLdmw' 6-max Seat #3 is the button
Seat 1: xNrvKa8pDLb8LKHUI3AbhQ ($1141 in chips)
Seat 2: 7SUIdtQak1SCtldWHjwnFA ($331 in chips)
Seat 3: voSAIKXtXUUbJnds83sYfQ ($1010 in chips)
Seat 4: kykGjpk/IjfbH8Gi6SIm5w ($65 in chips)
Seat 5: g/z/ANylbdR10I7oPCJdKQ ($200 in chips)
Seat 6: 3mTlg4g0FJN2bo939h/0Wg ($441 in chips)
kykGjpk/IjfbH8Gi6SIm5w: posts small blind $5
g/z/ANylbdR10I7oPCJdKQ: posts big blind $10
*** HOLE CARDS ***
3mTlg4g0FJN2bo939h/0Wg: folds
xNrvKa8pDLb8LKHUI3AbhQ: folds
7SUIdtQak1SCtldWHjwnFA: folds
voSAIKXtXUUbJnds83sYfQ: folds
kykGjpk/IjfbH8Gi6SIm5w: folds
g/z/ANylbdR10I7oPCJdKQ collected $10 from pot
g/z/ANylbdR10I7oPCJdKQ: doesn't show hand
*** SUMMARY ***
Total pot $10 | Rake $0
Seat 1: xNrvKa8pDLb8LKHUI3AbhQ folded before Flop (didn't bet)
Seat 2: 7SUIdtQak1SCtldWHjwnFA folded before Flop (didn't bet)
Seat 3: voSAIKXtXUUbJnds83sYfQ (button) folded before Flop (didn't bet)
Seat 4: kykGjpk/IjfbH8Gi6SIm5w (small blind) folded before Flop
Seat 5: g/z/ANylbdR10I7oPCJdKQ (big blind) collected ($10)
Seat 6: 3mTlg4g0FJN2bo939h/0Wg folded before Flop (didn't bet)



PokerStars Game #59960060458:  Hold'em No Limit ($5/$10) - 2009/07/01 10:46:21 ET
Table '5DMTRmVjl0/Fvn8CWpM59A' 6-max Seat #2 is the button
Seat 2: efhcaDPhNqQ/H48kMHLa8w ($1000 in chips)
Seat 3: UcFkfWngu95uR8Jhrj+HrQ ($210 in chips)
Seat 4: 1ScqYmNf7/uWx1XSBgPTBw ($185 in chips)
Seat 5: voSAIKXtXUUbJnds83sYfQ ($1010 in chips)
UcFkfWngu95uR8Jhrj+HrQ: posts small blind $5
1ScqYmNf7/uWx1XSBgPTBw: posts big blind $10
*** HOLE CARDS ***
voSAIKXtXUUbJnds83sYfQ: folds
efhcaDPhNqQ/H48kMHLa8w: raises $10 to $20
UcFkfWngu95uR8Jhrj+HrQ: folds
1ScqYmNf7/uWx1XSBgPTBw: folds
efhcaDPhNqQ/H48kMHLa8w collected $25 from pot
efhcaDPhNqQ/H48kMHLa8w: doesn't show hand
*** SUMMARY ***
Total pot $25 | Rake $0
Seat 2: efhcaDPhNqQ/H48kMHLa8w (button) collected ($25)
Seat 3: UcFkfWngu95uR8Jhrj+HrQ (small blind) folded before Flop
Seat 4: 1ScqYmNf7/uWx1XSBgPTBw (big blind) folded before Flop
Seat 5: voSAIKXtXUUbJnds83sYfQ folded before Flop (didn't bet)



PokerStars Game #59960077108:  Hold'em No Limit ($5/$10) - 2009/07/01 10:46:42 ET
Table 'dwLGEw3aoH/cOAI7JsLdmw' 6-max Seat #4 is the button
Seat 1: xNrvKa8pDLb8LKHUI3AbhQ ($1141 in chips)
Seat 2: 7SUIdtQak1SCtldWHjwnFA ($331 in chips)
Seat 3: voSAIKXtXUUbJnds83sYfQ ($1010 in chips)
Seat 4: kykGjpk/IjfbH8Gi6SIm5w ($60 in chips)
Seat 5: g/z/ANylbdR10I7oPCJdKQ ($205 in chips)
Seat 6: 3mTlg4g0FJN2bo939h/0Wg ($441 in chips)
g/z/ANylbdR10I7oPCJdKQ: posts small blind $5
3mTlg4g0FJN2bo939h/0Wg: posts big blind $10
*** HOLE CARDS ***
xNrvKa8pDLb8LKHUI3AbhQ: raises $11 to $21
7SUIdtQak1SCtldWHjwnFA: folds
voSAIKXtXUUbJnds83sYfQ: folds
kykGjpk/IjfbH8Gi6SIm5w: folds
g/z/ANylbdR10I7oPCJdKQ: folds
3mTlg4g0FJN2bo939h/0Wg: calls $11
*** FLOP *** [Qh Jd Ac]
3mTlg4g0FJN2bo939h/0Wg: checks
xNrvKa8pDLb8LKHUI3AbhQ: bets $20
3mTlg4g0FJN2bo939h/0Wg: calls $20
*** TURN *** [Qh Jd Ac] [2c]
3mTlg4g0FJN2bo939h/0Wg: checks
xNrvKa8pDLb8LKHUI3AbhQ: bets $50
3mTlg4g0FJN2bo939h/0Wg: folds
xNrvKa8pDLb8LKHUI3AbhQ collected $84 from pot
*** SUMMARY ***
Total pot $87 | Rake $3
Board [Qh Jd Ac 2c]
Seat 1: xNrvKa8pDLb8LKHUI3AbhQ collected ($84)
Seat 2: 7SUIdtQak1SCtldWHjwnFA folded before Flop (didn't bet)
Seat 3: voSAIKXtXUUbJnds83sYfQ folded before Flop (didn't bet)
Seat 4: kykGjpk/IjfbH8Gi6SIm5w (button) folded before Flop (didn't bet)
Seat 5: g/z/ANylbdR10I7oPCJdKQ (small blind) folded before Flop
Seat 6: 3mTlg4g0FJN2bo939h/0Wg (big blind) folded on the Turn



PokerStars Game #59960078190:  Hold'em No Limit ($5/$10) - 2009/07/01 10:46:43 ET
Table 'AiNa6yyp/njJVRYl/Lz1KQ' 6-max Seat #5 is the button
Seat 1: voSAIKXtXUUbJnds83sYfQ ($1000 in chips)
Seat 2: 1ScqYmNf7/uWx1XSBgPTBw ($343 in chips)
Seat 3: I1u3BrIcnPwCmkxtD03Q9A ($294 in chips)
Seat 4: /cJ8s40IT8d8TOJFu/vvGw ($744.20 in chips)
Seat 5: jkH6qYMpn8JA/IyBOhQPMw ($1103 in chips)
Seat 6: Xl+I49lxCJwPGRuegiaHoA ($1000 in chips)
Xl+I49lxCJwPGRuegiaHoA: posts small blind $5
voSAIKXtXUUbJnds83sYfQ: posts big blind $10
*** HOLE CARDS ***
1ScqYmNf7/uWx1XSBgPTBw: folds
I1u3BrIcnPwCmkxtD03Q9A is connected
I1u3BrIcnPwCmkxtD03Q9A: folds
/cJ8s40IT8d8TOJFu/vvGw: raises $10 to $20
jkH6qYMpn8JA/IyBOhQPMw: folds
Xl+I49lxCJwPGRuegiaHoA: folds
voSAIKXtXUUbJnds83sYfQ: calls $10
*** FLOP *** [5c 6s 9c]
voSAIKXtXUUbJnds83sYfQ: checks
/cJ8s40IT8d8TOJFu/vvGw: bets $28
voSAIKXtXUUbJnds83sYfQ: folds
/cJ8s40IT8d8TOJFu/vvGw collected $42.75 from pot
/cJ8s40IT8d8TOJFu/vvGw: doesn't show hand
*** SUMMARY ***
Total pot $45 | Rake $2.25
Board [5c 6s 9c]
Seat 1: voSAIKXtXUUbJnds83sYfQ (big blind) folded on the Flop
Seat 2: 1ScqYmNf7/uWx1XSBgPTBw folded before Flop (didn't bet)
Seat 3: I1u3BrIcnPwCmkxtD03Q9A folded before Flop (didn't bet)
Seat 4: /cJ8s40IT8d8TOJFu/vvGw collected ($42.75)
Seat 5: jkH6qYMpn8JA/IyBOhQPMw (button) folded before Flop (didn't bet)
Seat 6: Xl+I49lxCJwPGRuegiaHoA (small blind) folded before Flop



PokerStars Game #59960082346:  Hold'em No Limit ($5/$10) - 2009/07/01 10:46:48 ET
Table '1Dt9cpcLUVE6HYkx5dUEdQ' 6-max Seat #4 is the button
Seat 2: zdS2zKkZYSRe8p+GVcXMgg ($1259.05 in chips)
Seat 3: Lne9leXjEzXWbU3BGFWsxQ ($1000 in chips)
Seat 4: voSAIKXtXUUbJnds83sYfQ ($1040 in chips)
Seat 5: 7SUIdtQak1SCtldWHjwnFA ($215 in chips)
Seat 6: 3mTlg4g0FJN2bo939h/0Wg ($666 in chips)
7SUIdtQak1SCtldWHjwnFA: posts small blind $5
3mTlg4g0FJN2bo939h/0Wg: posts big blind $10
Xl+I49lxCJwPGRuegiaHoA: sits out
*** HOLE CARDS ***
zdS2zKkZYSRe8p+GVcXMgg: folds
Lne9leXjEzXWbU3BGFWsxQ: folds
voSAIKXtXUUbJnds83sYfQ: raises $10 to $20
7SUIdtQak1SCtldWHjwnFA: folds
3mTlg4g0FJN2bo939h/0Wg: folds
voSAIKXtXUUbJnds83sYfQ collected $25 from pot
*** SUMMARY ***
Total pot $25 | Rake $0
Seat 2: zdS2zKkZYSRe8p+GVcXMgg folded before Flop (didn't bet)
Seat 3: Lne9leXjEzXWbU3BGFWsxQ folded before Flop (didn't bet)
Seat 4: voSAIKXtXUUbJnds83sYfQ (button) collected ($25)
Seat 5: 7SUIdtQak1SCtldWHjwnFA (small blind) folded before Flop
Seat 6: 3mTlg4g0FJN2bo939h/0Wg (big blind) folded before Flop



PokerStars Game #59960101272:  Hold'em No Limit ($5/$10) - 2009/07/01 10:47:12 ET
Table '1Dt9cpcLUVE6HYkx5dUEdQ' 6-max Seat #5 is the button
Seat 1: Xl+I49lxCJwPGRuegiaHoA ($1000 in chips)
Seat 2: zdS2zKkZYSRe8p+GVcXMgg ($1259.05 in chips)
Seat 3: Lne9leXjEzXWbU3BGFWsxQ ($1000 in chips)
Seat 4: voSAIKXtXUUbJnds83sYfQ ($1055 in chips)
Seat 5: 7SUIdtQak1SCtldWHjwnFA ($210 in chips)
Seat 6: 3mTlg4g0FJN2bo939h/0Wg ($656 in chips)
3mTlg4g0FJN2bo939h/0Wg: posts small blind $5
Xl+I49lxCJwPGRuegiaHoA: posts big blind $10
*** HOLE CARDS ***
zdS2zKkZYSRe8p+GVcXMgg: folds
Lne9leXjEzXWbU3BGFWsxQ: folds
voSAIKXtXUUbJnds83sYfQ: folds
7SUIdtQak1SCtldWHjwnFA: raises $12 to $22
3mTlg4g0FJN2bo939h/0Wg: folds
Xl+I49lxCJwPGRuegiaHoA: folds
7SUIdtQak1SCtldWHjwnFA collected $25 from pot
*** SUMMARY ***
Total pot $25 | Rake $0
Seat 1: Xl+I49lxCJwPGRuegiaHoA (big blind) folded before Flop
Seat 2: zdS2zKkZYSRe8p+GVcXMgg folded before Flop (didn't bet)
Seat 3: Lne9leXjEzXWbU3BGFWsxQ folded before Flop (didn't bet)
Seat 4: voSAIKXtXUUbJnds83sYfQ folded before Flop (didn't bet)
Seat 5: 7SUIdtQak1SCtldWHjwnFA (button) collected ($25)
Seat 6: 3mTlg4g0FJN2bo939h/0Wg (small blind) folded before Flop



PokerStars Game #59960103664:  Hold'em No Limit ($5/$10) - 2009/07/01 10:47:15 ET
Table '2a86NK3xhs21kwGZmbj0QA' 6-max Seat #3 is the button
Seat 1: NczJqEIUdrpEc5Nbd7h1Ig ($359.50 in chips)
Seat 2: Xl+I49lxCJwPGRuegiaHoA ($1394 in chips)
Seat 3: voSAIKXtXUUbJnds83sYfQ ($1000 in chips)
Seat 4: Lne9leXjEzXWbU3BGFWsxQ ($1313.25 in chips)
Seat 5: jkH6qYMpn8JA/IyBOhQPMw ($2087 in chips)
Seat 6: UcFkfWngu95uR8Jhrj+HrQ ($200 in chips)
Lne9leXjEzXWbU3BGFWsxQ: posts small blind $5
jkH6qYMpn8JA/IyBOhQPMw: posts big blind $10
*** HOLE CARDS ***
UcFkfWngu95uR8Jhrj+HrQ: folds
NczJqEIUdrpEc5Nbd7h1Ig: raises $20 to $30
Xl+I49lxCJwPGRuegiaHoA: calls $30
voSAIKXtXUUbJnds83sYfQ: folds
Lne9leXjEzXWbU3BGFWsxQ: folds
jkH6qYMpn8JA/IyBOhQPMw: folds
*** FLOP *** [4d 5c Jc]
NczJqEIUdrpEc5Nbd7h1Ig: bets $50
Xl+I49lxCJwPGRuegiaHoA: folds
NczJqEIUdrpEc5Nbd7h1Ig collected $72 from pot
*** SUMMARY ***
Total pot $75 | Rake $3
Board [4d 5c Jc]
Seat 1: NczJqEIUdrpEc5Nbd7h1Ig collected ($72)
Seat 2: Xl+I49lxCJwPGRuegiaHoA folded on the Flop
Seat 3: voSAIKXtXUUbJnds83sYfQ (button) folded before Flop (didn't bet)
Seat 4: Lne9leXjEzXWbU3BGFWsxQ (small blind) folded before Flop
Seat 5: jkH6qYMpn8JA/IyBOhQPMw (big blind) folded before Flop
Seat 6: UcFkfWngu95uR8Jhrj+HrQ folded before Flop (didn't bet)



PokerStars Game #59960118388:  Hold'em No Limit ($5/$10) - 2009/07/01 10:47:33 ET
Table 'AiNa6yyp/njJVRYl/Lz1KQ' 6-max Seat #6 is the button
Seat 1: voSAIKXtXUUbJnds83sYfQ ($1000 in chips)
Seat 3: I1u3BrIcnPwCmkxtD03Q9A ($294 in chips)
Seat 4: /cJ8s40IT8d8TOJFu/vvGw ($766.95 in chips)
Seat 5: jkH6qYMpn8JA/IyBOhQPMw ($1103 in chips)
Seat 6: Xl+I49lxCJwPGRuegiaHoA ($1000 in chips)
voSAIKXtXUUbJnds83sYfQ: posts small blind $5
1ScqYmNf7/uWx1XSBgPTBw: is sitting out
I1u3BrIcnPwCmkxtD03Q9A: posts big blind $10
*** HOLE CARDS ***
/cJ8s40IT8d8TOJFu/vvGw: folds
1ScqYmNf7/uWx1XSBgPTBw leaves the table
jkH6qYMpn8JA/IyBOhQPMw: raises $20 to $30
efhcaDPhNqQ/H48kMHLa8w joins the table at seat #2
Xl+I49lxCJwPGRuegiaHoA: folds
voSAIKXtXUUbJnds83sYfQ: folds
I1u3BrIcnPwCmkxtD03Q9A: folds
jkH6qYMpn8JA/IyBOhQPMw collected $25 from pot
jkH6qYMpn8JA/IyBOhQPMw: doesn't show hand
*** SUMMARY ***
Total pot $25 | Rake $0
Seat 1: voSAIKXtXUUbJnds83sYfQ (small blind) folded before Flop
Seat 3: I1u3BrIcnPwCmkxtD03Q9A (big blind) folded before Flop
Seat 4: /cJ8s40IT8d8TOJFu/vvGw folded before Flop (didn't bet)
Seat 5: jkH6qYMpn8JA/IyBOhQPMw collected ($25)
Seat 6: Xl+I49lxCJwPGRuegiaHoA (button) folded before Flop (didn't bet)



PokerStars Game #59960131102:  Hold'em No Limit ($5/$10) - 2009/07/01 10:47:48 ET
Table '1Dt9cpcLUVE6HYkx5dUEdQ' 6-max Seat #6 is the button
Seat 1: Xl+I49lxCJwPGRuegiaHoA ($1000 in chips)
Seat 2: zdS2zKkZYSRe8p+GVcXMgg ($1259.05 in chips)
Seat 3: Lne9leXjEzXWbU3BGFWsxQ ($1000 in chips)
Seat 4: voSAIKXtXUUbJnds83sYfQ ($1055 in chips)
Seat 5: 7SUIdtQak1SCtldWHjwnFA ($225 in chips)
Seat 6: 3mTlg4g0FJN2bo939h/0Wg ($651 in chips)
Xl+I49lxCJwPGRuegiaHoA: posts small blind $5
zdS2zKkZYSRe8p+GVcXMgg: posts big blind $10
*** HOLE CARDS ***
Lne9leXjEzXWbU3BGFWsxQ: raises $20 to $30
voSAIKXtXUUbJnds83sYfQ: folds
7SUIdtQak1SCtldWHjwnFA: folds
3mTlg4g0FJN2bo939h/0Wg: folds
Xl+I49lxCJwPGRuegiaHoA: folds
zdS2zKkZYSRe8p+GVcXMgg: calls $20
*** FLOP *** [Kh Jd 9d]
zdS2zKkZYSRe8p+GVcXMgg: checks
Lne9leXjEzXWbU3BGFWsxQ: checks
*** TURN *** [Kh Jd 9d] [Ad]
zdS2zKkZYSRe8p+GVcXMgg: checks
Lne9leXjEzXWbU3BGFWsxQ: checks
*** RIVER *** [Kh Jd 9d Ad] [6s]
zdS2zKkZYSRe8p+GVcXMgg: checks
Lne9leXjEzXWbU3BGFWsxQ: checks
*** SHOW DOWN ***
zdS2zKkZYSRe8p+GVcXMgg: shows [4c 6c] (a pair of Sixes)
Lne9leXjEzXWbU3BGFWsxQ: mucks hand
zdS2zKkZYSRe8p+GVcXMgg collected $62 from pot
*** SUMMARY ***
Total pot $65 | Rake $3
Board [Kh Jd 9d Ad 6s]
Seat 1: Xl+I49lxCJwPGRuegiaHoA (small blind) folded before Flop
Seat 2: zdS2zKkZYSRe8p+GVcXMgg (big blind) showed [4c 6c] and won ($62) with a pair of Sixes
Seat 3: Lne9leXjEzXWbU3BGFWsxQ mucked
Seat 4: voSAIKXtXUUbJnds83sYfQ folded before Flop (didn't bet)
Seat 5: 7SUIdtQak1SCtldWHjwnFA folded before Flop (didn't bet)
Seat 6: 3mTlg4g0FJN2bo939h/0Wg (button) folded before Flop (didn't bet)



PokerStars Game #59960134272:  Hold'em No Limit ($5/$10) - 2009/07/01 10:47:52 ET
Table 'AiNa6yyp/njJVRYl/Lz1KQ' 6-max Seat #1 is the button
Seat 1: voSAIKXtXUUbJnds83sYfQ ($1000 in chips)
Seat 3: I1u3BrIcnPwCmkxtD03Q9A ($284 in chips)
Seat 5: jkH6qYMpn8JA/IyBOhQPMw ($1118 in chips)
Seat 6: Xl+I49lxCJwPGRuegiaHoA ($1000 in chips)
efhcaDPhNqQ/H48kMHLa8w will be allowed to play after the button
I1u3BrIcnPwCmkxtD03Q9A: posts small blind $5
/cJ8s40IT8d8TOJFu/vvGw: is sitting out
jkH6qYMpn8JA/IyBOhQPMw: posts big blind $10
*** HOLE CARDS ***
Xl+I49lxCJwPGRuegiaHoA: raises $20 to $30
voSAIKXtXUUbJnds83sYfQ: folds
I1u3BrIcnPwCmkxtD03Q9A: raises $60 to $90
jkH6qYMpn8JA/IyBOhQPMw: folds
Xl+I49lxCJwPGRuegiaHoA: raises $365 to $455
I1u3BrIcnPwCmkxtD03Q9A: calls $194 and is all-in
*** FLOP *** [5c Qh 5s]
*** TURN *** [5c Qh 5s] [4h]
*** RIVER *** [5c Qh 5s 4h] [3d]
*** SHOW DOWN ***
I1u3BrIcnPwCmkxtD03Q9A: shows [Qd Qc] (a full house, Queens full of Fives)
Xl+I49lxCJwPGRuegiaHoA: mucks hand
I1u3BrIcnPwCmkxtD03Q9A collected $576 from pot
*** SUMMARY ***
Total pot $578 | Rake $2
Board [5c Qh 5s 4h 3d]
Seat 1: voSAIKXtXUUbJnds83sYfQ (button) folded before Flop (didn't bet)
Seat 3: I1u3BrIcnPwCmkxtD03Q9A (small blind) showed [Qd Qc] and won ($576) with a full house, Queens full of Fives
Seat 5: jkH6qYMpn8JA/IyBOhQPMw (big blind) folded before Flop
Seat 6: Xl+I49lxCJwPGRuegiaHoA mucked



PokerStars Game #59960135546:  Hold'em No Limit ($5/$10) - 2009/07/01 10:47:54 ET
Table 'dwLGEw3aoH/cOAI7JsLdmw' 6-max Seat #5 is the button
Seat 1: xNrvKa8pDLb8LKHUI3AbhQ ($1184 in chips)
Seat 2: 7SUIdtQak1SCtldWHjwnFA ($331 in chips)
Seat 3: voSAIKXtXUUbJnds83sYfQ ($1010 in chips)
Seat 4: kykGjpk/IjfbH8Gi6SIm5w ($60 in chips)
Seat 5: g/z/ANylbdR10I7oPCJdKQ ($200 in chips)
Seat 6: 3mTlg4g0FJN2bo939h/0Wg ($400 in chips)
3mTlg4g0FJN2bo939h/0Wg: posts small blind $5
xNrvKa8pDLb8LKHUI3AbhQ: posts big blind $10
*** HOLE CARDS ***
7SUIdtQak1SCtldWHjwnFA: raises $13 to $23
voSAIKXtXUUbJnds83sYfQ: folds
kykGjpk/IjfbH8Gi6SIm5w: folds
g/z/ANylbdR10I7oPCJdKQ: folds
3mTlg4g0FJN2bo939h/0Wg: folds
xNrvKa8pDLb8LKHUI3AbhQ: folds
7SUIdtQak1SCtldWHjwnFA collected $25 from pot
*** SUMMARY ***
Total pot $25 | Rake $0
Seat 1: xNrvKa8pDLb8LKHUI3AbhQ (big blind) folded before Flop
Seat 2: 7SUIdtQak1SCtldWHjwnFA collected ($25)
Seat 3: voSAIKXtXUUbJnds83sYfQ folded before Flop (didn't bet)
Seat 4: kykGjpk/IjfbH8Gi6SIm5w folded before Flop (didn't bet)
Seat 5: g/z/ANylbdR10I7oPCJdKQ (button) folded before Flop (didn't bet)
Seat 6: 3mTlg4g0FJN2bo939h/0Wg (small blind) folded before Flop



PokerStars Game #59960135670:  Hold'em No Limit ($5/$10) - 2009/07/01 10:47:54 ET
Table '2a86NK3xhs21kwGZmbj0QA' 6-max Seat #4 is the button
Seat 1: NczJqEIUdrpEc5Nbd7h1Ig ($401.50 in chips)
Seat 2: Xl+I49lxCJwPGRuegiaHoA ($1364 in chips)
Seat 3: voSAIKXtXUUbJnds83sYfQ ($1000 in chips)
Seat 4: Lne9leXjEzXWbU3BGFWsxQ ($1308.25 in chips)
Seat 5: jkH6qYMpn8JA/IyBOhQPMw ($2077 in chips)
Seat 6: UcFkfWngu95uR8Jhrj+HrQ ($200 in chips)
jkH6qYMpn8JA/IyBOhQPMw: posts small blind $5
UcFkfWngu95uR8Jhrj+HrQ: posts big blind $10
*** HOLE CARDS ***
NczJqEIUdrpEc5Nbd7h1Ig: folds
Xl+I49lxCJwPGRuegiaHoA: folds
voSAIKXtXUUbJnds83sYfQ: folds
Lne9leXjEzXWbU3BGFWsxQ: raises $20 to $30
jkH6qYMpn8JA/IyBOhQPMw: folds
UcFkfWngu95uR8Jhrj+HrQ: folds
Lne9leXjEzXWbU3BGFWsxQ collected $25 from pot
Lne9leXjEzXWbU3BGFWsxQ: doesn't show hand
*** SUMMARY ***
Total pot $25 | Rake $0
Seat 1: NczJqEIUdrpEc5Nbd7h1Ig folded before Flop (didn't bet)
Seat 2: Xl+I49lxCJwPGRuegiaHoA folded before Flop (didn't bet)
Seat 3: voSAIKXtXUUbJnds83sYfQ folded before Flop (didn't bet)
Seat 4: Lne9leXjEzXWbU3BGFWsxQ (button) collected ($25)
Seat 5: jkH6qYMpn8JA/IyBOhQPMw (small blind) folded before Flop
Seat 6: UcFkfWngu95uR8Jhrj+HrQ (big blind) folded before Flop



PokerStars Game #59960151996:  Hold'em No Limit ($5/$10) - 2009/07/01 10:48:14 ET
Table 'dwLGEw3aoH/cOAI7JsLdmw' 6-max Seat #6 is the button
Seat 1: xNrvKa8pDLb8LKHUI3AbhQ ($1174 in chips)
Seat 2: 7SUIdtQak1SCtldWHjwnFA ($346 in chips)
Seat 3: voSAIKXtXUUbJnds83sYfQ ($1010 in chips)
Seat 4: kykGjpk/IjfbH8Gi6SIm5w ($60 in chips)
Seat 5: g/z/ANylbdR10I7oPCJdKQ ($200 in chips)
Seat 6: 3mTlg4g0FJN2bo939h/0Wg ($395 in chips)
xNrvKa8pDLb8LKHUI3AbhQ: posts small blind $5
7SUIdtQak1SCtldWHjwnFA: posts big blind $10
*** HOLE CARDS ***
voSAIKXtXUUbJnds83sYfQ: folds
kykGjpk/IjfbH8Gi6SIm5w: folds
g/z/ANylbdR10I7oPCJdKQ: folds
3mTlg4g0FJN2bo939h/0Wg: folds
xNrvKa8pDLb8LKHUI3AbhQ: folds
7SUIdtQak1SCtldWHjwnFA collected $10 from pot
7SUIdtQak1SCtldWHjwnFA: doesn't show hand
*** SUMMARY ***
Total pot $10 | Rake $0
Seat 1: xNrvKa8pDLb8LKHUI3AbhQ (small blind) folded before Flop
Seat 2: 7SUIdtQak1SCtldWHjwnFA (big blind) collected ($10)
Seat 3: voSAIKXtXUUbJnds83sYfQ folded before Flop (didn't bet)
Seat 4: kykGjpk/IjfbH8Gi6SIm5w folded before Flop (didn't bet)
Seat 5: g/z/ANylbdR10I7oPCJdKQ folded before Flop (didn't bet)
Seat 6: 3mTlg4g0FJN2bo939h/0Wg (button) folded before Flop (didn't bet)



PokerStars Game #59960157806:  Hold'em No Limit ($5/$10) - 2009/07/01 10:48:21 ET
Table '2a86NK3xhs21kwGZmbj0QA' 6-max Seat #5 is the button
Seat 1: NczJqEIUdrpEc5Nbd7h1Ig ($401.50 in chips)
Seat 2: Xl+I49lxCJwPGRuegiaHoA ($1364 in chips)
Seat 3: voSAIKXtXUUbJnds83sYfQ ($1000 in chips)
Seat 4: Lne9leXjEzXWbU3BGFWsxQ ($1323.25 in chips)
Seat 5: jkH6qYMpn8JA/IyBOhQPMw ($2072 in chips)
Seat 6: UcFkfWngu95uR8Jhrj+HrQ ($190 in chips)
UcFkfWngu95uR8Jhrj+HrQ: posts small blind $5
NczJqEIUdrpEc5Nbd7h1Ig: posts big blind $10
*** HOLE CARDS ***
Xl+I49lxCJwPGRuegiaHoA: folds
voSAIKXtXUUbJnds83sYfQ: raises $20 to $30
Lne9leXjEzXWbU3BGFWsxQ: folds
jkH6qYMpn8JA/IyBOhQPMw: folds
UcFkfWngu95uR8Jhrj+HrQ: folds
NczJqEIUdrpEc5Nbd7h1Ig: calls $20
*** FLOP *** [Td 5d As]
NczJqEIUdrpEc5Nbd7h1Ig: checks
voSAIKXtXUUbJnds83sYfQ: bets $50
NczJqEIUdrpEc5Nbd7h1Ig: calls $50
*** TURN *** [Td 5d As] [7s]
NczJqEIUdrpEc5Nbd7h1Ig: checks
voSAIKXtXUUbJnds83sYfQ: bets $110
NczJqEIUdrpEc5Nbd7h1Ig: folds
voSAIKXtXUUbJnds83sYfQ collected $162 from pot
voSAIKXtXUUbJnds83sYfQ: doesn't show hand
*** SUMMARY ***
Total pot $165 | Rake $3
Board [Td 5d As 7s]
Seat 1: NczJqEIUdrpEc5Nbd7h1Ig (big blind) folded on the Turn
Seat 2: Xl+I49lxCJwPGRuegiaHoA folded before Flop (didn't bet)
Seat 3: voSAIKXtXUUbJnds83sYfQ collected ($162)
Seat 4: Lne9leXjEzXWbU3BGFWsxQ folded before Flop (didn't bet)
Seat 5: jkH6qYMpn8JA/IyBOhQPMw (button) folded before Flop (didn't bet)
Seat 6: UcFkfWngu95uR8Jhrj+HrQ (small blind) folded before Flop



PokerStars Game #59960160254:  Hold'em No Limit ($5/$10) - 2009/07/01 10:48:24 ET
Table 'AiNa6yyp/njJVRYl/Lz1KQ' 6-max Seat #3 is the button
Seat 1: voSAIKXtXUUbJnds83sYfQ ($1000 in chips)
Seat 3: I1u3BrIcnPwCmkxtD03Q9A ($576 in chips)
Seat 5: jkH6qYMpn8JA/IyBOhQPMw ($1108 in chips)
Seat 6: Xl+I49lxCJwPGRuegiaHoA ($1000 in chips)
jkH6qYMpn8JA/IyBOhQPMw: posts small blind $5
Xl+I49lxCJwPGRuegiaHoA: posts big blind $10
efhcaDPhNqQ/H48kMHLa8w: sits out
*** HOLE CARDS ***
voSAIKXtXUUbJnds83sYfQ: raises $20 to $30
I1u3BrIcnPwCmkxtD03Q9A: folds
jkH6qYMpn8JA/IyBOhQPMw: folds
Xl+I49lxCJwPGRuegiaHoA: folds
voSAIKXtXUUbJnds83sYfQ collected $25 from pot
voSAIKXtXUUbJnds83sYfQ: doesn't show hand
*** SUMMARY ***
Total pot $25 | Rake $0
Seat 1: voSAIKXtXUUbJnds83sYfQ collected ($25)
Seat 3: I1u3BrIcnPwCmkxtD03Q9A (button) folded before Flop (didn't bet)
Seat 5: jkH6qYMpn8JA/IyBOhQPMw (small blind) folded before Flop
Seat 6: Xl+I49lxCJwPGRuegiaHoA (big blind) folded before Flop



PokerStars Game #59960165768:  Hold'em No Limit ($5/$10) - 2009/07/01 10:48:31 ET
Table '1Dt9cpcLUVE6HYkx5dUEdQ' 6-max Seat #1 is the button
Seat 1: Xl+I49lxCJwPGRuegiaHoA ($1000 in chips)
Seat 2: zdS2zKkZYSRe8p+GVcXMgg ($1291.05 in chips)
Seat 3: Lne9leXjEzXWbU3BGFWsxQ ($1000 in chips)
Seat 4: voSAIKXtXUUbJnds83sYfQ ($1055 in chips)
Seat 5: 7SUIdtQak1SCtldWHjwnFA ($225 in chips)
Seat 6: 3mTlg4g0FJN2bo939h/0Wg ($651 in chips)
zdS2zKkZYSRe8p+GVcXMgg: posts small blind $5
Lne9leXjEzXWbU3BGFWsxQ: posts big blind $10
*** HOLE CARDS ***
voSAIKXtXUUbJnds83sYfQ: folds
7SUIdtQak1SCtldWHjwnFA: folds
3mTlg4g0FJN2bo939h/0Wg: folds
Xl+I49lxCJwPGRuegiaHoA: raises $20 to $30
zdS2zKkZYSRe8p+GVcXMgg: folds
Lne9leXjEzXWbU3BGFWsxQ: folds
Xl+I49lxCJwPGRuegiaHoA collected $25 from pot
*** SUMMARY ***
Total pot $25 | Rake $0
Seat 1: Xl+I49lxCJwPGRuegiaHoA (button) collected ($25)
Seat 2: zdS2zKkZYSRe8p+GVcXMgg (small blind) folded before Flop
Seat 3: Lne9leXjEzXWbU3BGFWsxQ (big blind) folded before Flop
Seat 4: voSAIKXtXUUbJnds83sYfQ folded before Flop (didn't bet)
Seat 5: 7SUIdtQak1SCtldWHjwnFA folded before Flop (didn't bet)
Seat 6: 3mTlg4g0FJN2bo939h/0Wg folded before Flop (didn't bet)



PokerStars Game #59960172510:  Hold'em No Limit ($5/$10) - 2009/07/01 10:48:40 ET
Table 'AiNa6yyp/njJVRYl/Lz1KQ' 6-max Seat #5 is the button
Seat 1: voSAIKXtXUUbJnds83sYfQ ($1015 in chips)
Seat 3: I1u3BrIcnPwCmkxtD03Q9A ($576 in chips)
Seat 5: jkH6qYMpn8JA/IyBOhQPMw ($1103 in chips)
Seat 6: Xl+I49lxCJwPGRuegiaHoA ($1000 in chips)
Xl+I49lxCJwPGRuegiaHoA: posts small blind $5
voSAIKXtXUUbJnds83sYfQ: posts big blind $10
efhcaDPhNqQ/H48kMHLa8w: sits out
*** HOLE CARDS ***
I1u3BrIcnPwCmkxtD03Q9A: raises $20 to $30
jkH6qYMpn8JA/IyBOhQPMw: folds
Xl+I49lxCJwPGRuegiaHoA: folds
voSAIKXtXUUbJnds83sYfQ: folds
I1u3BrIcnPwCmkxtD03Q9A collected $25 from pot
I1u3BrIcnPwCmkxtD03Q9A: doesn't show hand
*** SUMMARY ***
Total pot $25 | Rake $0
Seat 1: voSAIKXtXUUbJnds83sYfQ (big blind) folded before Flop
Seat 3: I1u3BrIcnPwCmkxtD03Q9A collected ($25)
Seat 5: jkH6qYMpn8JA/IyBOhQPMw (button) folded before Flop (didn't bet)
Seat 6: Xl+I49lxCJwPGRuegiaHoA (small blind) folded before Flop



PokerStars Game #59960179122:  Hold'em No Limit ($5/$10) - 2009/07/01 10:48:48 ET
Table 'dwLGEw3aoH/cOAI7JsLdmw' 6-max Seat #1 is the button
Seat 1: xNrvKa8pDLb8LKHUI3AbhQ ($1169 in chips)
Seat 2: 7SUIdtQak1SCtldWHjwnFA ($351 in chips)
Seat 3: voSAIKXtXUUbJnds83sYfQ ($1010 in chips)
Seat 4: kykGjpk/IjfbH8Gi6SIm5w ($60 in chips)
Seat 5: g/z/ANylbdR10I7oPCJdKQ ($200 in chips)
Seat 6: 3mTlg4g0FJN2bo939h/0Wg ($395 in chips)
7SUIdtQak1SCtldWHjwnFA: posts small blind $5
voSAIKXtXUUbJnds83sYfQ: posts big blind $10
*** HOLE CARDS ***
kykGjpk/IjfbH8Gi6SIm5w: folds
g/z/ANylbdR10I7oPCJdKQ: folds
3mTlg4g0FJN2bo939h/0Wg: folds
xNrvKa8pDLb8LKHUI3AbhQ: raises $14 to $24
7SUIdtQak1SCtldWHjwnFA: folds
voSAIKXtXUUbJnds83sYfQ: folds
xNrvKa8pDLb8LKHUI3AbhQ collected $25 from pot
*** SUMMARY ***
Total pot $25 | Rake $0
Seat 1: xNrvKa8pDLb8LKHUI3AbhQ (button) collected ($25)
Seat 2: 7SUIdtQak1SCtldWHjwnFA (small blind) folded before Flop
Seat 3: voSAIKXtXUUbJnds83sYfQ (big blind) folded before Flop
Seat 4: kykGjpk/IjfbH8Gi6SIm5w folded before Flop (didn't bet)
Seat 5: g/z/ANylbdR10I7oPCJdKQ folded before Flop (didn't bet)
Seat 6: 3mTlg4g0FJN2bo939h/0Wg folded before Flop (didn't bet)



PokerStars Game #59960184756:  Hold'em No Limit ($5/$10) - 2009/07/01 10:48:55 ET
Table '1Dt9cpcLUVE6HYkx5dUEdQ' 6-max Seat #2 is the button
Seat 1: Xl+I49lxCJwPGRuegiaHoA ($1015 in chips)
Seat 2: zdS2zKkZYSRe8p+GVcXMgg ($1286.05 in chips)
Seat 3: Lne9leXjEzXWbU3BGFWsxQ ($1000 in chips)
Seat 4: voSAIKXtXUUbJnds83sYfQ ($1055 in chips)
Seat 5: 7SUIdtQak1SCtldWHjwnFA ($225 in chips)
Seat 6: 3mTlg4g0FJN2bo939h/0Wg ($651 in chips)
Lne9leXjEzXWbU3BGFWsxQ: posts small blind $5
voSAIKXtXUUbJnds83sYfQ: posts big blind $10
*** HOLE CARDS ***
7SUIdtQak1SCtldWHjwnFA: folds
3mTlg4g0FJN2bo939h/0Wg: folds
Xl+I49lxCJwPGRuegiaHoA: raises $20 to $30
zdS2zKkZYSRe8p+GVcXMgg: folds
Lne9leXjEzXWbU3BGFWsxQ: folds
voSAIKXtXUUbJnds83sYfQ: folds
Xl+I49lxCJwPGRuegiaHoA collected $25 from pot
*** SUMMARY ***
Total pot $25 | Rake $0
Seat 1: Xl+I49lxCJwPGRuegiaHoA collected ($25)
Seat 2: zdS2zKkZYSRe8p+GVcXMgg (button) folded before Flop (didn't bet)
Seat 3: Lne9leXjEzXWbU3BGFWsxQ (small blind) folded before Flop
Seat 4: voSAIKXtXUUbJnds83sYfQ (big blind) folded before Flop
Seat 5: 7SUIdtQak1SCtldWHjwnFA folded before Flop (didn't bet)
Seat 6: 3mTlg4g0FJN2bo939h/0Wg folded before Flop (didn't bet)



PokerStars Game #59960185708:  Hold'em No Limit ($5/$10) - 2009/07/01 10:48:56 ET
Table '2a86NK3xhs21kwGZmbj0QA' 6-max Seat #6 is the button
Seat 1: NczJqEIUdrpEc5Nbd7h1Ig ($321.50 in chips)
Seat 2: Xl+I49lxCJwPGRuegiaHoA ($1364 in chips)
Seat 3: voSAIKXtXUUbJnds83sYfQ ($1082 in chips)
Seat 4: Lne9leXjEzXWbU3BGFWsxQ ($1323.25 in chips)
Seat 5: jkH6qYMpn8JA/IyBOhQPMw ($2072 in chips)
Seat 6: UcFkfWngu95uR8Jhrj+HrQ ($185 in chips)
NczJqEIUdrpEc5Nbd7h1Ig: posts small blind $5
Xl+I49lxCJwPGRuegiaHoA: posts big blind $10
*** HOLE CARDS ***
voSAIKXtXUUbJnds83sYfQ: folds
Lne9leXjEzXWbU3BGFWsxQ: folds
jkH6qYMpn8JA/IyBOhQPMw: folds
UcFkfWngu95uR8Jhrj+HrQ: folds
NczJqEIUdrpEc5Nbd7h1Ig: calls $5
Xl+I49lxCJwPGRuegiaHoA: raises $25 to $35
NczJqEIUdrpEc5Nbd7h1Ig: calls $25
*** FLOP *** [Kc 4s 6c]
NczJqEIUdrpEc5Nbd7h1Ig: checks
Xl+I49lxCJwPGRuegiaHoA: bets $40
NczJqEIUdrpEc5Nbd7h1Ig: calls $40
*** TURN *** [Kc 4s 6c] [2d]
NczJqEIUdrpEc5Nbd7h1Ig: checks
Xl+I49lxCJwPGRuegiaHoA: checks
*** RIVER *** [Kc 4s 6c 2d] [3d]
NczJqEIUdrpEc5Nbd7h1Ig: checks
Xl+I49lxCJwPGRuegiaHoA: bets $40
NczJqEIUdrpEc5Nbd7h1Ig: raises $90 to $130
Xl+I49lxCJwPGRuegiaHoA: calls $90
*** SHOW DOWN ***
NczJqEIUdrpEc5Nbd7h1Ig: shows [2h 3c] (two pair, Threes and Deuces)
Xl+I49lxCJwPGRuegiaHoA: mucks hand
NczJqEIUdrpEc5Nbd7h1Ig collected $407 from pot
*** SUMMARY ***
Total pot $410 | Rake $3
Board [Kc 4s 6c 2d 3d]
Seat 1: NczJqEIUdrpEc5Nbd7h1Ig (small blind) showed [2h 3c] and won ($407) with two pair, Threes and Deuces
Seat 2: Xl+I49lxCJwPGRuegiaHoA (big blind) mucked
Seat 3: voSAIKXtXUUbJnds83sYfQ folded before Flop (didn't bet)
Seat 4: Lne9leXjEzXWbU3BGFWsxQ folded before Flop (didn't bet)
Seat 5: jkH6qYMpn8JA/IyBOhQPMw folded before Flop (didn't bet)
Seat 6: UcFkfWngu95uR8Jhrj+HrQ (button) folded before Flop (didn't bet)



PokerStars Game #59960185878:  Hold'em No Limit ($5/$10) - 2009/07/01 10:48:56 ET
Table 'AiNa6yyp/njJVRYl/Lz1KQ' 6-max Seat #6 is the button
Seat 1: voSAIKXtXUUbJnds83sYfQ ($1005 in chips)
Seat 2: efhcaDPhNqQ/H48kMHLa8w ($1000 in chips)
Seat 3: I1u3BrIcnPwCmkxtD03Q9A ($591 in chips)
Seat 5: jkH6qYMpn8JA/IyBOhQPMw ($1103 in chips)
Seat 6: Xl+I49lxCJwPGRuegiaHoA ($1000 in chips)
voSAIKXtXUUbJnds83sYfQ: posts small blind $5
efhcaDPhNqQ/H48kMHLa8w: posts big blind $10
*** HOLE CARDS ***
I1u3BrIcnPwCmkxtD03Q9A: folds
jkH6qYMpn8JA/IyBOhQPMw: raises $20 to $30
Xl+I49lxCJwPGRuegiaHoA: folds
voSAIKXtXUUbJnds83sYfQ: folds
efhcaDPhNqQ/H48kMHLa8w: folds
jkH6qYMpn8JA/IyBOhQPMw collected $25 from pot
jkH6qYMpn8JA/IyBOhQPMw: doesn't show hand
*** SUMMARY ***
Total pot $25 | Rake $0
Seat 1: voSAIKXtXUUbJnds83sYfQ (small blind) folded before Flop
Seat 2: efhcaDPhNqQ/H48kMHLa8w (big blind) folded before Flop
Seat 3: I1u3BrIcnPwCmkxtD03Q9A folded before Flop (didn't bet)
Seat 5: jkH6qYMpn8JA/IyBOhQPMw collected ($25)
Seat 6: Xl+I49lxCJwPGRuegiaHoA (button) folded before Flop (didn't bet)



PokerStars Game #59960197488:  Hold'em No Limit ($5/$10) - 2009/07/01 10:49:11 ET
Table 'AiNa6yyp/njJVRYl/Lz1KQ' 6-max Seat #1 is the button
Seat 1: voSAIKXtXUUbJnds83sYfQ ($1000 in chips)
Seat 2: efhcaDPhNqQ/H48kMHLa8w ($1000 in chips)
Seat 3: I1u3BrIcnPwCmkxtD03Q9A ($591 in chips)
Seat 5: jkH6qYMpn8JA/IyBOhQPMw ($1118 in chips)
Seat 6: Xl+I49lxCJwPGRuegiaHoA ($1000 in chips)
efhcaDPhNqQ/H48kMHLa8w: posts small blind $5
I1u3BrIcnPwCmkxtD03Q9A: posts big blind $10
*** HOLE CARDS ***
jkH6qYMpn8JA/IyBOhQPMw: raises $20 to $30
Xl+I49lxCJwPGRuegiaHoA: folds
voSAIKXtXUUbJnds83sYfQ: folds
efhcaDPhNqQ/H48kMHLa8w: folds
I1u3BrIcnPwCmkxtD03Q9A: folds
jkH6qYMpn8JA/IyBOhQPMw collected $25 from pot
jkH6qYMpn8JA/IyBOhQPMw: doesn't show hand
*** SUMMARY ***
Total pot $25 | Rake $0
Seat 1: voSAIKXtXUUbJnds83sYfQ (button) folded before Flop (didn't bet)
Seat 2: efhcaDPhNqQ/H48kMHLa8w (small blind) folded before Flop
Seat 3: I1u3BrIcnPwCmkxtD03Q9A (big blind) folded before Flop
Seat 5: jkH6qYMpn8JA/IyBOhQPMw collected ($25)
Seat 6: Xl+I49lxCJwPGRuegiaHoA folded before Flop (didn't bet)



PokerStars Game #59960198568:  Hold'em No Limit ($5/$10) - 2009/07/01 10:49:12 ET
Table 'dwLGEw3aoH/cOAI7JsLdmw' 6-max Seat #2 is the button
Seat 1: xNrvKa8pDLb8LKHUI3AbhQ ($1184 in chips)
Seat 2: 7SUIdtQak1SCtldWHjwnFA ($346 in chips)
Seat 3: voSAIKXtXUUbJnds83sYfQ ($1000 in chips)
Seat 4: kykGjpk/IjfbH8Gi6SIm5w ($60 in chips)
Seat 5: g/z/ANylbdR10I7oPCJdKQ ($200 in chips)
Seat 6: 3mTlg4g0FJN2bo939h/0Wg ($395 in chips)
voSAIKXtXUUbJnds83sYfQ: posts small blind $5
kykGjpk/IjfbH8Gi6SIm5w: posts big blind $10
*** HOLE CARDS ***
g/z/ANylbdR10I7oPCJdKQ: folds
3mTlg4g0FJN2bo939h/0Wg: folds
xNrvKa8pDLb8LKHUI3AbhQ: raises $14 to $24
7SUIdtQak1SCtldWHjwnFA: calls $24
voSAIKXtXUUbJnds83sYfQ: folds
kykGjpk/IjfbH8Gi6SIm5w: folds
*** FLOP *** [Qs Jh Kc]
xNrvKa8pDLb8LKHUI3AbhQ: checks
7SUIdtQak1SCtldWHjwnFA: checks
*** TURN *** [Qs Jh Kc] [4d]
xNrvKa8pDLb8LKHUI3AbhQ: checks
7SUIdtQak1SCtldWHjwnFA: checks
*** RIVER *** [Qs Jh Kc 4d] [Qc]
xNrvKa8pDLb8LKHUI3AbhQ: checks
7SUIdtQak1SCtldWHjwnFA: checks
*** SHOW DOWN ***
xNrvKa8pDLb8LKHUI3AbhQ: shows [7h As] (a pair of Queens)
7SUIdtQak1SCtldWHjwnFA: shows [5s 5h] (two pair, Queens and Fives)
7SUIdtQak1SCtldWHjwnFA collected $60 from pot
*** SUMMARY ***
Total pot $63 | Rake $3
Board [Qs Jh Kc 4d Qc]
Seat 1: xNrvKa8pDLb8LKHUI3AbhQ showed [7h As] and lost with a pair of Queens
Seat 2: 7SUIdtQak1SCtldWHjwnFA (button) showed [5s 5h] and won ($60) with two pair, Queens and Fives
Seat 3: voSAIKXtXUUbJnds83sYfQ (small blind) folded before Flop
Seat 4: kykGjpk/IjfbH8Gi6SIm5w (big blind) folded before Flop
Seat 5: g/z/ANylbdR10I7oPCJdKQ folded before Flop (didn't bet)
Seat 6: 3mTlg4g0FJN2bo939h/0Wg folded before Flop (didn't bet)



PokerStars Game #59960210464:  Hold'em No Limit ($5/$10) - 2009/07/01 10:49:27 ET
Table '1Dt9cpcLUVE6HYkx5dUEdQ' 6-max Seat #3 is the button
Seat 1: Xl+I49lxCJwPGRuegiaHoA ($1030 in chips)
Seat 2: zdS2zKkZYSRe8p+GVcXMgg ($1286.05 in chips)
Seat 3: Lne9leXjEzXWbU3BGFWsxQ ($1000 in chips)
Seat 4: voSAIKXtXUUbJnds83sYfQ ($1045 in chips)
Seat 5: 7SUIdtQak1SCtldWHjwnFA ($225 in chips)
Seat 6: 3mTlg4g0FJN2bo939h/0Wg ($651 in chips)
voSAIKXtXUUbJnds83sYfQ: posts small blind $5
7SUIdtQak1SCtldWHjwnFA: posts big blind $10
*** HOLE CARDS ***
3mTlg4g0FJN2bo939h/0Wg: folds
Xl+I49lxCJwPGRuegiaHoA: folds
zdS2zKkZYSRe8p+GVcXMgg: raises $10 to $20
Lne9leXjEzXWbU3BGFWsxQ: folds
voSAIKXtXUUbJnds83sYfQ: folds
7SUIdtQak1SCtldWHjwnFA: folds
zdS2zKkZYSRe8p+GVcXMgg collected $25 from pot
*** SUMMARY ***
Total pot $25 | Rake $0
Seat 1: Xl+I49lxCJwPGRuegiaHoA folded before Flop (didn't bet)
Seat 2: zdS2zKkZYSRe8p+GVcXMgg collected ($25)
Seat 3: Lne9leXjEzXWbU3BGFWsxQ (button) folded before Flop (didn't bet)
Seat 4: voSAIKXtXUUbJnds83sYfQ (small blind) folded before Flop
Seat 5: 7SUIdtQak1SCtldWHjwnFA (big blind) folded before Flop
Seat 6: 3mTlg4g0FJN2bo939h/0Wg folded before Flop (didn't bet)



PokerStars Game #59960213308:  Hold'em No Limit ($5/$10) - 2009/07/01 10:49:31 ET
Table 'AiNa6yyp/njJVRYl/Lz1KQ' 6-max Seat #2 is the button
Seat 1: voSAIKXtXUUbJnds83sYfQ ($1000 in chips)
Seat 2: efhcaDPhNqQ/H48kMHLa8w ($1000 in chips)
Seat 3: I1u3BrIcnPwCmkxtD03Q9A ($581 in chips)
Seat 5: jkH6qYMpn8JA/IyBOhQPMw ($1133 in chips)
Seat 6: Xl+I49lxCJwPGRuegiaHoA ($1000 in chips)
I1u3BrIcnPwCmkxtD03Q9A: posts small blind $5
jkH6qYMpn8JA/IyBOhQPMw: posts big blind $10
*** HOLE CARDS ***
Xl+I49lxCJwPGRuegiaHoA: folds
voSAIKXtXUUbJnds83sYfQ: raises $20 to $30
efhcaDPhNqQ/H48kMHLa8w: raises $60 to $90
I1u3BrIcnPwCmkxtD03Q9A: folds
jkH6qYMpn8JA/IyBOhQPMw: folds
voSAIKXtXUUbJnds83sYfQ: raises $140 to $230
efhcaDPhNqQ/H48kMHLa8w: folds
voSAIKXtXUUbJnds83sYfQ collected $195 from pot
voSAIKXtXUUbJnds83sYfQ: doesn't show hand
*** SUMMARY ***
Total pot $195 | Rake $0
Seat 1: voSAIKXtXUUbJnds83sYfQ collected ($195)
Seat 2: efhcaDPhNqQ/H48kMHLa8w (button) folded before Flop
Seat 3: I1u3BrIcnPwCmkxtD03Q9A (small blind) folded before Flop
Seat 5: jkH6qYMpn8JA/IyBOhQPMw (big blind) folded before Flop
Seat 6: Xl+I49lxCJwPGRuegiaHoA folded before Flop (didn't bet)



PokerStars Game #59960231624:  Hold'em No Limit ($5/$10) - 2009/07/01 10:49:54 ET
Table '2a86NK3xhs21kwGZmbj0QA' 6-max Seat #1 is the button
Seat 1: NczJqEIUdrpEc5Nbd7h1Ig ($523.50 in chips)
Seat 2: Xl+I49lxCJwPGRuegiaHoA ($1159 in chips)
Seat 3: voSAIKXtXUUbJnds83sYfQ ($1082 in chips)
Seat 4: Lne9leXjEzXWbU3BGFWsxQ ($1323.25 in chips)
Seat 5: jkH6qYMpn8JA/IyBOhQPMw ($2072 in chips)
Seat 6: UcFkfWngu95uR8Jhrj+HrQ ($185 in chips)
Xl+I49lxCJwPGRuegiaHoA: posts small blind $5
voSAIKXtXUUbJnds83sYfQ: posts big blind $10
*** HOLE CARDS ***
Lne9leXjEzXWbU3BGFWsxQ: folds
jkH6qYMpn8JA/IyBOhQPMw: folds
UcFkfWngu95uR8Jhrj+HrQ: folds
NczJqEIUdrpEc5Nbd7h1Ig: raises $20 to $30
Xl+I49lxCJwPGRuegiaHoA: folds
voSAIKXtXUUbJnds83sYfQ: folds
NczJqEIUdrpEc5Nbd7h1Ig collected $25 from pot
*** SUMMARY ***
Total pot $25 | Rake $0
Seat 1: NczJqEIUdrpEc5Nbd7h1Ig (button) collected ($25)
Seat 2: Xl+I49lxCJwPGRuegiaHoA (small blind) folded before Flop
Seat 3: voSAIKXtXUUbJnds83sYfQ (big blind) folded before Flop
Seat 4: Lne9leXjEzXWbU3BGFWsxQ folded before Flop (didn't bet)
Seat 5: jkH6qYMpn8JA/IyBOhQPMw folded before Flop (didn't bet)
Seat 6: UcFkfWngu95uR8Jhrj+HrQ folded before Flop (didn't bet)



PokerStars Game #59960234182:  Hold'em No Limit ($5/$10) - 2009/07/01 10:49:57 ET
Table '1Dt9cpcLUVE6HYkx5dUEdQ' 6-max Seat #4 is the button
Seat 1: Xl+I49lxCJwPGRuegiaHoA ($1030 in chips)
Seat 2: zdS2zKkZYSRe8p+GVcXMgg ($1301.05 in chips)
Seat 3: Lne9leXjEzXWbU3BGFWsxQ ($1000 in chips)
Seat 4: voSAIKXtXUUbJnds83sYfQ ($1040 in chips)
Seat 5: 7SUIdtQak1SCtldWHjwnFA ($215 in chips)
Seat 6: 3mTlg4g0FJN2bo939h/0Wg ($651 in chips)
7SUIdtQak1SCtldWHjwnFA: posts small blind $5
3mTlg4g0FJN2bo939h/0Wg: posts big blind $10
*** HOLE CARDS ***
Xl+I49lxCJwPGRuegiaHoA: folds
zdS2zKkZYSRe8p+GVcXMgg: folds
Lne9leXjEzXWbU3BGFWsxQ: folds
voSAIKXtXUUbJnds83sYfQ: raises $15 to $25
7SUIdtQak1SCtldWHjwnFA: folds
3mTlg4g0FJN2bo939h/0Wg: calls $15
*** FLOP *** [2s 5s 4c]
3mTlg4g0FJN2bo939h/0Wg: bets $20
voSAIKXtXUUbJnds83sYfQ: raises $45 to $65
3mTlg4g0FJN2bo939h/0Wg: calls $45
*** TURN *** [2s 5s 4c] [Jh]
3mTlg4g0FJN2bo939h/0Wg: checks
voSAIKXtXUUbJnds83sYfQ: checks
*** RIVER *** [2s 5s 4c Jh] [Kc]
3mTlg4g0FJN2bo939h/0Wg: bets $60
voSAIKXtXUUbJnds83sYfQ: folds
3mTlg4g0FJN2bo939h/0Wg collected $182 from pot
*** SUMMARY ***
Total pot $185 | Rake $3
Board [2s 5s 4c Jh Kc]
Seat 1: Xl+I49lxCJwPGRuegiaHoA folded before Flop (didn't bet)
Seat 2: zdS2zKkZYSRe8p+GVcXMgg folded before Flop (didn't bet)
Seat 3: Lne9leXjEzXWbU3BGFWsxQ folded before Flop (didn't bet)
Seat 4: voSAIKXtXUUbJnds83sYfQ (button) folded on the River
Seat 5: 7SUIdtQak1SCtldWHjwnFA (small blind) folded before Flop
Seat 6: 3mTlg4g0FJN2bo939h/0Wg (big blind) collected ($182)



PokerStars Game #59960235152:  Hold'em No Limit ($5/$10) - 2009/07/01 10:49:58 ET
Table 'dwLGEw3aoH/cOAI7JsLdmw' 6-max Seat #3 is the button
Seat 1: xNrvKa8pDLb8LKHUI3AbhQ ($1160 in chips)
Seat 2: 7SUIdtQak1SCtldWHjwnFA ($382 in chips)
Seat 3: voSAIKXtXUUbJnds83sYfQ ($1000 in chips)
Seat 4: kykGjpk/IjfbH8Gi6SIm5w ($50 in chips)
Seat 5: g/z/ANylbdR10I7oPCJdKQ ($200 in chips)
Seat 6: 3mTlg4g0FJN2bo939h/0Wg ($395 in chips)
kykGjpk/IjfbH8Gi6SIm5w: posts small blind $5
g/z/ANylbdR10I7oPCJdKQ: posts big blind $10
*** HOLE CARDS ***
3mTlg4g0FJN2bo939h/0Wg: folds
xNrvKa8pDLb8LKHUI3AbhQ: folds
7SUIdtQak1SCtldWHjwnFA: folds
voSAIKXtXUUbJnds83sYfQ: folds
kykGjpk/IjfbH8Gi6SIm5w: folds
g/z/ANylbdR10I7oPCJdKQ collected $10 from pot
*** SUMMARY ***
Total pot $10 | Rake $0
Seat 1: xNrvKa8pDLb8LKHUI3AbhQ folded before Flop (didn't bet)
Seat 2: 7SUIdtQak1SCtldWHjwnFA folded before Flop (didn't bet)
Seat 3: voSAIKXtXUUbJnds83sYfQ (button) folded before Flop (didn't bet)
Seat 4: kykGjpk/IjfbH8Gi6SIm5w (small blind) folded before Flop
Seat 5: g/z/ANylbdR10I7oPCJdKQ (big blind) collected ($10)
Seat 6: 3mTlg4g0FJN2bo939h/0Wg folded before Flop (didn't bet)



PokerStars Game #59960254832:  Hold'em No Limit ($5/$10) - 2009/07/01 10:50:23 ET
Table '2a86NK3xhs21kwGZmbj0QA' 6-max Seat #2 is the button
Seat 1: NczJqEIUdrpEc5Nbd7h1Ig ($538.50 in chips)
Seat 2: Xl+I49lxCJwPGRuegiaHoA ($1154 in chips)
Seat 3: voSAIKXtXUUbJnds83sYfQ ($1072 in chips)
Seat 4: Lne9leXjEzXWbU3BGFWsxQ ($1323.25 in chips)
Seat 5: jkH6qYMpn8JA/IyBOhQPMw ($2072 in chips)
Seat 6: UcFkfWngu95uR8Jhrj+HrQ ($185 in chips)
voSAIKXtXUUbJnds83sYfQ: posts small blind $5
Lne9leXjEzXWbU3BGFWsxQ: posts big blind $10
*** HOLE CARDS ***
jkH6qYMpn8JA/IyBOhQPMw: raises $20 to $30
UcFkfWngu95uR8Jhrj+HrQ: folds
NczJqEIUdrpEc5Nbd7h1Ig: calls $30
Xl+I49lxCJwPGRuegiaHoA: folds
voSAIKXtXUUbJnds83sYfQ: folds
Lne9leXjEzXWbU3BGFWsxQ: calls $20
*** FLOP *** [2c Qh Ad]
Lne9leXjEzXWbU3BGFWsxQ: checks
jkH6qYMpn8JA/IyBOhQPMw: checks
NczJqEIUdrpEc5Nbd7h1Ig: bets $60
Lne9leXjEzXWbU3BGFWsxQ: folds
jkH6qYMpn8JA/IyBOhQPMw: folds
NczJqEIUdrpEc5Nbd7h1Ig collected $92 from pot
*** SUMMARY ***
Total pot $95 | Rake $3
Board [2c Qh Ad]
Seat 1: NczJqEIUdrpEc5Nbd7h1Ig collected ($92)
Seat 2: Xl+I49lxCJwPGRuegiaHoA (button) folded before Flop (didn't bet)
Seat 3: voSAIKXtXUUbJnds83sYfQ (small blind) folded before Flop
Seat 4: Lne9leXjEzXWbU3BGFWsxQ (big blind) folded on the Flop
Seat 5: jkH6qYMpn8JA/IyBOhQPMw folded on the Flop
Seat 6: UcFkfWngu95uR8Jhrj+HrQ folded before Flop (didn't bet)



PokerStars Game #59960257066:  Hold'em No Limit ($5/$10) - 2009/07/01 10:50:26 ET
Table 'dwLGEw3aoH/cOAI7JsLdmw' 6-max Seat #4 is the button
Seat 1: xNrvKa8pDLb8LKHUI3AbhQ ($1160 in chips)
Seat 2: 7SUIdtQak1SCtldWHjwnFA ($382 in chips)
Seat 3: voSAIKXtXUUbJnds83sYfQ ($1000 in chips)
Seat 4: kykGjpk/IjfbH8Gi6SIm5w ($45 in chips)
Seat 5: g/z/ANylbdR10I7oPCJdKQ ($205 in chips)
Seat 6: 3mTlg4g0FJN2bo939h/0Wg ($395 in chips)
g/z/ANylbdR10I7oPCJdKQ: posts small blind $5
3mTlg4g0FJN2bo939h/0Wg: posts big blind $10
*** HOLE CARDS ***
xNrvKa8pDLb8LKHUI3AbhQ: folds
7SUIdtQak1SCtldWHjwnFA: folds
xNrvKa8pDLb8LKHUI3AbhQ leaves the table
voSAIKXtXUUbJnds83sYfQ: folds
kykGjpk/IjfbH8Gi6SIm5w: folds
g/z/ANylbdR10I7oPCJdKQ: folds
3mTlg4g0FJN2bo939h/0Wg collected $10 from pot
*** SUMMARY ***
Total pot $10 | Rake $0
Seat 1: xNrvKa8pDLb8LKHUI3AbhQ folded before Flop (didn't bet)
Seat 2: 7SUIdtQak1SCtldWHjwnFA folded before Flop (didn't bet)
Seat 3: voSAIKXtXUUbJnds83sYfQ folded before Flop (didn't bet)
Seat 4: kykGjpk/IjfbH8Gi6SIm5w (button) folded before Flop (didn't bet)
Seat 5: g/z/ANylbdR10I7oPCJdKQ (small blind) folded before Flop
Seat 6: 3mTlg4g0FJN2bo939h/0Wg (big blind) collected ($10)



PokerStars Game #59960258054:  Hold'em No Limit ($5/$10) - 2009/07/01 10:50:27 ET
Table 'AiNa6yyp/njJVRYl/Lz1KQ' 6-max Seat #3 is the button
Seat 1: voSAIKXtXUUbJnds83sYfQ ($1105 in chips)
Seat 2: efhcaDPhNqQ/H48kMHLa8w ($1000 in chips)
Seat 3: I1u3BrIcnPwCmkxtD03Q9A ($576 in chips)
Seat 5: jkH6qYMpn8JA/IyBOhQPMw ($1123 in chips)
Seat 6: Xl+I49lxCJwPGRuegiaHoA ($1000 in chips)
jkH6qYMpn8JA/IyBOhQPMw: posts small blind $5
Xl+I49lxCJwPGRuegiaHoA: posts big blind $10
*** HOLE CARDS ***
voSAIKXtXUUbJnds83sYfQ: folds
efhcaDPhNqQ/H48kMHLa8w: raises $20 to $30
I1u3BrIcnPwCmkxtD03Q9A: folds
jkH6qYMpn8JA/IyBOhQPMw: folds
Xl+I49lxCJwPGRuegiaHoA: folds
efhcaDPhNqQ/H48kMHLa8w collected $25 from pot
efhcaDPhNqQ/H48kMHLa8w: doesn't show hand
*** SUMMARY ***
Total pot $25 | Rake $0
Seat 1: voSAIKXtXUUbJnds83sYfQ folded before Flop (didn't bet)
Seat 2: efhcaDPhNqQ/H48kMHLa8w collected ($25)
Seat 3: I1u3BrIcnPwCmkxtD03Q9A (button) folded before Flop (didn't bet)
Seat 5: jkH6qYMpn8JA/IyBOhQPMw (small blind) folded before Flop
Seat 6: Xl+I49lxCJwPGRuegiaHoA (big blind) folded before Flop



PokerStars Game #59960271944:  Hold'em No Limit ($5/$10) - 2009/07/01 10:50:44 ET
Table 'AiNa6yyp/njJVRYl/Lz1KQ' 6-max Seat #5 is the button
Seat 1: voSAIKXtXUUbJnds83sYfQ ($1105 in chips)
Seat 2: efhcaDPhNqQ/H48kMHLa8w ($1015 in chips)
Seat 3: I1u3BrIcnPwCmkxtD03Q9A ($576 in chips)
Seat 5: jkH6qYMpn8JA/IyBOhQPMw ($1118 in chips)
Seat 6: Xl+I49lxCJwPGRuegiaHoA ($1000 in chips)
Xl+I49lxCJwPGRuegiaHoA: posts small blind $5
voSAIKXtXUUbJnds83sYfQ: posts big blind $10
*** HOLE CARDS ***
efhcaDPhNqQ/H48kMHLa8w: folds
I1u3BrIcnPwCmkxtD03Q9A: folds
jkH6qYMpn8JA/IyBOhQPMw: raises $20 to $30
Xl+I49lxCJwPGRuegiaHoA: folds
voSAIKXtXUUbJnds83sYfQ: folds
jkH6qYMpn8JA/IyBOhQPMw collected $25 from pot
jkH6qYMpn8JA/IyBOhQPMw: doesn't show hand
*** SUMMARY ***
Total pot $25 | Rake $0
Seat 1: voSAIKXtXUUbJnds83sYfQ (big blind) folded before Flop
Seat 2: efhcaDPhNqQ/H48kMHLa8w folded before Flop (didn't bet)
Seat 3: I1u3BrIcnPwCmkxtD03Q9A folded before Flop (didn't bet)
Seat 5: jkH6qYMpn8JA/IyBOhQPMw (button) collected ($25)
Seat 6: Xl+I49lxCJwPGRuegiaHoA (small blind) folded before Flop



PokerStars Game #59960276512:  Hold'em No Limit ($5/$10) - 2009/07/01 10:50:50 ET
Table 'dwLGEw3aoH/cOAI7JsLdmw' 6-max Seat #5 is the button
Seat 2: 7SUIdtQak1SCtldWHjwnFA ($382 in chips)
Seat 3: voSAIKXtXUUbJnds83sYfQ ($1000 in chips)
Seat 4: kykGjpk/IjfbH8Gi6SIm5w ($45 in chips)
Seat 5: g/z/ANylbdR10I7oPCJdKQ ($200 in chips)
Seat 6: 3mTlg4g0FJN2bo939h/0Wg ($400 in chips)
3mTlg4g0FJN2bo939h/0Wg: posts small blind $5
7SUIdtQak1SCtldWHjwnFA: posts big blind $10
*** HOLE CARDS ***
voSAIKXtXUUbJnds83sYfQ: folds
kykGjpk/IjfbH8Gi6SIm5w: folds
g/z/ANylbdR10I7oPCJdKQ: folds
3mTlg4g0FJN2bo939h/0Wg: calls $5
7SUIdtQak1SCtldWHjwnFA: checks
*** FLOP *** [8h 2c 9h]
3mTlg4g0FJN2bo939h/0Wg: checks
7SUIdtQak1SCtldWHjwnFA: checks
*** TURN *** [8h 2c 9h] [Kc]
3mTlg4g0FJN2bo939h/0Wg: checks
7SUIdtQak1SCtldWHjwnFA: checks
*** RIVER *** [8h 2c 9h Kc] [Ks]
3mTlg4g0FJN2bo939h/0Wg: checks
7SUIdtQak1SCtldWHjwnFA: checks
*** SHOW DOWN ***
3mTlg4g0FJN2bo939h/0Wg: shows [2d Qc] (two pair, Kings and Deuces)
7SUIdtQak1SCtldWHjwnFA: mucks hand
3mTlg4g0FJN2bo939h/0Wg collected $19 from pot
*** SUMMARY ***
Total pot $20 | Rake $1
Board [8h 2c 9h Kc Ks]
Seat 2: 7SUIdtQak1SCtldWHjwnFA (big blind) mucked
Seat 3: voSAIKXtXUUbJnds83sYfQ folded before Flop (didn't bet)
Seat 4: kykGjpk/IjfbH8Gi6SIm5w folded before Flop (didn't bet)
Seat 5: g/z/ANylbdR10I7oPCJdKQ (button) folded before Flop (didn't bet)
Seat 6: 3mTlg4g0FJN2bo939h/0Wg (small blind) showed [2d Qc] and won ($19) with two pair, Kings and Deuces



PokerStars Game #59960290676:  Hold'em No Limit ($5/$10) - 2009/07/01 10:51:08 ET
Table 'AiNa6yyp/njJVRYl/Lz1KQ' 6-max Seat #6 is the button
Seat 1: voSAIKXtXUUbJnds83sYfQ ($1095 in chips)
Seat 2: efhcaDPhNqQ/H48kMHLa8w ($1015 in chips)
Seat 3: I1u3BrIcnPwCmkxtD03Q9A ($576 in chips)
Seat 5: jkH6qYMpn8JA/IyBOhQPMw ($1133 in chips)
Seat 6: Xl+I49lxCJwPGRuegiaHoA ($1000 in chips)
voSAIKXtXUUbJnds83sYfQ: posts small blind $5
efhcaDPhNqQ/H48kMHLa8w: posts big blind $10
*** HOLE CARDS ***
I1u3BrIcnPwCmkxtD03Q9A: folds
jkH6qYMpn8JA/IyBOhQPMw: raises $20 to $30
Xl+I49lxCJwPGRuegiaHoA: folds
voSAIKXtXUUbJnds83sYfQ: folds
efhcaDPhNqQ/H48kMHLa8w: folds
jkH6qYMpn8JA/IyBOhQPMw collected $25 from pot
jkH6qYMpn8JA/IyBOhQPMw: doesn't show hand
*** SUMMARY ***
Total pot $25 | Rake $0
Seat 1: voSAIKXtXUUbJnds83sYfQ (small blind) folded before Flop
Seat 2: efhcaDPhNqQ/H48kMHLa8w (big blind) folded before Flop
Seat 3: I1u3BrIcnPwCmkxtD03Q9A folded before Flop (didn't bet)
Seat 5: jkH6qYMpn8JA/IyBOhQPMw collected ($25)
Seat 6: Xl+I49lxCJwPGRuegiaHoA (button) folded before Flop (didn't bet)



PokerStars Game #59960292668:  Hold'em No Limit ($5/$10) - 2009/07/01 10:51:10 ET
Table '2a86NK3xhs21kwGZmbj0QA' 6-max Seat #3 is the button
Seat 1: NczJqEIUdrpEc5Nbd7h1Ig ($600.50 in chips)
Seat 2: Xl+I49lxCJwPGRuegiaHoA ($1154 in chips)
Seat 3: voSAIKXtXUUbJnds83sYfQ ($1067 in chips)
Seat 4: Lne9leXjEzXWbU3BGFWsxQ ($1293.25 in chips)
Seat 5: jkH6qYMpn8JA/IyBOhQPMw ($2042 in chips)
Seat 6: UcFkfWngu95uR8Jhrj+HrQ ($185 in chips)
Lne9leXjEzXWbU3BGFWsxQ: posts small blind $5
jkH6qYMpn8JA/IyBOhQPMw: posts big blind $10
*** HOLE CARDS ***
UcFkfWngu95uR8Jhrj+HrQ: folds
NczJqEIUdrpEc5Nbd7h1Ig: calls $10
Xl+I49lxCJwPGRuegiaHoA: raises $30 to $40
voSAIKXtXUUbJnds83sYfQ: folds
Lne9leXjEzXWbU3BGFWsxQ: folds
jkH6qYMpn8JA/IyBOhQPMw: raises $80 to $120
NczJqEIUdrpEc5Nbd7h1Ig: folds
Xl+I49lxCJwPGRuegiaHoA: calls $80
*** FLOP *** [Qs Kc 7h]
jkH6qYMpn8JA/IyBOhQPMw: bets $162
Xl+I49lxCJwPGRuegiaHoA: calls $162
*** TURN *** [Qs Kc 7h] [8c]
jkH6qYMpn8JA/IyBOhQPMw: checks
Xl+I49lxCJwPGRuegiaHoA: checks
*** RIVER *** [Qs Kc 7h 8c] [5c]
jkH6qYMpn8JA/IyBOhQPMw: bets $1760 and is all-in
Xl+I49lxCJwPGRuegiaHoA: calls $872 and is all-in
*** SHOW DOWN ***
jkH6qYMpn8JA/IyBOhQPMw: shows [Jc Kd] (a pair of Kings)
Xl+I49lxCJwPGRuegiaHoA: shows [8d 7c] (two pair, Eights and Sevens)
Xl+I49lxCJwPGRuegiaHoA collected $2320 from pot
*** SUMMARY ***
Total pot $2323 | Rake $3
Board [Qs Kc 7h 8c 5c]
Seat 1: NczJqEIUdrpEc5Nbd7h1Ig folded before Flop
Seat 2: Xl+I49lxCJwPGRuegiaHoA showed [8d 7c] and won ($2320) with two pair, Eights and Sevens
Seat 3: voSAIKXtXUUbJnds83sYfQ (button) folded before Flop (didn't bet)
Seat 4: Lne9leXjEzXWbU3BGFWsxQ (small blind) folded before Flop
Seat 5: jkH6qYMpn8JA/IyBOhQPMw (big blind) showed [Jc Kd] and lost with a pair of Kings
Seat 6: UcFkfWngu95uR8Jhrj+HrQ folded before Flop (didn't bet)



PokerStars Game #59960295366:  Hold'em No Limit ($5/$10) - 2009/07/01 10:51:13 ET
Table '1Dt9cpcLUVE6HYkx5dUEdQ' 6-max Seat #5 is the button
Seat 1: Xl+I49lxCJwPGRuegiaHoA ($1030 in chips)
Seat 2: zdS2zKkZYSRe8p+GVcXMgg ($1301.05 in chips)
Seat 3: Lne9leXjEzXWbU3BGFWsxQ ($1000 in chips)
Seat 4: voSAIKXtXUUbJnds83sYfQ ($1000 in chips)
Seat 5: 7SUIdtQak1SCtldWHjwnFA ($210 in chips)
Seat 6: 3mTlg4g0FJN2bo939h/0Wg ($743 in chips)
3mTlg4g0FJN2bo939h/0Wg: posts small blind $5
Xl+I49lxCJwPGRuegiaHoA: posts big blind $10
*** HOLE CARDS ***
zdS2zKkZYSRe8p+GVcXMgg: folds
Lne9leXjEzXWbU3BGFWsxQ: folds
voSAIKXtXUUbJnds83sYfQ: folds
7SUIdtQak1SCtldWHjwnFA: raises $12 to $22
3mTlg4g0FJN2bo939h/0Wg: folds
Xl+I49lxCJwPGRuegiaHoA: folds
7SUIdtQak1SCtldWHjwnFA collected $25 from pot
7SUIdtQak1SCtldWHjwnFA: doesn't show hand
*** SUMMARY ***
Total pot $25 | Rake $0
Seat 1: Xl+I49lxCJwPGRuegiaHoA (big blind) folded before Flop
Seat 2: zdS2zKkZYSRe8p+GVcXMgg folded before Flop (didn't bet)
Seat 3: Lne9leXjEzXWbU3BGFWsxQ folded before Flop (didn't bet)
Seat 4: voSAIKXtXUUbJnds83sYfQ folded before Flop (didn't bet)
Seat 5: 7SUIdtQak1SCtldWHjwnFA (button) collected ($25)
Seat 6: 3mTlg4g0FJN2bo939h/0Wg (small blind) folded before Flop



PokerStars Game #59960302396:  Hold'em No Limit ($5/$10) - 2009/07/01 10:51:22 ET
Table 'AiNa6yyp/njJVRYl/Lz1KQ' 6-max Seat #1 is the button
Seat 1: voSAIKXtXUUbJnds83sYfQ ($1090 in chips)
Seat 2: efhcaDPhNqQ/H48kMHLa8w ($1005 in chips)
Seat 3: I1u3BrIcnPwCmkxtD03Q9A ($576 in chips)
Seat 5: jkH6qYMpn8JA/IyBOhQPMw ($1148 in chips)
Seat 6: Xl+I49lxCJwPGRuegiaHoA ($1000 in chips)
efhcaDPhNqQ/H48kMHLa8w: posts small blind $5
I1u3BrIcnPwCmkxtD03Q9A: posts big blind $10
*** HOLE CARDS ***
jkH6qYMpn8JA/IyBOhQPMw: raises $20 to $30
Xl+I49lxCJwPGRuegiaHoA: calls $30
voSAIKXtXUUbJnds83sYfQ: folds
efhcaDPhNqQ/H48kMHLa8w: folds
I1u3BrIcnPwCmkxtD03Q9A: raises $60 to $90
/cJ8s40IT8d8TOJFu/vvGw leaves the table
jkH6qYMpn8JA/IyBOhQPMw: calls $60
Xl+I49lxCJwPGRuegiaHoA: calls $60
*** FLOP *** [Kc Qh 5d]
I1u3BrIcnPwCmkxtD03Q9A: checks
jkH6qYMpn8JA/IyBOhQPMw: checks
Xl+I49lxCJwPGRuegiaHoA: bets $120
I1u3BrIcnPwCmkxtD03Q9A: folds
jkH6qYMpn8JA/IyBOhQPMw: folds
Xl+I49lxCJwPGRuegiaHoA collected $273 from pot
Xl+I49lxCJwPGRuegiaHoA: doesn't show hand
*** SUMMARY ***
Total pot $275 | Rake $2
Board [Kc Qh 5d]
Seat 1: voSAIKXtXUUbJnds83sYfQ (button) folded before Flop (didn't bet)
Seat 2: efhcaDPhNqQ/H48kMHLa8w (small blind) folded before Flop
Seat 3: I1u3BrIcnPwCmkxtD03Q9A (big blind) folded on the Flop
Seat 5: jkH6qYMpn8JA/IyBOhQPMw folded on the Flop
Seat 6: Xl+I49lxCJwPGRuegiaHoA collected ($273)



PokerStars Game #59960309176:  Hold'em No Limit ($5/$10) - 2009/07/01 10:51:31 ET
Table 'dwLGEw3aoH/cOAI7JsLdmw' 6-max Seat #6 is the button
Seat 2: 7SUIdtQak1SCtldWHjwnFA ($372 in chips)
Seat 3: voSAIKXtXUUbJnds83sYfQ ($1000 in chips)
Seat 4: kykGjpk/IjfbH8Gi6SIm5w ($45 in chips)
Seat 5: g/z/ANylbdR10I7oPCJdKQ ($200 in chips)
Seat 6: 3mTlg4g0FJN2bo939h/0Wg ($409 in chips)
7SUIdtQak1SCtldWHjwnFA: posts small blind $5
voSAIKXtXUUbJnds83sYfQ: posts big blind $10
*** HOLE CARDS ***
kykGjpk/IjfbH8Gi6SIm5w: raises $35 to $45 and is all-in
g/z/ANylbdR10I7oPCJdKQ: folds
3mTlg4g0FJN2bo939h/0Wg: folds
7SUIdtQak1SCtldWHjwnFA: folds
voSAIKXtXUUbJnds83sYfQ: folds
kykGjpk/IjfbH8Gi6SIm5w collected $25 from pot
*** SUMMARY ***
Total pot $25 | Rake $0
Seat 2: 7SUIdtQak1SCtldWHjwnFA (small blind) folded before Flop
Seat 3: voSAIKXtXUUbJnds83sYfQ (big blind) folded before Flop
Seat 4: kykGjpk/IjfbH8Gi6SIm5w collected ($25)
Seat 5: g/z/ANylbdR10I7oPCJdKQ folded before Flop (didn't bet)
Seat 6: 3mTlg4g0FJN2bo939h/0Wg (button) folded before Flop (didn't bet)



PokerStars Game #59960317148:  Hold'em No Limit ($5/$10) - 2009/07/01 10:51:41 ET
Table '1Dt9cpcLUVE6HYkx5dUEdQ' 6-max Seat #6 is the button
Seat 1: Xl+I49lxCJwPGRuegiaHoA ($1020 in chips)
Seat 2: zdS2zKkZYSRe8p+GVcXMgg ($1301.05 in chips)
Seat 3: Lne9leXjEzXWbU3BGFWsxQ ($1000 in chips)
Seat 4: voSAIKXtXUUbJnds83sYfQ ($1000 in chips)
Seat 5: 7SUIdtQak1SCtldWHjwnFA ($225 in chips)
Seat 6: 3mTlg4g0FJN2bo939h/0Wg ($738 in chips)
Xl+I49lxCJwPGRuegiaHoA: posts small blind $5
zdS2zKkZYSRe8p+GVcXMgg: posts big blind $10
*** HOLE CARDS ***
Lne9leXjEzXWbU3BGFWsxQ: folds
voSAIKXtXUUbJnds83sYfQ: folds
7SUIdtQak1SCtldWHjwnFA: raises $12 to $22
3mTlg4g0FJN2bo939h/0Wg: folds
Xl+I49lxCJwPGRuegiaHoA: folds
zdS2zKkZYSRe8p+GVcXMgg: calls $12
*** FLOP *** [9c 7s 2h]
zdS2zKkZYSRe8p+GVcXMgg: checks
7SUIdtQak1SCtldWHjwnFA: checks
*** TURN *** [9c 7s 2h] [2c]
zdS2zKkZYSRe8p+GVcXMgg: bets $20
7SUIdtQak1SCtldWHjwnFA: folds
zdS2zKkZYSRe8p+GVcXMgg collected $46.55 from pot
*** SUMMARY ***
Total pot $49 | Rake $2.45
Board [9c 7s 2h 2c]
Seat 1: Xl+I49lxCJwPGRuegiaHoA (small blind) folded before Flop
Seat 2: zdS2zKkZYSRe8p+GVcXMgg (big blind) collected ($46.55)
Seat 3: Lne9leXjEzXWbU3BGFWsxQ folded before Flop (didn't bet)
Seat 4: voSAIKXtXUUbJnds83sYfQ folded before Flop (didn't bet)
Seat 5: 7SUIdtQak1SCtldWHjwnFA folded on the Turn
Seat 6: 3mTlg4g0FJN2bo939h/0Wg (button) folded before Flop (didn't bet)



PokerStars Game #59960327878:  Hold'em No Limit ($5/$10) - 2009/07/01 10:51:54 ET
Table 'dwLGEw3aoH/cOAI7JsLdmw' 6-max Seat #2 is the button
Seat 2: 7SUIdtQak1SCtldWHjwnFA ($367 in chips)
Seat 3: voSAIKXtXUUbJnds83sYfQ ($1000 in chips)
Seat 4: kykGjpk/IjfbH8Gi6SIm5w ($60 in chips)
Seat 5: g/z/ANylbdR10I7oPCJdKQ ($200 in chips)
Seat 6: 3mTlg4g0FJN2bo939h/0Wg ($409 in chips)
voSAIKXtXUUbJnds83sYfQ: posts small blind $5
kykGjpk/IjfbH8Gi6SIm5w: posts big blind $10
is0C+o+4W8624tMaRmJg7A: sits out
*** HOLE CARDS ***
g/z/ANylbdR10I7oPCJdKQ: folds
3mTlg4g0FJN2bo939h/0Wg: folds
7SUIdtQak1SCtldWHjwnFA: raises $15 to $25
voSAIKXtXUUbJnds83sYfQ: folds
kykGjpk/IjfbH8Gi6SIm5w: raises $35 to $60 and is all-in
7SUIdtQak1SCtldWHjwnFA: calls $35
*** FLOP *** [4d 6h 2d]
*** TURN *** [4d 6h 2d] [2h]
*** RIVER *** [4d 6h 2d 2h] [3d]
*** SHOW DOWN ***
kykGjpk/IjfbH8Gi6SIm5w: shows [Ts Th] (two pair, Tens and Deuces)
7SUIdtQak1SCtldWHjwnFA: mucks hand
kykGjpk/IjfbH8Gi6SIm5w collected $123 from pot
*** SUMMARY ***
Total pot $125 | Rake $2
Board [4d 6h 2d 2h 3d]
Seat 2: 7SUIdtQak1SCtldWHjwnFA (button) mucked
Seat 3: voSAIKXtXUUbJnds83sYfQ (small blind) folded before Flop
Seat 4: kykGjpk/IjfbH8Gi6SIm5w (big blind) showed [Ts Th] and won ($123) with two pair, Tens and Deuces
Seat 5: g/z/ANylbdR10I7oPCJdKQ folded before Flop (didn't bet)
Seat 6: 3mTlg4g0FJN2bo939h/0Wg folded before Flop (didn't bet)



PokerStars Game #59960346836:  Hold'em No Limit ($5/$10) - 2009/07/01 10:52:17 ET
Table '1Dt9cpcLUVE6HYkx5dUEdQ' 6-max Seat #1 is the button
Seat 1: Xl+I49lxCJwPGRuegiaHoA ($1015 in chips)
Seat 2: zdS2zKkZYSRe8p+GVcXMgg ($1325.60 in chips)
Seat 3: Lne9leXjEzXWbU3BGFWsxQ ($1000 in chips)
Seat 4: voSAIKXtXUUbJnds83sYfQ ($1000 in chips)
Seat 5: 7SUIdtQak1SCtldWHjwnFA ($203 in chips)
Seat 6: 3mTlg4g0FJN2bo939h/0Wg ($738 in chips)
zdS2zKkZYSRe8p+GVcXMgg: posts small blind $5
Lne9leXjEzXWbU3BGFWsxQ: posts big blind $10
*** HOLE CARDS ***
voSAIKXtXUUbJnds83sYfQ: folds
7SUIdtQak1SCtldWHjwnFA: raises $12 to $22
3mTlg4g0FJN2bo939h/0Wg: calls $22
Xl+I49lxCJwPGRuegiaHoA: folds
zdS2zKkZYSRe8p+GVcXMgg: folds
Lne9leXjEzXWbU3BGFWsxQ: folds
*** FLOP *** [9c 5c 4h]
7SUIdtQak1SCtldWHjwnFA: bets $28
3mTlg4g0FJN2bo939h/0Wg: calls $28
*** TURN *** [9c 5c 4h] [4c]
7SUIdtQak1SCtldWHjwnFA: bets $84
3mTlg4g0FJN2bo939h/0Wg: folds
7SUIdtQak1SCtldWHjwnFA collected $112 from pot
*** SUMMARY ***
Total pot $115 | Rake $3
Board [9c 5c 4h 4c]
Seat 1: Xl+I49lxCJwPGRuegiaHoA (button) folded before Flop (didn't bet)
Seat 2: zdS2zKkZYSRe8p+GVcXMgg (small blind) folded before Flop
Seat 3: Lne9leXjEzXWbU3BGFWsxQ (big blind) folded before Flop
Seat 4: voSAIKXtXUUbJnds83sYfQ folded before Flop (didn't bet)
Seat 5: 7SUIdtQak1SCtldWHjwnFA collected ($112)
Seat 6: 3mTlg4g0FJN2bo939h/0Wg folded on the Turn



PokerStars Game #59960357764:  Hold'em No Limit ($5/$10) - 2009/07/01 10:52:31 ET
Table 'dwLGEw3aoH/cOAI7JsLdmw' 6-max Seat #3 is the button
Seat 2: 7SUIdtQak1SCtldWHjwnFA ($307 in chips)
Seat 3: voSAIKXtXUUbJnds83sYfQ ($1000 in chips)
Seat 4: kykGjpk/IjfbH8Gi6SIm5w ($123 in chips)
Seat 5: g/z/ANylbdR10I7oPCJdKQ ($200 in chips)
Seat 6: 3mTlg4g0FJN2bo939h/0Wg ($409 in chips)
kykGjpk/IjfbH8Gi6SIm5w: posts small blind $5
g/z/ANylbdR10I7oPCJdKQ: posts big blind $10
is0C+o+4W8624tMaRmJg7A: sits out
*** HOLE CARDS ***
3mTlg4g0FJN2bo939h/0Wg: raises $10 to $20
7SUIdtQak1SCtldWHjwnFA: folds
voSAIKXtXUUbJnds83sYfQ: folds
kykGjpk/IjfbH8Gi6SIm5w: calls $15
g/z/ANylbdR10I7oPCJdKQ: calls $10
*** FLOP *** [3d Js 4d]
kykGjpk/IjfbH8Gi6SIm5w: checks
g/z/ANylbdR10I7oPCJdKQ: checks
3mTlg4g0FJN2bo939h/0Wg: checks
*** TURN *** [3d Js 4d] [3c]
kykGjpk/IjfbH8Gi6SIm5w: bets $20
g/z/ANylbdR10I7oPCJdKQ: calls $20
3mTlg4g0FJN2bo939h/0Wg: folds
*** RIVER *** [3d Js 4d 3c] [6c]
kykGjpk/IjfbH8Gi6SIm5w: bets $30
g/z/ANylbdR10I7oPCJdKQ: raises $60 to $90
kykGjpk/IjfbH8Gi6SIm5w: folds
g/z/ANylbdR10I7oPCJdKQ collected $158 from pot
*** SUMMARY ***
Total pot $160 | Rake $2
Board [3d Js 4d 3c 6c]
Seat 2: 7SUIdtQak1SCtldWHjwnFA folded before Flop (didn't bet)
Seat 3: voSAIKXtXUUbJnds83sYfQ (button) folded before Flop (didn't bet)
Seat 4: kykGjpk/IjfbH8Gi6SIm5w (small blind) folded on the River
Seat 5: g/z/ANylbdR10I7oPCJdKQ (big blind) collected ($158)
Seat 6: 3mTlg4g0FJN2bo939h/0Wg folded on the Turn



PokerStars Game #59960363074:  Hold'em No Limit ($5/$10) - 2009/07/01 10:52:38 ET
Table 'AiNa6yyp/njJVRYl/Lz1KQ' 6-max Seat #2 is the button
Seat 1: voSAIKXtXUUbJnds83sYfQ ($1090 in chips)
Seat 2: efhcaDPhNqQ/H48kMHLa8w ($1000 in chips)
Seat 3: I1u3BrIcnPwCmkxtD03Q9A ($486 in chips)
Seat 5: jkH6qYMpn8JA/IyBOhQPMw ($1058 in chips)
Seat 6: Xl+I49lxCJwPGRuegiaHoA ($1183 in chips)
I1u3BrIcnPwCmkxtD03Q9A: posts small blind $5
jkH6qYMpn8JA/IyBOhQPMw: posts big blind $10
*** HOLE CARDS ***
Xl+I49lxCJwPGRuegiaHoA: folds
voSAIKXtXUUbJnds83sYfQ: folds
efhcaDPhNqQ/H48kMHLa8w: raises $10 to $20
I1u3BrIcnPwCmkxtD03Q9A: calls $15
W5z+iP++AH0RC/BH7RB+Fg joins the table at seat #4
jkH6qYMpn8JA/IyBOhQPMw: folds
*** FLOP *** [5c Qc 6h]
I1u3BrIcnPwCmkxtD03Q9A: checks
efhcaDPhNqQ/H48kMHLa8w: bets $30
I1u3BrIcnPwCmkxtD03Q9A: raises $30 to $60
efhcaDPhNqQ/H48kMHLa8w: calls $30
*** TURN *** [5c Qc 6h] [As]
I1u3BrIcnPwCmkxtD03Q9A: bets $60
efhcaDPhNqQ/H48kMHLa8w: folds
I1u3BrIcnPwCmkxtD03Q9A collected $168 from pot
I1u3BrIcnPwCmkxtD03Q9A: doesn't show hand
*** SUMMARY ***
Total pot $170 | Rake $2
Board [5c Qc 6h As]
Seat 1: voSAIKXtXUUbJnds83sYfQ folded before Flop (didn't bet)
Seat 2: efhcaDPhNqQ/H48kMHLa8w (button) folded on the Turn
Seat 3: I1u3BrIcnPwCmkxtD03Q9A (small blind) collected ($168)
Seat 5: jkH6qYMpn8JA/IyBOhQPMw (big blind) folded before Flop
Seat 6: Xl+I49lxCJwPGRuegiaHoA folded before Flop (didn't bet)



PokerStars Game #59960373650:  Hold'em No Limit ($5/$10) - 2009/07/01 10:52:51 ET
Table '2a86NK3xhs21kwGZmbj0QA' 6-max Seat #4 is the button
Seat 1: NczJqEIUdrpEc5Nbd7h1Ig ($590.50 in chips)
Seat 2: Xl+I49lxCJwPGRuegiaHoA ($2320 in chips)
Seat 3: voSAIKXtXUUbJnds83sYfQ ($1067 in chips)
Seat 4: Lne9leXjEzXWbU3BGFWsxQ ($1288.25 in chips)
Seat 5: jkH6qYMpn8JA/IyBOhQPMw ($1000 in chips)
Seat 6: UcFkfWngu95uR8Jhrj+HrQ ($185 in chips)
jkH6qYMpn8JA/IyBOhQPMw: posts small blind $5
UcFkfWngu95uR8Jhrj+HrQ: posts big blind $10
*** HOLE CARDS ***
NczJqEIUdrpEc5Nbd7h1Ig: calls $10
Xl+I49lxCJwPGRuegiaHoA: folds
voSAIKXtXUUbJnds83sYfQ: folds
Lne9leXjEzXWbU3BGFWsxQ: folds
jkH6qYMpn8JA/IyBOhQPMw said, "run better"
jkH6qYMpn8JA/IyBOhQPMw: folds
UcFkfWngu95uR8Jhrj+HrQ: checks
*** FLOP *** [7h Qh 7s]
UcFkfWngu95uR8Jhrj+HrQ: checks
NczJqEIUdrpEc5Nbd7h1Ig: bets $40
UcFkfWngu95uR8Jhrj+HrQ: folds
NczJqEIUdrpEc5Nbd7h1Ig collected $23.75 from pot
*** SUMMARY ***
Total pot $25 | Rake $1.25
Board [7h Qh 7s]
Seat 1: NczJqEIUdrpEc5Nbd7h1Ig collected ($23.75)
Seat 2: Xl+I49lxCJwPGRuegiaHoA folded before Flop (didn't bet)
Seat 3: voSAIKXtXUUbJnds83sYfQ folded before Flop (didn't bet)
Seat 4: Lne9leXjEzXWbU3BGFWsxQ (button) folded before Flop (didn't bet)
Seat 5: jkH6qYMpn8JA/IyBOhQPMw (small blind) folded before Flop
Seat 6: UcFkfWngu95uR8Jhrj+HrQ (big blind) folded on the Flop



PokerStars Game #59960390938:  Hold'em No Limit ($5/$10) - 2009/07/01 10:53:13 ET
Table '1Dt9cpcLUVE6HYkx5dUEdQ' 6-max Seat #2 is the button
Seat 1: Xl+I49lxCJwPGRuegiaHoA ($1015 in chips)
Seat 2: zdS2zKkZYSRe8p+GVcXMgg ($1320.60 in chips)
Seat 3: Lne9leXjEzXWbU3BGFWsxQ ($1000 in chips)
Seat 4: voSAIKXtXUUbJnds83sYfQ ($1000 in chips)
Seat 5: 7SUIdtQak1SCtldWHjwnFA ($265 in chips)
Seat 6: 3mTlg4g0FJN2bo939h/0Wg ($688 in chips)
Lne9leXjEzXWbU3BGFWsxQ: posts small blind $5
voSAIKXtXUUbJnds83sYfQ: posts big blind $10
*** HOLE CARDS ***
7SUIdtQak1SCtldWHjwnFA: folds
3mTlg4g0FJN2bo939h/0Wg: folds
Xl+I49lxCJwPGRuegiaHoA: raises $20 to $30
zdS2zKkZYSRe8p+GVcXMgg: calls $30
Lne9leXjEzXWbU3BGFWsxQ: folds
voSAIKXtXUUbJnds83sYfQ: folds
*** FLOP *** [5h 3c Qc]
Xl+I49lxCJwPGRuegiaHoA: bets $50
zdS2zKkZYSRe8p+GVcXMgg: calls $50
*** TURN *** [5h 3c Qc] [4s]
Xl+I49lxCJwPGRuegiaHoA: checks
zdS2zKkZYSRe8p+GVcXMgg: bets $60
Xl+I49lxCJwPGRuegiaHoA: folds
zdS2zKkZYSRe8p+GVcXMgg collected $172 from pot
*** SUMMARY ***
Total pot $175 | Rake $3
Board [5h 3c Qc 4s]
Seat 1: Xl+I49lxCJwPGRuegiaHoA folded on the Turn
Seat 2: zdS2zKkZYSRe8p+GVcXMgg (button) collected ($172)
Seat 3: Lne9leXjEzXWbU3BGFWsxQ (small blind) folded before Flop
Seat 4: voSAIKXtXUUbJnds83sYfQ (big blind) folded before Flop
Seat 5: 7SUIdtQak1SCtldWHjwnFA folded before Flop (didn't bet)
Seat 6: 3mTlg4g0FJN2bo939h/0Wg folded before Flop (didn't bet)



PokerStars Game #59960394550:  Hold'em No Limit ($5/$10) - 2009/07/01 10:53:17 ET
Table 'dwLGEw3aoH/cOAI7JsLdmw' 6-max Seat #4 is the button
Seat 2: 7SUIdtQak1SCtldWHjwnFA ($307 in chips)
Seat 3: voSAIKXtXUUbJnds83sYfQ ($1000 in chips)
Seat 4: kykGjpk/IjfbH8Gi6SIm5w ($53 in chips)
Seat 5: g/z/ANylbdR10I7oPCJdKQ ($288 in chips)
Seat 6: 3mTlg4g0FJN2bo939h/0Wg ($389 in chips)
g/z/ANylbdR10I7oPCJdKQ: posts small blind $5
3mTlg4g0FJN2bo939h/0Wg: posts big blind $10
is0C+o+4W8624tMaRmJg7A: sits out
*** HOLE CARDS ***
7SUIdtQak1SCtldWHjwnFA: raises $15 to $25
voSAIKXtXUUbJnds83sYfQ: folds
kykGjpk/IjfbH8Gi6SIm5w: folds
g/z/ANylbdR10I7oPCJdKQ: calls $20
3mTlg4g0FJN2bo939h/0Wg: calls $15
*** FLOP *** [4d 2d 2h]
g/z/ANylbdR10I7oPCJdKQ: checks
3mTlg4g0FJN2bo939h/0Wg: checks
7SUIdtQak1SCtldWHjwnFA: checks
*** TURN *** [4d 2d 2h] [As]
g/z/ANylbdR10I7oPCJdKQ: checks
3mTlg4g0FJN2bo939h/0Wg: checks
7SUIdtQak1SCtldWHjwnFA: checks
*** RIVER *** [4d 2d 2h As] [5h]
g/z/ANylbdR10I7oPCJdKQ: bets $40
3mTlg4g0FJN2bo939h/0Wg: folds
7SUIdtQak1SCtldWHjwnFA: folds
g/z/ANylbdR10I7oPCJdKQ collected $73 from pot
*** SUMMARY ***
Total pot $75 | Rake $2
Board [4d 2d 2h As 5h]
Seat 2: 7SUIdtQak1SCtldWHjwnFA folded on the River
Seat 3: voSAIKXtXUUbJnds83sYfQ folded before Flop (didn't bet)
Seat 4: kykGjpk/IjfbH8Gi6SIm5w (button) folded before Flop (didn't bet)
Seat 5: g/z/ANylbdR10I7oPCJdKQ (small blind) collected ($73)
Seat 6: 3mTlg4g0FJN2bo939h/0Wg (big blind) folded on the River



PokerStars Game #59960405004:  Hold'em No Limit ($5/$10) - 2009/07/01 10:53:30 ET
Table '2a86NK3xhs21kwGZmbj0QA' 6-max Seat #5 is the button
Seat 1: NczJqEIUdrpEc5Nbd7h1Ig ($604.25 in chips)
Seat 2: Xl+I49lxCJwPGRuegiaHoA ($2320 in chips)
Seat 3: voSAIKXtXUUbJnds83sYfQ ($1067 in chips)
Seat 4: Lne9leXjEzXWbU3BGFWsxQ ($1288.25 in chips)
Seat 5: jkH6qYMpn8JA/IyBOhQPMw ($1000 in chips)
Seat 6: UcFkfWngu95uR8Jhrj+HrQ ($175 in chips)
UcFkfWngu95uR8Jhrj+HrQ: posts small blind $5
NczJqEIUdrpEc5Nbd7h1Ig: posts big blind $10
*** HOLE CARDS ***
Xl+I49lxCJwPGRuegiaHoA said, "how is -40kin 15 days for u?"
Xl+I49lxCJwPGRuegiaHoA: folds
voSAIKXtXUUbJnds83sYfQ: folds
Lne9leXjEzXWbU3BGFWsxQ: folds
jkH6qYMpn8JA/IyBOhQPMw: raises $20 to $30
UcFkfWngu95uR8Jhrj+HrQ: folds
NczJqEIUdrpEc5Nbd7h1Ig: calls $20
*** FLOP *** [Js 3h 8h]
NczJqEIUdrpEc5Nbd7h1Ig: checks
jkH6qYMpn8JA/IyBOhQPMw: bets $52
NczJqEIUdrpEc5Nbd7h1Ig: folds
jkH6qYMpn8JA/IyBOhQPMw collected $62 from pot
jkH6qYMpn8JA/IyBOhQPMw: doesn't show hand
*** SUMMARY ***
Total pot $65 | Rake $3
Board [Js 3h 8h]
Seat 1: NczJqEIUdrpEc5Nbd7h1Ig (big blind) folded on the Flop
Seat 2: Xl+I49lxCJwPGRuegiaHoA folded before Flop (didn't bet)
Seat 3: voSAIKXtXUUbJnds83sYfQ folded before Flop (didn't bet)
Seat 4: Lne9leXjEzXWbU3BGFWsxQ folded before Flop (didn't bet)
Seat 5: jkH6qYMpn8JA/IyBOhQPMw (button) collected ($62)
Seat 6: UcFkfWngu95uR8Jhrj+HrQ (small blind) folded before Flop



PokerStars Game #59960419916:  Hold'em No Limit ($5/$10) - 2009/07/01 10:53:48 ET
Table 'AiNa6yyp/njJVRYl/Lz1KQ' 6-max Seat #3 is the button
Seat 1: voSAIKXtXUUbJnds83sYfQ ($1090 in chips)
Seat 2: efhcaDPhNqQ/H48kMHLa8w ($1000 in chips)
Seat 3: I1u3BrIcnPwCmkxtD03Q9A ($574 in chips)
Seat 5: jkH6qYMpn8JA/IyBOhQPMw ($1048 in chips)
Seat 6: Xl+I49lxCJwPGRuegiaHoA ($1183 in chips)
W5z+iP++AH0RC/BH7RB+Fg will be allowed to play after the button
jkH6qYMpn8JA/IyBOhQPMw: posts small blind $5
Xl+I49lxCJwPGRuegiaHoA: posts big blind $10
*** HOLE CARDS ***
voSAIKXtXUUbJnds83sYfQ: folds
efhcaDPhNqQ/H48kMHLa8w: folds
I1u3BrIcnPwCmkxtD03Q9A: raises $20 to $30
jkH6qYMpn8JA/IyBOhQPMw: folds
Xl+I49lxCJwPGRuegiaHoA: folds
I1u3BrIcnPwCmkxtD03Q9A collected $25 from pot
I1u3BrIcnPwCmkxtD03Q9A: doesn't show hand
*** SUMMARY ***
Total pot $25 | Rake $0
Seat 1: voSAIKXtXUUbJnds83sYfQ folded before Flop (didn't bet)
Seat 2: efhcaDPhNqQ/H48kMHLa8w folded before Flop (didn't bet)
Seat 3: I1u3BrIcnPwCmkxtD03Q9A (button) collected ($25)
Seat 5: jkH6qYMpn8JA/IyBOhQPMw (small blind) folded before Flop
Seat 6: Xl+I49lxCJwPGRuegiaHoA (big blind) folded before Flop



PokerStars Game #59960428658:  Hold'em No Limit ($5/$10) - 2009/07/01 10:53:59 ET
Table 'dwLGEw3aoH/cOAI7JsLdmw' 6-max Seat #5 is the button
Seat 1: is0C+o+4W8624tMaRmJg7A ($1000 in chips)
Seat 2: 7SUIdtQak1SCtldWHjwnFA ($282 in chips)
Seat 3: voSAIKXtXUUbJnds83sYfQ ($1000 in chips)
Seat 4: kykGjpk/IjfbH8Gi6SIm5w ($53 in chips)
Seat 5: g/z/ANylbdR10I7oPCJdKQ ($336 in chips)
Seat 6: 3mTlg4g0FJN2bo939h/0Wg ($364 in chips)
3mTlg4g0FJN2bo939h/0Wg: posts small blind $5
is0C+o+4W8624tMaRmJg7A: posts big blind $10
*** HOLE CARDS ***
7SUIdtQak1SCtldWHjwnFA: folds
voSAIKXtXUUbJnds83sYfQ: folds
kykGjpk/IjfbH8Gi6SIm5w: raises $43 to $53 and is all-in
g/z/ANylbdR10I7oPCJdKQ: folds
3mTlg4g0FJN2bo939h/0Wg: folds
is0C+o+4W8624tMaRmJg7A: folds
kykGjpk/IjfbH8Gi6SIm5w collected $25 from pot
*** SUMMARY ***
Total pot $25 | Rake $0
Seat 1: is0C+o+4W8624tMaRmJg7A (big blind) folded before Flop
Seat 2: 7SUIdtQak1SCtldWHjwnFA folded before Flop (didn't bet)
Seat 3: voSAIKXtXUUbJnds83sYfQ folded before Flop (didn't bet)
Seat 4: kykGjpk/IjfbH8Gi6SIm5w collected ($25)
Seat 5: g/z/ANylbdR10I7oPCJdKQ (button) folded before Flop (didn't bet)
Seat 6: 3mTlg4g0FJN2bo939h/0Wg (small blind) folded before Flop



PokerStars Game #59960433800:  Hold'em No Limit ($5/$10) - 2009/07/01 10:54:05 ET
Table 'AiNa6yyp/njJVRYl/Lz1KQ' 6-max Seat #5 is the button
Seat 1: voSAIKXtXUUbJnds83sYfQ ($1090 in chips)
Seat 2: efhcaDPhNqQ/H48kMHLa8w ($1000 in chips)
Seat 3: I1u3BrIcnPwCmkxtD03Q9A ($589 in chips)
Seat 5: jkH6qYMpn8JA/IyBOhQPMw ($1043 in chips)
Seat 6: Xl+I49lxCJwPGRuegiaHoA ($1173 in chips)
Xl+I49lxCJwPGRuegiaHoA: posts small blind $5
voSAIKXtXUUbJnds83sYfQ: posts big blind $10
W5z+iP++AH0RC/BH7RB+Fg: sits out
*** HOLE CARDS ***
efhcaDPhNqQ/H48kMHLa8w: raises $20 to $30
I1u3BrIcnPwCmkxtD03Q9A: folds
jkH6qYMpn8JA/IyBOhQPMw: folds
Xl+I49lxCJwPGRuegiaHoA: folds
voSAIKXtXUUbJnds83sYfQ: folds
efhcaDPhNqQ/H48kMHLa8w collected $25 from pot
efhcaDPhNqQ/H48kMHLa8w: doesn't show hand
*** SUMMARY ***
Total pot $25 | Rake $0
Seat 1: voSAIKXtXUUbJnds83sYfQ (big blind) folded before Flop
Seat 2: efhcaDPhNqQ/H48kMHLa8w collected ($25)
Seat 3: I1u3BrIcnPwCmkxtD03Q9A folded before Flop (didn't bet)
Seat 5: jkH6qYMpn8JA/IyBOhQPMw (button) folded before Flop (didn't bet)
Seat 6: Xl+I49lxCJwPGRuegiaHoA (small blind) folded before Flop



PokerStars Game #59960445794:  Hold'em No Limit ($5/$10) - 2009/07/01 10:54:20 ET
Table '2a86NK3xhs21kwGZmbj0QA' 6-max Seat #6 is the button
Seat 1: NczJqEIUdrpEc5Nbd7h1Ig ($574.25 in chips)
Seat 2: Xl+I49lxCJwPGRuegiaHoA ($2320 in chips)
Seat 3: voSAIKXtXUUbJnds83sYfQ ($1067 in chips)
Seat 4: Lne9leXjEzXWbU3BGFWsxQ ($1288.25 in chips)
Seat 5: jkH6qYMpn8JA/IyBOhQPMw ($1032 in chips)
Seat 6: UcFkfWngu95uR8Jhrj+HrQ ($170 in chips)
NczJqEIUdrpEc5Nbd7h1Ig: posts small blind $5
Xl+I49lxCJwPGRuegiaHoA: posts big blind $10
*** HOLE CARDS ***
voSAIKXtXUUbJnds83sYfQ: folds
Lne9leXjEzXWbU3BGFWsxQ: folds
jkH6qYMpn8JA/IyBOhQPMw: raises $20 to $30
UcFkfWngu95uR8Jhrj+HrQ: folds
NczJqEIUdrpEc5Nbd7h1Ig: calls $25
Xl+I49lxCJwPGRuegiaHoA: folds
*** FLOP *** [2s Tc As]
NczJqEIUdrpEc5Nbd7h1Ig: checks
jkH6qYMpn8JA/IyBOhQPMw said, "seems standard"
jkH6qYMpn8JA/IyBOhQPMw: checks
*** TURN *** [2s Tc As] [8c]
NczJqEIUdrpEc5Nbd7h1Ig: bets $30
jkH6qYMpn8JA/IyBOhQPMw: calls $30
*** RIVER *** [2s Tc As 8c] [Qs]
NczJqEIUdrpEc5Nbd7h1Ig: bets $100
jkH6qYMpn8JA/IyBOhQPMw: folds
NczJqEIUdrpEc5Nbd7h1Ig collected $127 from pot
*** SUMMARY ***
Total pot $130 | Rake $3
Board [2s Tc As 8c Qs]
Seat 1: NczJqEIUdrpEc5Nbd7h1Ig (small blind) collected ($127)
Seat 2: Xl+I49lxCJwPGRuegiaHoA (big blind) folded before Flop
Seat 3: voSAIKXtXUUbJnds83sYfQ folded before Flop (didn't bet)
Seat 4: Lne9leXjEzXWbU3BGFWsxQ folded before Flop (didn't bet)
Seat 5: jkH6qYMpn8JA/IyBOhQPMw folded on the River
Seat 6: UcFkfWngu95uR8Jhrj+HrQ (button) folded before Flop (didn't bet)



PokerStars Game #59960455818:  Hold'em No Limit ($5/$10) - 2009/07/01 10:54:33 ET
Table 'AiNa6yyp/njJVRYl/Lz1KQ' 6-max Seat #6 is the button
Seat 1: voSAIKXtXUUbJnds83sYfQ ($1080 in chips)
Seat 2: efhcaDPhNqQ/H48kMHLa8w ($1015 in chips)
Seat 3: I1u3BrIcnPwCmkxtD03Q9A ($589 in chips)
Seat 5: jkH6qYMpn8JA/IyBOhQPMw ($1043 in chips)
Seat 6: Xl+I49lxCJwPGRuegiaHoA ($1168 in chips)
voSAIKXtXUUbJnds83sYfQ: posts small blind $5
efhcaDPhNqQ/H48kMHLa8w: posts big blind $10
W5z+iP++AH0RC/BH7RB+Fg: sits out
*** HOLE CARDS ***
I1u3BrIcnPwCmkxtD03Q9A: folds
jkH6qYMpn8JA/IyBOhQPMw: raises $20 to $30
Xl+I49lxCJwPGRuegiaHoA: folds
voSAIKXtXUUbJnds83sYfQ: folds
efhcaDPhNqQ/H48kMHLa8w: folds
jkH6qYMpn8JA/IyBOhQPMw collected $25 from pot
jkH6qYMpn8JA/IyBOhQPMw: doesn't show hand
*** SUMMARY ***
Total pot $25 | Rake $0
Seat 1: voSAIKXtXUUbJnds83sYfQ (small blind) folded before Flop
Seat 2: efhcaDPhNqQ/H48kMHLa8w (big blind) folded before Flop
Seat 3: I1u3BrIcnPwCmkxtD03Q9A folded before Flop (didn't bet)
Seat 5: jkH6qYMpn8JA/IyBOhQPMw collected ($25)
Seat 6: Xl+I49lxCJwPGRuegiaHoA (button) folded before Flop (didn't bet)



PokerStars Game #59960456902:  Hold'em No Limit ($5/$10) - 2009/07/01 10:54:35 ET
Table 'dwLGEw3aoH/cOAI7JsLdmw' 6-max Seat #6 is the button
Seat 1: is0C+o+4W8624tMaRmJg7A ($1000 in chips)
Seat 2: 7SUIdtQak1SCtldWHjwnFA ($282 in chips)
Seat 3: voSAIKXtXUUbJnds83sYfQ ($1000 in chips)
Seat 4: kykGjpk/IjfbH8Gi6SIm5w ($68 in chips)
Seat 5: g/z/ANylbdR10I7oPCJdKQ ($336 in chips)
Seat 6: 3mTlg4g0FJN2bo939h/0Wg ($359 in chips)
is0C+o+4W8624tMaRmJg7A: posts small blind $5
7SUIdtQak1SCtldWHjwnFA: posts big blind $10
*** HOLE CARDS ***
voSAIKXtXUUbJnds83sYfQ: folds
kykGjpk/IjfbH8Gi6SIm5w: folds
g/z/ANylbdR10I7oPCJdKQ: folds
3mTlg4g0FJN2bo939h/0Wg: raises $20 to $30
is0C+o+4W8624tMaRmJg7A: folds
7SUIdtQak1SCtldWHjwnFA: calls $20
*** FLOP *** [Kd 2s Kc]
7SUIdtQak1SCtldWHjwnFA: checks
3mTlg4g0FJN2bo939h/0Wg: checks
*** TURN *** [Kd 2s Kc] [Qh]
7SUIdtQak1SCtldWHjwnFA: checks
3mTlg4g0FJN2bo939h/0Wg: bets $30
7SUIdtQak1SCtldWHjwnFA: calls $30
*** RIVER *** [Kd 2s Kc Qh] [7s]
7SUIdtQak1SCtldWHjwnFA: checks
3mTlg4g0FJN2bo939h/0Wg: bets $100
7SUIdtQak1SCtldWHjwnFA: folds
3mTlg4g0FJN2bo939h/0Wg collected $122 from pot
*** SUMMARY ***
Total pot $125 | Rake $3
Board [Kd 2s Kc Qh 7s]
Seat 1: is0C+o+4W8624tMaRmJg7A (small blind) folded before Flop
Seat 2: 7SUIdtQak1SCtldWHjwnFA (big blind) folded on the River
Seat 3: voSAIKXtXUUbJnds83sYfQ folded before Flop (didn't bet)
Seat 4: kykGjpk/IjfbH8Gi6SIm5w folded before Flop (didn't bet)
Seat 5: g/z/ANylbdR10I7oPCJdKQ folded before Flop (didn't bet)
Seat 6: 3mTlg4g0FJN2bo939h/0Wg (button) collected ($122)



PokerStars Game #59960463530:  Hold'em No Limit ($5/$10) - 2009/07/01 10:54:43 ET
Table '1Dt9cpcLUVE6HYkx5dUEdQ' 6-max Seat #3 is the button
Seat 1: Xl+I49lxCJwPGRuegiaHoA ($1000 in chips)
Seat 2: zdS2zKkZYSRe8p+GVcXMgg ($1412.60 in chips)
Seat 3: Lne9leXjEzXWbU3BGFWsxQ ($1000 in chips)
Seat 4: voSAIKXtXUUbJnds83sYfQ ($1000 in chips)
Seat 5: 7SUIdtQak1SCtldWHjwnFA ($265 in chips)
Seat 6: 3mTlg4g0FJN2bo939h/0Wg ($688 in chips)
voSAIKXtXUUbJnds83sYfQ: posts small blind $5
7SUIdtQak1SCtldWHjwnFA: posts big blind $10
*** HOLE CARDS ***
3mTlg4g0FJN2bo939h/0Wg: folds
Xl+I49lxCJwPGRuegiaHoA: raises $20 to $30
zdS2zKkZYSRe8p+GVcXMgg: calls $30
Lne9leXjEzXWbU3BGFWsxQ: folds
voSAIKXtXUUbJnds83sYfQ: folds
7SUIdtQak1SCtldWHjwnFA: raises $235 to $265 and is all-in
Xl+I49lxCJwPGRuegiaHoA: folds
zdS2zKkZYSRe8p+GVcXMgg: folds
7SUIdtQak1SCtldWHjwnFA collected $95 from pot
*** SUMMARY ***
Total pot $95 | Rake $0
Seat 1: Xl+I49lxCJwPGRuegiaHoA folded before Flop
Seat 2: zdS2zKkZYSRe8p+GVcXMgg folded before Flop
Seat 3: Lne9leXjEzXWbU3BGFWsxQ (button) folded before Flop (didn't bet)
Seat 4: voSAIKXtXUUbJnds83sYfQ (small blind) folded before Flop
Seat 5: 7SUIdtQak1SCtldWHjwnFA (big blind) collected ($95)
Seat 6: 3mTlg4g0FJN2bo939h/0Wg folded before Flop (didn't bet)



PokerStars Game #59960472084:  Hold'em No Limit ($5/$10) - 2009/07/01 10:54:54 ET
Table 'AiNa6yyp/njJVRYl/Lz1KQ' 6-max Seat #1 is the button
Seat 1: voSAIKXtXUUbJnds83sYfQ ($1075 in chips)
Seat 2: efhcaDPhNqQ/H48kMHLa8w ($1005 in chips)
Seat 3: I1u3BrIcnPwCmkxtD03Q9A ($589 in chips)
Seat 5: jkH6qYMpn8JA/IyBOhQPMw ($1058 in chips)
Seat 6: Xl+I49lxCJwPGRuegiaHoA ($1168 in chips)
efhcaDPhNqQ/H48kMHLa8w: posts small blind $5
I1u3BrIcnPwCmkxtD03Q9A: posts big blind $10
W5z+iP++AH0RC/BH7RB+Fg: sits out
*** HOLE CARDS ***
jkH6qYMpn8JA/IyBOhQPMw: folds
Xl+I49lxCJwPGRuegiaHoA: folds
voSAIKXtXUUbJnds83sYfQ: raises $20 to $30
efhcaDPhNqQ/H48kMHLa8w: folds
I1u3BrIcnPwCmkxtD03Q9A: folds
voSAIKXtXUUbJnds83sYfQ collected $25 from pot
voSAIKXtXUUbJnds83sYfQ: doesn't show hand
*** SUMMARY ***
Total pot $25 | Rake $0
Seat 1: voSAIKXtXUUbJnds83sYfQ (button) collected ($25)
Seat 2: efhcaDPhNqQ/H48kMHLa8w (small blind) folded before Flop
Seat 3: I1u3BrIcnPwCmkxtD03Q9A (big blind) folded before Flop
Seat 5: jkH6qYMpn8JA/IyBOhQPMw folded before Flop (didn't bet)
Seat 6: Xl+I49lxCJwPGRuegiaHoA folded before Flop (didn't bet)



PokerStars Game #59960480820:  Hold'em No Limit ($5/$10) - 2009/07/01 10:55:04 ET
Table '2a86NK3xhs21kwGZmbj0QA' 6-max Seat #1 is the button
Seat 1: NczJqEIUdrpEc5Nbd7h1Ig ($641.25 in chips)
Seat 2: Xl+I49lxCJwPGRuegiaHoA ($2310 in chips)
Seat 3: voSAIKXtXUUbJnds83sYfQ ($1067 in chips)
Seat 4: Lne9leXjEzXWbU3BGFWsxQ ($1288.25 in chips)
Seat 5: jkH6qYMpn8JA/IyBOhQPMw ($1000 in chips)
Seat 6: UcFkfWngu95uR8Jhrj+HrQ ($170 in chips)
Xl+I49lxCJwPGRuegiaHoA: posts small blind $5
voSAIKXtXUUbJnds83sYfQ: posts big blind $10
*** HOLE CARDS ***
Lne9leXjEzXWbU3BGFWsxQ: folds
jkH6qYMpn8JA/IyBOhQPMw: folds
UcFkfWngu95uR8Jhrj+HrQ: raises $10 to $20
NczJqEIUdrpEc5Nbd7h1Ig: calls $20
Xl+I49lxCJwPGRuegiaHoA: calls $15
voSAIKXtXUUbJnds83sYfQ: calls $10
*** FLOP *** [2c 9s 8h]
Xl+I49lxCJwPGRuegiaHoA: bets $50
voSAIKXtXUUbJnds83sYfQ: folds
UcFkfWngu95uR8Jhrj+HrQ: raises $100 to $150 and is all-in
NczJqEIUdrpEc5Nbd7h1Ig: folds
Xl+I49lxCJwPGRuegiaHoA: calls $100
*** TURN *** [2c 9s 8h] [Ah]
*** RIVER *** [2c 9s 8h Ah] [7d]
*** SHOW DOWN ***
Xl+I49lxCJwPGRuegiaHoA: shows [2s 2h] (three of a kind, Deuces)
UcFkfWngu95uR8Jhrj+HrQ: shows [Th Jh] (a straight, Seven to Jack)
UcFkfWngu95uR8Jhrj+HrQ collected $377 from pot
*** SUMMARY ***
Total pot $380 | Rake $3
Board [2c 9s 8h Ah 7d]
Seat 1: NczJqEIUdrpEc5Nbd7h1Ig (button) folded on the Flop
Seat 2: Xl+I49lxCJwPGRuegiaHoA (small blind) showed [2s 2h] and lost with three of a kind, Deuces
Seat 3: voSAIKXtXUUbJnds83sYfQ (big blind) folded on the Flop
Seat 4: Lne9leXjEzXWbU3BGFWsxQ folded before Flop (didn't bet)
Seat 5: jkH6qYMpn8JA/IyBOhQPMw folded before Flop (didn't bet)
Seat 6: UcFkfWngu95uR8Jhrj+HrQ showed [Th Jh] and won ($377) with a straight, Seven to Jack



PokerStars Game #59960485514:  Hold'em No Limit ($5/$10) - 2009/07/01 10:55:10 ET
Table '1Dt9cpcLUVE6HYkx5dUEdQ' 6-max Seat #4 is the button
Seat 1: Xl+I49lxCJwPGRuegiaHoA ($1000 in chips)
Seat 2: zdS2zKkZYSRe8p+GVcXMgg ($1382.60 in chips)
Seat 3: Lne9leXjEzXWbU3BGFWsxQ ($1000 in chips)
Seat 4: voSAIKXtXUUbJnds83sYfQ ($1000 in chips)
Seat 5: 7SUIdtQak1SCtldWHjwnFA ($330 in chips)
Seat 6: 3mTlg4g0FJN2bo939h/0Wg ($688 in chips)
7SUIdtQak1SCtldWHjwnFA: posts small blind $5
3mTlg4g0FJN2bo939h/0Wg: posts big blind $10
*** HOLE CARDS ***
Xl+I49lxCJwPGRuegiaHoA: folds
zdS2zKkZYSRe8p+GVcXMgg: raises $20 to $30
Lne9leXjEzXWbU3BGFWsxQ: folds
voSAIKXtXUUbJnds83sYfQ: folds
7SUIdtQak1SCtldWHjwnFA: folds
3mTlg4g0FJN2bo939h/0Wg: calls $20
*** FLOP *** [Jc Td 4c]
3mTlg4g0FJN2bo939h/0Wg: checks
zdS2zKkZYSRe8p+GVcXMgg: bets $60
3mTlg4g0FJN2bo939h/0Wg: folds
zdS2zKkZYSRe8p+GVcXMgg collected $62 from pot
*** SUMMARY ***
Total pot $65 | Rake $3
Board [Jc Td 4c]
Seat 1: Xl+I49lxCJwPGRuegiaHoA folded before Flop (didn't bet)
Seat 2: zdS2zKkZYSRe8p+GVcXMgg collected ($62)
Seat 3: Lne9leXjEzXWbU3BGFWsxQ folded before Flop (didn't bet)
Seat 4: voSAIKXtXUUbJnds83sYfQ (button) folded before Flop (didn't bet)
Seat 5: 7SUIdtQak1SCtldWHjwnFA (small blind) folded before Flop
Seat 6: 3mTlg4g0FJN2bo939h/0Wg (big blind) folded on the Flop



PokerStars Game #59960491368:  Hold'em No Limit ($5/$10) - 2009/07/01 10:55:17 ET
Table 'AiNa6yyp/njJVRYl/Lz1KQ' 6-max Seat #2 is the button
Seat 1: voSAIKXtXUUbJnds83sYfQ ($1090 in chips)
Seat 2: efhcaDPhNqQ/H48kMHLa8w ($1000 in chips)
Seat 3: I1u3BrIcnPwCmkxtD03Q9A ($579 in chips)
Seat 4: W5z+iP++AH0RC/BH7RB+Fg ($205.90 in chips)
Seat 5: jkH6qYMpn8JA/IyBOhQPMw ($1058 in chips)
Seat 6: Xl+I49lxCJwPGRuegiaHoA ($1168 in chips)
I1u3BrIcnPwCmkxtD03Q9A: posts small blind $5
W5z+iP++AH0RC/BH7RB+Fg: posts big blind $10
*** HOLE CARDS ***
jkH6qYMpn8JA/IyBOhQPMw: folds
Xl+I49lxCJwPGRuegiaHoA: raises $20 to $30
voSAIKXtXUUbJnds83sYfQ: folds
efhcaDPhNqQ/H48kMHLa8w: folds
I1u3BrIcnPwCmkxtD03Q9A: raises $40 to $70
W5z+iP++AH0RC/BH7RB+Fg: folds
Xl+I49lxCJwPGRuegiaHoA: folds
I1u3BrIcnPwCmkxtD03Q9A collected $70 from pot
I1u3BrIcnPwCmkxtD03Q9A: doesn't show hand
*** SUMMARY ***
Total pot $70 | Rake $0
Seat 1: voSAIKXtXUUbJnds83sYfQ folded before Flop (didn't bet)
Seat 2: efhcaDPhNqQ/H48kMHLa8w (button) folded before Flop (didn't bet)
Seat 3: I1u3BrIcnPwCmkxtD03Q9A (small blind) collected ($70)
Seat 4: W5z+iP++AH0RC/BH7RB+Fg (big blind) folded before Flop
Seat 5: jkH6qYMpn8JA/IyBOhQPMw folded before Flop (didn't bet)
Seat 6: Xl+I49lxCJwPGRuegiaHoA folded before Flop



PokerStars Game #59960519788:  Hold'em No Limit ($5/$10) - 2009/07/01 10:55:52 ET
Table 'dwLGEw3aoH/cOAI7JsLdmw' 6-max Seat #1 is the button
Seat 1: is0C+o+4W8624tMaRmJg7A ($1000 in chips)
Seat 2: 7SUIdtQak1SCtldWHjwnFA ($222 in chips)
Seat 3: voSAIKXtXUUbJnds83sYfQ ($1000 in chips)
Seat 4: kykGjpk/IjfbH8Gi6SIm5w ($68 in chips)
Seat 5: g/z/ANylbdR10I7oPCJdKQ ($336 in chips)
Seat 6: 3mTlg4g0FJN2bo939h/0Wg ($421 in chips)
7SUIdtQak1SCtldWHjwnFA: posts small blind $5
voSAIKXtXUUbJnds83sYfQ: posts big blind $10
*** HOLE CARDS ***
kykGjpk/IjfbH8Gi6SIm5w: folds
g/z/ANylbdR10I7oPCJdKQ: folds
3mTlg4g0FJN2bo939h/0Wg: folds
is0C+o+4W8624tMaRmJg7A: folds
7SUIdtQak1SCtldWHjwnFA: folds
voSAIKXtXUUbJnds83sYfQ collected $10 from pot
*** SUMMARY ***
Total pot $10 | Rake $0
Seat 1: is0C+o+4W8624tMaRmJg7A (button) folded before Flop (didn't bet)
Seat 2: 7SUIdtQak1SCtldWHjwnFA (small blind) folded before Flop
Seat 3: voSAIKXtXUUbJnds83sYfQ (big blind) collected ($10)
Seat 4: kykGjpk/IjfbH8Gi6SIm5w folded before Flop (didn't bet)
Seat 5: g/z/ANylbdR10I7oPCJdKQ folded before Flop (didn't bet)
Seat 6: 3mTlg4g0FJN2bo939h/0Wg folded before Flop (didn't bet)



PokerStars Game #59960519904:  Hold'em No Limit ($5/$10) - 2009/07/01 10:55:53 ET
Table 'AiNa6yyp/njJVRYl/Lz1KQ' 6-max Seat #3 is the button
Seat 1: voSAIKXtXUUbJnds83sYfQ ($1090 in chips)
Seat 2: efhcaDPhNqQ/H48kMHLa8w ($1000 in chips)
Seat 3: I1u3BrIcnPwCmkxtD03Q9A ($619 in chips)
Seat 4: W5z+iP++AH0RC/BH7RB+Fg ($195.90 in chips)
Seat 5: jkH6qYMpn8JA/IyBOhQPMw ($1058 in chips)
Seat 6: Xl+I49lxCJwPGRuegiaHoA ($1138 in chips)
W5z+iP++AH0RC/BH7RB+Fg: posts small blind $5
jkH6qYMpn8JA/IyBOhQPMw: posts big blind $10
*** HOLE CARDS ***
Xl+I49lxCJwPGRuegiaHoA: folds
voSAIKXtXUUbJnds83sYfQ: raises $20 to $30
efhcaDPhNqQ/H48kMHLa8w: calls $30
I1u3BrIcnPwCmkxtD03Q9A: folds
W5z+iP++AH0RC/BH7RB+Fg: raises $50 to $80
jkH6qYMpn8JA/IyBOhQPMw: folds
voSAIKXtXUUbJnds83sYfQ: folds
efhcaDPhNqQ/H48kMHLa8w: raises $920 to $1000 and is all-in
W5z+iP++AH0RC/BH7RB+Fg: calls $115.90 and is all-in
*** FLOP *** [8c 5h 8h]
*** TURN *** [8c 5h 8h] [Qh]
*** RIVER *** [8c 5h 8h Qh] [Kd]
*** SHOW DOWN ***
W5z+iP++AH0RC/BH7RB+Fg: shows [Jc Qc] (two pair, Queens and Eights)
efhcaDPhNqQ/H48kMHLa8w: shows [As Qd] (two pair, Queens and Eights - Ace kicker)
efhcaDPhNqQ/H48kMHLa8w collected $428.80 from pot
*** SUMMARY ***
Total pot $431.80 | Rake $3
Board [8c 5h 8h Qh Kd]
Seat 1: voSAIKXtXUUbJnds83sYfQ folded before Flop
Seat 2: efhcaDPhNqQ/H48kMHLa8w showed [As Qd] and won ($428.80) with two pair, Queens and Eights
Seat 3: I1u3BrIcnPwCmkxtD03Q9A (button) folded before Flop (didn't bet)
Seat 4: W5z+iP++AH0RC/BH7RB+Fg (small blind) showed [Jc Qc] and lost with two pair, Queens and Eights
Seat 5: jkH6qYMpn8JA/IyBOhQPMw (big blind) folded before Flop
Seat 6: Xl+I49lxCJwPGRuegiaHoA folded before Flop (didn't bet)



PokerStars Game #59960529520:  Hold'em No Limit ($5/$10) - 2009/07/01 10:56:04 ET
Table '2a86NK3xhs21kwGZmbj0QA' 6-max Seat #2 is the button
Seat 1: NczJqEIUdrpEc5Nbd7h1Ig ($621.25 in chips)
Seat 2: Xl+I49lxCJwPGRuegiaHoA ($2140 in chips)
Seat 3: voSAIKXtXUUbJnds83sYfQ ($1047 in chips)
Seat 4: Lne9leXjEzXWbU3BGFWsxQ ($1288.25 in chips)
Seat 5: jkH6qYMpn8JA/IyBOhQPMw ($1000 in chips)
Seat 6: UcFkfWngu95uR8Jhrj+HrQ ($377 in chips)
voSAIKXtXUUbJnds83sYfQ: posts small blind $5
Lne9leXjEzXWbU3BGFWsxQ: posts big blind $10
*** HOLE CARDS ***
jkH6qYMpn8JA/IyBOhQPMw: raises $20 to $30
UcFkfWngu95uR8Jhrj+HrQ: folds
NczJqEIUdrpEc5Nbd7h1Ig: calls $30
Xl+I49lxCJwPGRuegiaHoA: folds
voSAIKXtXUUbJnds83sYfQ: folds
Lne9leXjEzXWbU3BGFWsxQ: folds
*** FLOP *** [Ts 7h Qd]
jkH6qYMpn8JA/IyBOhQPMw: bets $52
NczJqEIUdrpEc5Nbd7h1Ig: calls $52
*** TURN *** [Ts 7h Qd] [As]
jkH6qYMpn8JA/IyBOhQPMw: bets $142
NczJqEIUdrpEc5Nbd7h1Ig: folds
jkH6qYMpn8JA/IyBOhQPMw collected $176 from pot
jkH6qYMpn8JA/IyBOhQPMw: doesn't show hand
*** SUMMARY ***
Total pot $179 | Rake $3
Board [Ts 7h Qd As]
Seat 1: NczJqEIUdrpEc5Nbd7h1Ig folded on the Turn
Seat 2: Xl+I49lxCJwPGRuegiaHoA (button) folded before Flop (didn't bet)
Seat 3: voSAIKXtXUUbJnds83sYfQ (small blind) folded before Flop
Seat 4: Lne9leXjEzXWbU3BGFWsxQ (big blind) folded before Flop
Seat 5: jkH6qYMpn8JA/IyBOhQPMw collected ($176)
Seat 6: UcFkfWngu95uR8Jhrj+HrQ folded before Flop (didn't bet)



PokerStars Game #59960535006:  Hold'em No Limit ($5/$10) - 2009/07/01 10:56:11 ET
Table '1Dt9cpcLUVE6HYkx5dUEdQ' 6-max Seat #5 is the button
Seat 1: Xl+I49lxCJwPGRuegiaHoA ($1000 in chips)
Seat 2: zdS2zKkZYSRe8p+GVcXMgg ($1414.60 in chips)
Seat 3: Lne9leXjEzXWbU3BGFWsxQ ($1000 in chips)
Seat 4: voSAIKXtXUUbJnds83sYfQ ($1000 in chips)
Seat 5: 7SUIdtQak1SCtldWHjwnFA ($325 in chips)
Seat 6: 3mTlg4g0FJN2bo939h/0Wg ($658 in chips)
3mTlg4g0FJN2bo939h/0Wg: posts small blind $5
Xl+I49lxCJwPGRuegiaHoA: posts big blind $10
*** HOLE CARDS ***
zdS2zKkZYSRe8p+GVcXMgg: folds
Lne9leXjEzXWbU3BGFWsxQ: folds
voSAIKXtXUUbJnds83sYfQ: folds
7SUIdtQak1SCtldWHjwnFA: raises $20 to $30
3mTlg4g0FJN2bo939h/0Wg: calls $25
Xl+I49lxCJwPGRuegiaHoA: folds
*** FLOP *** [6d 2d 7s]
3mTlg4g0FJN2bo939h/0Wg: bets $30
7SUIdtQak1SCtldWHjwnFA: raises $69 to $99
3mTlg4g0FJN2bo939h/0Wg: calls $69
*** TURN *** [6d 2d 7s] [5d]
3mTlg4g0FJN2bo939h/0Wg: bets $200
7SUIdtQak1SCtldWHjwnFA: calls $196 and is all-in
*** RIVER *** [6d 2d 7s 5d] [7c]
*** SHOW DOWN ***
3mTlg4g0FJN2bo939h/0Wg: shows [7h Js] (three of a kind, Sevens)
7SUIdtQak1SCtldWHjwnFA: mucks hand
3mTlg4g0FJN2bo939h/0Wg collected $657 from pot
*** SUMMARY ***
Total pot $660 | Rake $3
Board [6d 2d 7s 5d 7c]
Seat 1: Xl+I49lxCJwPGRuegiaHoA (big blind) folded before Flop
Seat 2: zdS2zKkZYSRe8p+GVcXMgg folded before Flop (didn't bet)
Seat 3: Lne9leXjEzXWbU3BGFWsxQ folded before Flop (didn't bet)
Seat 4: voSAIKXtXUUbJnds83sYfQ folded before Flop (didn't bet)
Seat 5: 7SUIdtQak1SCtldWHjwnFA (button) mucked
Seat 6: 3mTlg4g0FJN2bo939h/0Wg (small blind) showed [7h Js] and won ($657) with three of a kind, Sevens



PokerStars Game #59960534928:  Hold'em No Limit ($5/$10) - 2009/07/01 10:56:11 ET
Table 'dwLGEw3aoH/cOAI7JsLdmw' 6-max Seat #2 is the button
Seat 1: is0C+o+4W8624tMaRmJg7A ($1000 in chips)
Seat 2: 7SUIdtQak1SCtldWHjwnFA ($217 in chips)
Seat 3: voSAIKXtXUUbJnds83sYfQ ($1005 in chips)
Seat 4: kykGjpk/IjfbH8Gi6SIm5w ($68 in chips)
Seat 5: g/z/ANylbdR10I7oPCJdKQ ($336 in chips)
Seat 6: 3mTlg4g0FJN2bo939h/0Wg ($421 in chips)
voSAIKXtXUUbJnds83sYfQ: posts small blind $5
kykGjpk/IjfbH8Gi6SIm5w: posts big blind $10
*** HOLE CARDS ***
g/z/ANylbdR10I7oPCJdKQ: folds
3mTlg4g0FJN2bo939h/0Wg: folds
g/z/ANylbdR10I7oPCJdKQ is sitting out
is0C+o+4W8624tMaRmJg7A: folds
7SUIdtQak1SCtldWHjwnFA: folds
voSAIKXtXUUbJnds83sYfQ: folds
kykGjpk/IjfbH8Gi6SIm5w collected $10 from pot
*** SUMMARY ***
Total pot $10 | Rake $0
Seat 1: is0C+o+4W8624tMaRmJg7A folded before Flop (didn't bet)
Seat 2: 7SUIdtQak1SCtldWHjwnFA (button) folded before Flop (didn't bet)
Seat 3: voSAIKXtXUUbJnds83sYfQ (small blind) folded before Flop
Seat 4: kykGjpk/IjfbH8Gi6SIm5w (big blind) collected ($10)
Seat 5: g/z/ANylbdR10I7oPCJdKQ folded before Flop (didn't bet)
Seat 6: 3mTlg4g0FJN2bo939h/0Wg folded before Flop (didn't bet)



PokerStars Game #59960550114:  Hold'em No Limit ($5/$10) - 2009/07/01 10:56:30 ET
Table 'AiNa6yyp/njJVRYl/Lz1KQ' 6-max Seat #5 is the button
Seat 1: voSAIKXtXUUbJnds83sYfQ ($1060 in chips)
Seat 2: efhcaDPhNqQ/H48kMHLa8w ($1232.90 in chips)
Seat 3: I1u3BrIcnPwCmkxtD03Q9A ($619 in chips)
Seat 5: jkH6qYMpn8JA/IyBOhQPMw ($1048 in chips)
Seat 6: Xl+I49lxCJwPGRuegiaHoA ($1138 in chips)
Xl+I49lxCJwPGRuegiaHoA: posts small blind $5
voSAIKXtXUUbJnds83sYfQ: posts big blind $10
*** HOLE CARDS ***
efhcaDPhNqQ/H48kMHLa8w: raises $20 to $30
I1u3BrIcnPwCmkxtD03Q9A: calls $30
jkH6qYMpn8JA/IyBOhQPMw has timed out
jkH6qYMpn8JA/IyBOhQPMw: folds
jkH6qYMpn8JA/IyBOhQPMw is sitting out
jkH6qYMpn8JA/IyBOhQPMw has returned
Xl+I49lxCJwPGRuegiaHoA: folds
voSAIKXtXUUbJnds83sYfQ: folds
*** FLOP *** [5s Jd Td]
efhcaDPhNqQ/H48kMHLa8w: checks
I1u3BrIcnPwCmkxtD03Q9A: bets $50
efhcaDPhNqQ/H48kMHLa8w: folds
I1u3BrIcnPwCmkxtD03Q9A collected $73 from pot
I1u3BrIcnPwCmkxtD03Q9A: doesn't show hand
*** SUMMARY ***
Total pot $75 | Rake $2
Board [5s Jd Td]
Seat 1: voSAIKXtXUUbJnds83sYfQ (big blind) folded before Flop
Seat 2: efhcaDPhNqQ/H48kMHLa8w folded on the Flop
Seat 3: I1u3BrIcnPwCmkxtD03Q9A collected ($73)
Seat 5: jkH6qYMpn8JA/IyBOhQPMw (button) folded before Flop (didn't bet)
Seat 6: Xl+I49lxCJwPGRuegiaHoA (small blind) folded before Flop



PokerStars Game #59960552484:  Hold'em No Limit ($5/$10) - 2009/07/01 10:56:33 ET
Table 'dwLGEw3aoH/cOAI7JsLdmw' 6-max Seat #3 is the button
Seat 1: is0C+o+4W8624tMaRmJg7A ($1000 in chips)
Seat 2: 7SUIdtQak1SCtldWHjwnFA ($217 in chips)
Seat 3: voSAIKXtXUUbJnds83sYfQ ($1000 in chips)
Seat 4: kykGjpk/IjfbH8Gi6SIm5w ($73 in chips)
Seat 6: 3mTlg4g0FJN2bo939h/0Wg ($421 in chips)
kykGjpk/IjfbH8Gi6SIm5w: posts small blind $5
3mTlg4g0FJN2bo939h/0Wg: posts big blind $10
*** HOLE CARDS ***
is0C+o+4W8624tMaRmJg7A: raises $15 to $25
7SUIdtQak1SCtldWHjwnFA: raises $55 to $80
voSAIKXtXUUbJnds83sYfQ: folds
kykGjpk/IjfbH8Gi6SIm5w: folds
3mTlg4g0FJN2bo939h/0Wg: folds
is0C+o+4W8624tMaRmJg7A: folds
7SUIdtQak1SCtldWHjwnFA collected $65 from pot
*** SUMMARY ***
Total pot $65 | Rake $0
Seat 1: is0C+o+4W8624tMaRmJg7A folded before Flop
Seat 2: 7SUIdtQak1SCtldWHjwnFA collected ($65)
Seat 3: voSAIKXtXUUbJnds83sYfQ (button) folded before Flop (didn't bet)
Seat 4: kykGjpk/IjfbH8Gi6SIm5w (small blind) folded before Flop
Seat 6: 3mTlg4g0FJN2bo939h/0Wg (big blind) folded before Flop



PokerStars Game #59960577418:  Hold'em No Limit ($5/$10) - 2009/07/01 10:57:04 ET
Table '2a86NK3xhs21kwGZmbj0QA' 6-max Seat #3 is the button
Seat 1: NczJqEIUdrpEc5Nbd7h1Ig ($539.25 in chips)
Seat 2: Xl+I49lxCJwPGRuegiaHoA ($2140 in chips)
Seat 3: voSAIKXtXUUbJnds83sYfQ ($1042 in chips)
Seat 4: Lne9leXjEzXWbU3BGFWsxQ ($1278.25 in chips)
Seat 5: jkH6qYMpn8JA/IyBOhQPMw ($1094 in chips)
Seat 6: UcFkfWngu95uR8Jhrj+HrQ ($377 in chips)
Lne9leXjEzXWbU3BGFWsxQ: posts small blind $5
jkH6qYMpn8JA/IyBOhQPMw: posts big blind $10
*** HOLE CARDS ***
UcFkfWngu95uR8Jhrj+HrQ: folds
NczJqEIUdrpEc5Nbd7h1Ig: folds
Xl+I49lxCJwPGRuegiaHoA: folds
UcFkfWngu95uR8Jhrj+HrQ leaves the table
voSAIKXtXUUbJnds83sYfQ: raises $20 to $30
Lne9leXjEzXWbU3BGFWsxQ: folds
0OfLwED3kKs3FwY+JlHC0g joins the table at seat #6
jkH6qYMpn8JA/IyBOhQPMw: folds
voSAIKXtXUUbJnds83sYfQ collected $25 from pot
voSAIKXtXUUbJnds83sYfQ: doesn't show hand
*** SUMMARY ***
Total pot $25 | Rake $0
Seat 1: NczJqEIUdrpEc5Nbd7h1Ig folded before Flop (didn't bet)
Seat 2: Xl+I49lxCJwPGRuegiaHoA folded before Flop (didn't bet)
Seat 3: voSAIKXtXUUbJnds83sYfQ (button) collected ($25)
Seat 4: Lne9leXjEzXWbU3BGFWsxQ (small blind) folded before Flop
Seat 5: jkH6qYMpn8JA/IyBOhQPMw (big blind) folded before Flop
Seat 6: UcFkfWngu95uR8Jhrj+HrQ folded before Flop (didn't bet)



PokerStars Game #59960583114:  Hold'em No Limit ($5/$10) - 2009/07/01 10:57:11 ET
Table 'dwLGEw3aoH/cOAI7JsLdmw' 6-max Seat #4 is the button
Seat 1: is0C+o+4W8624tMaRmJg7A ($1000 in chips)
Seat 2: 7SUIdtQak1SCtldWHjwnFA ($257 in chips)
Seat 3: voSAIKXtXUUbJnds83sYfQ ($1000 in chips)
Seat 4: kykGjpk/IjfbH8Gi6SIm5w ($68 in chips)
Seat 6: 3mTlg4g0FJN2bo939h/0Wg ($411 in chips)
3mTlg4g0FJN2bo939h/0Wg: posts small blind $5
is0C+o+4W8624tMaRmJg7A: posts big blind $10
*** HOLE CARDS ***
7SUIdtQak1SCtldWHjwnFA: folds
voSAIKXtXUUbJnds83sYfQ: folds
kykGjpk/IjfbH8Gi6SIm5w: folds
3mTlg4g0FJN2bo939h/0Wg: calls $5
is0C+o+4W8624tMaRmJg7A: checks
*** FLOP *** [Ad Ks Jd]
3mTlg4g0FJN2bo939h/0Wg: checks
is0C+o+4W8624tMaRmJg7A: checks
*** TURN *** [Ad Ks Jd] [4d]
3mTlg4g0FJN2bo939h/0Wg: checks
is0C+o+4W8624tMaRmJg7A: checks
*** RIVER *** [Ad Ks Jd 4d] [Ac]
3mTlg4g0FJN2bo939h/0Wg: checks
is0C+o+4W8624tMaRmJg7A: checks
*** SHOW DOWN ***
3mTlg4g0FJN2bo939h/0Wg: shows [5c 9s] (a pair of Aces)
is0C+o+4W8624tMaRmJg7A: shows [9c Jh] (two pair, Aces and Jacks)
is0C+o+4W8624tMaRmJg7A collected $19 from pot
*** SUMMARY ***
Total pot $20 | Rake $1
Board [Ad Ks Jd 4d Ac]
Seat 1: is0C+o+4W8624tMaRmJg7A (big blind) showed [9c Jh] and won ($19) with two pair, Aces and Jacks
Seat 2: 7SUIdtQak1SCtldWHjwnFA folded before Flop (didn't bet)
Seat 3: voSAIKXtXUUbJnds83sYfQ folded before Flop (didn't bet)
Seat 4: kykGjpk/IjfbH8Gi6SIm5w (button) folded before Flop (didn't bet)
Seat 6: 3mTlg4g0FJN2bo939h/0Wg (small blind) showed [5c 9s] and lost with a pair of Aces



PokerStars Game #59960593022:  Hold'em No Limit ($5/$10) - 2009/07/01 10:57:23 ET
Table '2a86NK3xhs21kwGZmbj0QA' 6-max Seat #4 is the button
Seat 1: NczJqEIUdrpEc5Nbd7h1Ig ($539.25 in chips)
Seat 2: Xl+I49lxCJwPGRuegiaHoA ($2140 in chips)
Seat 3: voSAIKXtXUUbJnds83sYfQ ($1057 in chips)
Seat 4: Lne9leXjEzXWbU3BGFWsxQ ($1273.25 in chips)
Seat 5: jkH6qYMpn8JA/IyBOhQPMw ($1084 in chips)
Seat 6: 0OfLwED3kKs3FwY+JlHC0g ($1000 in chips)
jkH6qYMpn8JA/IyBOhQPMw: posts small blind $5
0OfLwED3kKs3FwY+JlHC0g: posts big blind $10
*** HOLE CARDS ***
NczJqEIUdrpEc5Nbd7h1Ig: raises $20 to $30
Xl+I49lxCJwPGRuegiaHoA: folds
voSAIKXtXUUbJnds83sYfQ: folds
Lne9leXjEzXWbU3BGFWsxQ: raises $70 to $100
jkH6qYMpn8JA/IyBOhQPMw: calls $95
0OfLwED3kKs3FwY+JlHC0g: folds
NczJqEIUdrpEc5Nbd7h1Ig: calls $70
*** FLOP *** [3h 6d 4h]
jkH6qYMpn8JA/IyBOhQPMw: checks
NczJqEIUdrpEc5Nbd7h1Ig: checks
Lne9leXjEzXWbU3BGFWsxQ: checks
*** TURN *** [3h 6d 4h] [Js]
jkH6qYMpn8JA/IyBOhQPMw: bets $140
NczJqEIUdrpEc5Nbd7h1Ig: folds
Lne9leXjEzXWbU3BGFWsxQ: folds
jkH6qYMpn8JA/IyBOhQPMw collected $307 from pot
jkH6qYMpn8JA/IyBOhQPMw: doesn't show hand
*** SUMMARY ***
Total pot $310 | Rake $3
Board [3h 6d 4h Js]
Seat 1: NczJqEIUdrpEc5Nbd7h1Ig folded on the Turn
Seat 2: Xl+I49lxCJwPGRuegiaHoA folded before Flop (didn't bet)
Seat 3: voSAIKXtXUUbJnds83sYfQ folded before Flop (didn't bet)
Seat 4: Lne9leXjEzXWbU3BGFWsxQ (button) folded on the Turn
Seat 5: jkH6qYMpn8JA/IyBOhQPMw (small blind) collected ($307)
Seat 6: 0OfLwED3kKs3FwY+JlHC0g (big blind) folded before Flop



PokerStars Game #59960601706:  Hold'em No Limit ($5/$10) - 2009/07/01 10:57:34 ET
Table 'AiNa6yyp/njJVRYl/Lz1KQ' 6-max Seat #6 is the button
Seat 1: voSAIKXtXUUbJnds83sYfQ ($1050 in chips)
Seat 2: efhcaDPhNqQ/H48kMHLa8w ($1202.90 in chips)
Seat 3: I1u3BrIcnPwCmkxtD03Q9A ($662 in chips)
Seat 5: jkH6qYMpn8JA/IyBOhQPMw ($1048 in chips)
Seat 6: Xl+I49lxCJwPGRuegiaHoA ($1133 in chips)
voSAIKXtXUUbJnds83sYfQ: posts small blind $5
efhcaDPhNqQ/H48kMHLa8w: posts big blind $10
*** HOLE CARDS ***
I1u3BrIcnPwCmkxtD03Q9A: raises $20 to $30
jkH6qYMpn8JA/IyBOhQPMw: folds
Xl+I49lxCJwPGRuegiaHoA: folds
voSAIKXtXUUbJnds83sYfQ: folds
efhcaDPhNqQ/H48kMHLa8w: folds
I1u3BrIcnPwCmkxtD03Q9A collected $25 from pot
I1u3BrIcnPwCmkxtD03Q9A: doesn't show hand
*** SUMMARY ***
Total pot $25 | Rake $0
Seat 1: voSAIKXtXUUbJnds83sYfQ (small blind) folded before Flop
Seat 2: efhcaDPhNqQ/H48kMHLa8w (big blind) folded before Flop
Seat 3: I1u3BrIcnPwCmkxtD03Q9A collected ($25)
Seat 5: jkH6qYMpn8JA/IyBOhQPMw folded before Flop (didn't bet)
Seat 6: Xl+I49lxCJwPGRuegiaHoA (button) folded before Flop (didn't bet)



PokerStars Game #59960615950:  Hold'em No Limit ($5/$10) - 2009/07/01 10:57:52 ET
Table '1Dt9cpcLUVE6HYkx5dUEdQ' 6-max Seat #6 is the button
Seat 1: Xl+I49lxCJwPGRuegiaHoA ($1000 in chips)
Seat 2: zdS2zKkZYSRe8p+GVcXMgg ($1414.60 in chips)
Seat 3: Lne9leXjEzXWbU3BGFWsxQ ($1000 in chips)
Seat 4: voSAIKXtXUUbJnds83sYfQ ($1000 in chips)
Seat 5: 7SUIdtQak1SCtldWHjwnFA ($200 in chips)
Seat 6: 3mTlg4g0FJN2bo939h/0Wg ($990 in chips)
Xl+I49lxCJwPGRuegiaHoA: posts small blind $5
zdS2zKkZYSRe8p+GVcXMgg: posts big blind $10
*** HOLE CARDS ***
Lne9leXjEzXWbU3BGFWsxQ: folds
voSAIKXtXUUbJnds83sYfQ: folds
7SUIdtQak1SCtldWHjwnFA: raises $12 to $22
3mTlg4g0FJN2bo939h/0Wg: calls $22
Xl+I49lxCJwPGRuegiaHoA: folds
zdS2zKkZYSRe8p+GVcXMgg: calls $12
*** FLOP *** [Kd Td 5c]
zdS2zKkZYSRe8p+GVcXMgg: checks
7SUIdtQak1SCtldWHjwnFA: bets $40
3mTlg4g0FJN2bo939h/0Wg: raises $60 to $100
zdS2zKkZYSRe8p+GVcXMgg: folds
7SUIdtQak1SCtldWHjwnFA: raises $78 to $178 and is all-in
3mTlg4g0FJN2bo939h/0Wg: calls $78
*** TURN *** [Kd Td 5c] [7c]
*** RIVER *** [Kd Td 5c 7c] [Tc]
*** SHOW DOWN ***
7SUIdtQak1SCtldWHjwnFA: shows [Ad As] (two pair, Aces and Tens)
3mTlg4g0FJN2bo939h/0Wg: shows [Ks Ts] (a full house, Tens full of Kings)
3mTlg4g0FJN2bo939h/0Wg collected $424 from pot
*** SUMMARY ***
Total pot $427 | Rake $3
Board [Kd Td 5c 7c Tc]
Seat 1: Xl+I49lxCJwPGRuegiaHoA (small blind) folded before Flop
Seat 2: zdS2zKkZYSRe8p+GVcXMgg (big blind) folded on the Flop
Seat 3: Lne9leXjEzXWbU3BGFWsxQ folded before Flop (didn't bet)
Seat 4: voSAIKXtXUUbJnds83sYfQ folded before Flop (didn't bet)
Seat 5: 7SUIdtQak1SCtldWHjwnFA showed [Ad As] and lost with two pair, Aces and Tens
Seat 6: 3mTlg4g0FJN2bo939h/0Wg (button) showed [Ks Ts] and won ($424) with a full house, Tens full of Kings



PokerStars Game #59960618500:  Hold'em No Limit ($5/$10) - 2009/07/01 10:57:55 ET
Table 'AiNa6yyp/njJVRYl/Lz1KQ' 6-max Seat #1 is the button
Seat 1: voSAIKXtXUUbJnds83sYfQ ($1045 in chips)
Seat 2: efhcaDPhNqQ/H48kMHLa8w ($1192.90 in chips)
Seat 3: I1u3BrIcnPwCmkxtD03Q9A ($677 in chips)
Seat 5: jkH6qYMpn8JA/IyBOhQPMw ($1048 in chips)
Seat 6: Xl+I49lxCJwPGRuegiaHoA ($1133 in chips)
efhcaDPhNqQ/H48kMHLa8w: posts small blind $5
I1u3BrIcnPwCmkxtD03Q9A: posts big blind $10
*** HOLE CARDS ***
jkH6qYMpn8JA/IyBOhQPMw: folds
Xl+I49lxCJwPGRuegiaHoA: folds
voSAIKXtXUUbJnds83sYfQ: folds
W5z+iP++AH0RC/BH7RB+Fg has returned
efhcaDPhNqQ/H48kMHLa8w: folds
I1u3BrIcnPwCmkxtD03Q9A collected $10 from pot
I1u3BrIcnPwCmkxtD03Q9A: doesn't show hand
*** SUMMARY ***
Total pot $10 | Rake $0
Seat 1: voSAIKXtXUUbJnds83sYfQ (button) folded before Flop (didn't bet)
Seat 2: efhcaDPhNqQ/H48kMHLa8w (small blind) folded before Flop
Seat 3: I1u3BrIcnPwCmkxtD03Q9A (big blind) collected ($10)
Seat 5: jkH6qYMpn8JA/IyBOhQPMw folded before Flop (didn't bet)
Seat 6: Xl+I49lxCJwPGRuegiaHoA folded before Flop (didn't bet)



PokerStars Game #59960626644:  Hold'em No Limit ($5/$10) - 2009/07/01 10:58:05 ET
Table 'dwLGEw3aoH/cOAI7JsLdmw' 6-max Seat #6 is the button
Seat 1: is0C+o+4W8624tMaRmJg7A ($1009 in chips)
Seat 3: voSAIKXtXUUbJnds83sYfQ ($1000 in chips)
Seat 4: kykGjpk/IjfbH8Gi6SIm5w ($68 in chips)
Seat 6: 3mTlg4g0FJN2bo939h/0Wg ($401 in chips)
is0C+o+4W8624tMaRmJg7A: posts small blind $5
7SUIdtQak1SCtldWHjwnFA: is sitting out
voSAIKXtXUUbJnds83sYfQ: posts big blind $10
*** HOLE CARDS ***
7SUIdtQak1SCtldWHjwnFA leaves the table
kykGjpk/IjfbH8Gi6SIm5w: folds
3mTlg4g0FJN2bo939h/0Wg: folds
1ScqYmNf7/uWx1XSBgPTBw joins the table at seat #2
is0C+o+4W8624tMaRmJg7A: folds
voSAIKXtXUUbJnds83sYfQ collected $10 from pot
*** SUMMARY ***
Total pot $10 | Rake $0
Seat 1: is0C+o+4W8624tMaRmJg7A (small blind) folded before Flop
Seat 3: voSAIKXtXUUbJnds83sYfQ (big blind) collected ($10)
Seat 4: kykGjpk/IjfbH8Gi6SIm5w folded before Flop (didn't bet)
Seat 6: 3mTlg4g0FJN2bo939h/0Wg (button) folded before Flop (didn't bet)



PokerStars Game #59960630424:  Hold'em No Limit ($5/$10) - 2009/07/01 10:58:10 ET
Table 'AiNa6yyp/njJVRYl/Lz1KQ' 6-max Seat #2 is the button
Seat 1: voSAIKXtXUUbJnds83sYfQ ($1045 in chips)
Seat 2: efhcaDPhNqQ/H48kMHLa8w ($1187.90 in chips)
Seat 3: I1u3BrIcnPwCmkxtD03Q9A ($682 in chips)
Seat 5: jkH6qYMpn8JA/IyBOhQPMw ($1048 in chips)
Seat 6: Xl+I49lxCJwPGRuegiaHoA ($1133 in chips)
I1u3BrIcnPwCmkxtD03Q9A: posts small blind $5
jkH6qYMpn8JA/IyBOhQPMw: posts big blind $10
*** HOLE CARDS ***
Xl+I49lxCJwPGRuegiaHoA: folds
voSAIKXtXUUbJnds83sYfQ: raises $20 to $30
efhcaDPhNqQ/H48kMHLa8w: folds
I1u3BrIcnPwCmkxtD03Q9A: folds
jkH6qYMpn8JA/IyBOhQPMw: folds
voSAIKXtXUUbJnds83sYfQ collected $25 from pot
voSAIKXtXUUbJnds83sYfQ: doesn't show hand
*** SUMMARY ***
Total pot $25 | Rake $0
Seat 1: voSAIKXtXUUbJnds83sYfQ collected ($25)
Seat 2: efhcaDPhNqQ/H48kMHLa8w (button) folded before Flop (didn't bet)
Seat 3: I1u3BrIcnPwCmkxtD03Q9A (small blind) folded before Flop
Seat 5: jkH6qYMpn8JA/IyBOhQPMw (big blind) folded before Flop
Seat 6: Xl+I49lxCJwPGRuegiaHoA folded before Flop (didn't bet)



PokerStars Game #59960634454:  Hold'em No Limit ($5/$10) - 2009/07/01 10:58:15 ET
Table '2a86NK3xhs21kwGZmbj0QA' 6-max Seat #5 is the button
Seat 1: NczJqEIUdrpEc5Nbd7h1Ig ($439.25 in chips)
Seat 2: Xl+I49lxCJwPGRuegiaHoA ($2140 in chips)
Seat 3: voSAIKXtXUUbJnds83sYfQ ($1057 in chips)
Seat 4: Lne9leXjEzXWbU3BGFWsxQ ($1173.25 in chips)
Seat 5: jkH6qYMpn8JA/IyBOhQPMw ($1291 in chips)
Seat 6: 0OfLwED3kKs3FwY+JlHC0g ($1000 in chips)
0OfLwED3kKs3FwY+JlHC0g: posts small blind $5
NczJqEIUdrpEc5Nbd7h1Ig: posts big blind $10
*** HOLE CARDS ***
Xl+I49lxCJwPGRuegiaHoA: folds
voSAIKXtXUUbJnds83sYfQ: folds
Lne9leXjEzXWbU3BGFWsxQ: folds
jkH6qYMpn8JA/IyBOhQPMw: raises $20 to $30
0OfLwED3kKs3FwY+JlHC0g: folds
NczJqEIUdrpEc5Nbd7h1Ig: raises $70 to $100
jkH6qYMpn8JA/IyBOhQPMw: raises $930 to $1030
NczJqEIUdrpEc5Nbd7h1Ig: calls $339.25 and is all-in
*** FLOP *** [Jc Kc 2d]
*** TURN *** [Jc Kc 2d] [5d]
*** RIVER *** [Jc Kc 2d 5d] [9h]
*** SHOW DOWN ***
NczJqEIUdrpEc5Nbd7h1Ig: shows [Ah Qs] (high card Ace)
jkH6qYMpn8JA/IyBOhQPMw: shows [7d 7h] (a pair of Sevens)
jkH6qYMpn8JA/IyBOhQPMw collected $880.50 from pot
*** SUMMARY ***
Total pot $883.50 | Rake $3
Board [Jc Kc 2d 5d 9h]
Seat 1: NczJqEIUdrpEc5Nbd7h1Ig (big blind) showed [Ah Qs] and lost with high card Ace
Seat 2: Xl+I49lxCJwPGRuegiaHoA folded before Flop (didn't bet)
Seat 3: voSAIKXtXUUbJnds83sYfQ folded before Flop (didn't bet)
Seat 4: Lne9leXjEzXWbU3BGFWsxQ folded before Flop (didn't bet)
Seat 5: jkH6qYMpn8JA/IyBOhQPMw (button) showed [7d 7h] and won ($880.50) with a pair of Sevens
Seat 6: 0OfLwED3kKs3FwY+JlHC0g (small blind) folded before Flop



PokerStars Game #59960642920:  Hold'em No Limit ($5/$10) - 2009/07/01 10:58:25 ET
Table 'dwLGEw3aoH/cOAI7JsLdmw' 6-max Seat #1 is the button
Seat 1: is0C+o+4W8624tMaRmJg7A ($1004 in chips)
Seat 3: voSAIKXtXUUbJnds83sYfQ ($1005 in chips)
Seat 4: kykGjpk/IjfbH8Gi6SIm5w ($68 in chips)
Seat 6: 3mTlg4g0FJN2bo939h/0Wg ($401 in chips)
1ScqYmNf7/uWx1XSBgPTBw will be allowed to play after the button
voSAIKXtXUUbJnds83sYfQ: posts small blind $5
kykGjpk/IjfbH8Gi6SIm5w: posts big blind $10
*** HOLE CARDS ***
3mTlg4g0FJN2bo939h/0Wg: raises $10 to $20
is0C+o+4W8624tMaRmJg7A: folds
voSAIKXtXUUbJnds83sYfQ: folds
kykGjpk/IjfbH8Gi6SIm5w: folds
3mTlg4g0FJN2bo939h/0Wg collected $25 from pot
*** SUMMARY ***
Total pot $25 | Rake $0
Seat 1: is0C+o+4W8624tMaRmJg7A (button) folded before Flop (didn't bet)
Seat 3: voSAIKXtXUUbJnds83sYfQ (small blind) folded before Flop
Seat 4: kykGjpk/IjfbH8Gi6SIm5w (big blind) folded before Flop
Seat 6: 3mTlg4g0FJN2bo939h/0Wg collected ($25)



PokerStars Game #59960645190:  Hold'em No Limit ($5/$10) - 2009/07/01 10:58:28 ET
Table 'AiNa6yyp/njJVRYl/Lz1KQ' 6-max Seat #3 is the button
Seat 1: voSAIKXtXUUbJnds83sYfQ ($1060 in chips)
Seat 2: efhcaDPhNqQ/H48kMHLa8w ($1187.90 in chips)
Seat 3: I1u3BrIcnPwCmkxtD03Q9A ($677 in chips)
Seat 5: jkH6qYMpn8JA/IyBOhQPMw ($1038 in chips)
Seat 6: Xl+I49lxCJwPGRuegiaHoA ($1133 in chips)
jkH6qYMpn8JA/IyBOhQPMw: posts small blind $5
Xl+I49lxCJwPGRuegiaHoA: posts big blind $10
*** HOLE CARDS ***
voSAIKXtXUUbJnds83sYfQ: folds
efhcaDPhNqQ/H48kMHLa8w: folds
I1u3BrIcnPwCmkxtD03Q9A: folds
jkH6qYMpn8JA/IyBOhQPMw: folds
Xl+I49lxCJwPGRuegiaHoA collected $10 from pot
Xl+I49lxCJwPGRuegiaHoA: doesn't show hand
*** SUMMARY ***
Total pot $10 | Rake $0
Seat 1: voSAIKXtXUUbJnds83sYfQ folded before Flop (didn't bet)
Seat 2: efhcaDPhNqQ/H48kMHLa8w folded before Flop (didn't bet)
Seat 3: I1u3BrIcnPwCmkxtD03Q9A (button) folded before Flop (didn't bet)
Seat 5: jkH6qYMpn8JA/IyBOhQPMw (small blind) folded before Flop
Seat 6: Xl+I49lxCJwPGRuegiaHoA (big blind) collected ($10)



PokerStars Game #59960656284:  Hold'em No Limit ($5/$10) - 2009/07/01 10:58:42 ET
Table 'dwLGEw3aoH/cOAI7JsLdmw' 6-max Seat #3 is the button
Seat 1: is0C+o+4W8624tMaRmJg7A ($1004 in chips)
Seat 3: voSAIKXtXUUbJnds83sYfQ ($1000 in chips)
Seat 4: kykGjpk/IjfbH8Gi6SIm5w ($58 in chips)
Seat 6: 3mTlg4g0FJN2bo939h/0Wg ($416 in chips)
kykGjpk/IjfbH8Gi6SIm5w: posts small blind $5
3mTlg4g0FJN2bo939h/0Wg: posts big blind $10
1ScqYmNf7/uWx1XSBgPTBw: sits out
*** HOLE CARDS ***
is0C+o+4W8624tMaRmJg7A: raises $15 to $25
voSAIKXtXUUbJnds83sYfQ: folds
kykGjpk/IjfbH8Gi6SIm5w: folds
3mTlg4g0FJN2bo939h/0Wg: folds
is0C+o+4W8624tMaRmJg7A collected $25 from pot
*** SUMMARY ***
Total pot $25 | Rake $0
Seat 1: is0C+o+4W8624tMaRmJg7A collected ($25)
Seat 3: voSAIKXtXUUbJnds83sYfQ (button) folded before Flop (didn't bet)
Seat 4: kykGjpk/IjfbH8Gi6SIm5w (small blind) folded before Flop
Seat 6: 3mTlg4g0FJN2bo939h/0Wg (big blind) folded before Flop



PokerStars Game #59960659756:  Hold'em No Limit ($5/$10) - 2009/07/01 10:58:46 ET
Table '1Dt9cpcLUVE6HYkx5dUEdQ' 6-max Seat #1 is the button
Seat 1: Xl+I49lxCJwPGRuegiaHoA ($1000 in chips)
Seat 2: zdS2zKkZYSRe8p+GVcXMgg ($1392.60 in chips)
Seat 3: Lne9leXjEzXWbU3BGFWsxQ ($1000 in chips)
Seat 4: voSAIKXtXUUbJnds83sYfQ ($1000 in chips)
Seat 5: 7SUIdtQak1SCtldWHjwnFA ($200 in chips)
Seat 6: 3mTlg4g0FJN2bo939h/0Wg ($1214 in chips)
zdS2zKkZYSRe8p+GVcXMgg: posts small blind $5
Lne9leXjEzXWbU3BGFWsxQ: posts big blind $10
*** HOLE CARDS ***
voSAIKXtXUUbJnds83sYfQ: folds
7SUIdtQak1SCtldWHjwnFA: raises $12 to $22
3mTlg4g0FJN2bo939h/0Wg: folds
Xl+I49lxCJwPGRuegiaHoA: raises $38 to $60
zdS2zKkZYSRe8p+GVcXMgg: folds
Lne9leXjEzXWbU3BGFWsxQ: folds
7SUIdtQak1SCtldWHjwnFA: folds
Xl+I49lxCJwPGRuegiaHoA collected $59 from pot
Xl+I49lxCJwPGRuegiaHoA: doesn't show hand
*** SUMMARY ***
Total pot $59 | Rake $0
Seat 1: Xl+I49lxCJwPGRuegiaHoA (button) collected ($59)
Seat 2: zdS2zKkZYSRe8p+GVcXMgg (small blind) folded before Flop
Seat 3: Lne9leXjEzXWbU3BGFWsxQ (big blind) folded before Flop
Seat 4: voSAIKXtXUUbJnds83sYfQ folded before Flop (didn't bet)
Seat 5: 7SUIdtQak1SCtldWHjwnFA folded before Flop
Seat 6: 3mTlg4g0FJN2bo939h/0Wg folded before Flop (didn't bet)



PokerStars Game #59960660822:  Hold'em No Limit ($5/$10) - 2009/07/01 10:58:47 ET
Table 'AiNa6yyp/njJVRYl/Lz1KQ' 6-max Seat #5 is the button
Seat 1: voSAIKXtXUUbJnds83sYfQ ($1060 in chips)
Seat 2: efhcaDPhNqQ/H48kMHLa8w ($1187.90 in chips)
Seat 3: I1u3BrIcnPwCmkxtD03Q9A ($677 in chips)
Seat 5: jkH6qYMpn8JA/IyBOhQPMw ($1033 in chips)
Seat 6: Xl+I49lxCJwPGRuegiaHoA ($1138 in chips)
Xl+I49lxCJwPGRuegiaHoA: posts small blind $5
voSAIKXtXUUbJnds83sYfQ: posts big blind $10
*** HOLE CARDS ***
efhcaDPhNqQ/H48kMHLa8w: folds
I1u3BrIcnPwCmkxtD03Q9A: raises $20 to $30
jkH6qYMpn8JA/IyBOhQPMw: calls $30
Xl+I49lxCJwPGRuegiaHoA: folds
voSAIKXtXUUbJnds83sYfQ: raises $95 to $125
I1u3BrIcnPwCmkxtD03Q9A: calls $95
jkH6qYMpn8JA/IyBOhQPMw: folds
*** FLOP *** [Qd 6s 9c]
voSAIKXtXUUbJnds83sYfQ: bets $160
I1u3BrIcnPwCmkxtD03Q9A: raises $392 to $552 and is all-in
voSAIKXtXUUbJnds83sYfQ: calls $392
*** TURN *** [Qd 6s 9c] [7d]
*** RIVER *** [Qd 6s 9c 7d] [As]
*** SHOW DOWN ***
voSAIKXtXUUbJnds83sYfQ: shows [Ah Qh] (two pair, Aces and Queens)
I1u3BrIcnPwCmkxtD03Q9A: mucks hand
voSAIKXtXUUbJnds83sYfQ collected $1387 from pot
*** SUMMARY ***
Total pot $1389 | Rake $2
Board [Qd 6s 9c 7d As]
Seat 1: voSAIKXtXUUbJnds83sYfQ (big blind) showed [Ah Qh] and won ($1387) with two pair, Aces and Queens
Seat 2: efhcaDPhNqQ/H48kMHLa8w folded before Flop (didn't bet)
Seat 3: I1u3BrIcnPwCmkxtD03Q9A mucked
Seat 5: jkH6qYMpn8JA/IyBOhQPMw (button) folded before Flop
Seat 6: Xl+I49lxCJwPGRuegiaHoA (small blind) folded before Flop



PokerStars Game #59960660118:  Hold'em No Limit ($5/$10) - 2009/07/01 10:58:47 ET
Table '2a86NK3xhs21kwGZmbj0QA' 6-max Seat #6 is the button
Seat 2: Xl+I49lxCJwPGRuegiaHoA ($2140 in chips)
Seat 3: voSAIKXtXUUbJnds83sYfQ ($1057 in chips)
Seat 4: Lne9leXjEzXWbU3BGFWsxQ ($1173.25 in chips)
Seat 5: jkH6qYMpn8JA/IyBOhQPMw ($1732.25 in chips)
Seat 6: 0OfLwED3kKs3FwY+JlHC0g ($1000 in chips)
Xl+I49lxCJwPGRuegiaHoA: posts small blind $5
voSAIKXtXUUbJnds83sYfQ: posts big blind $10
*** HOLE CARDS ***
Lne9leXjEzXWbU3BGFWsxQ: raises $20 to $30
NczJqEIUdrpEc5Nbd7h1Ig leaves the table
jkH6qYMpn8JA/IyBOhQPMw: folds
0OfLwED3kKs3FwY+JlHC0g: folds
Xl+I49lxCJwPGRuegiaHoA: folds
voSAIKXtXUUbJnds83sYfQ: folds
Lne9leXjEzXWbU3BGFWsxQ collected $25 from pot
Lne9leXjEzXWbU3BGFWsxQ: doesn't show hand
*** SUMMARY ***
Total pot $25 | Rake $0
Seat 2: Xl+I49lxCJwPGRuegiaHoA (small blind) folded before Flop
Seat 3: voSAIKXtXUUbJnds83sYfQ (big blind) folded before Flop
Seat 4: Lne9leXjEzXWbU3BGFWsxQ collected ($25)
Seat 5: jkH6qYMpn8JA/IyBOhQPMw folded before Flop (didn't bet)
Seat 6: 0OfLwED3kKs3FwY+JlHC0g (button) folded before Flop (didn't bet)



PokerStars Game #59960671562:  Hold'em No Limit ($5/$10) - 2009/07/01 10:59:01 ET
Table 'dwLGEw3aoH/cOAI7JsLdmw' 6-max Seat #4 is the button
Seat 1: is0C+o+4W8624tMaRmJg7A ($1019 in chips)
Seat 3: voSAIKXtXUUbJnds83sYfQ ($1000 in chips)
Seat 4: kykGjpk/IjfbH8Gi6SIm5w ($53 in chips)
Seat 6: 3mTlg4g0FJN2bo939h/0Wg ($406 in chips)
3mTlg4g0FJN2bo939h/0Wg: posts small blind $5
is0C+o+4W8624tMaRmJg7A: posts big blind $10
1ScqYmNf7/uWx1XSBgPTBw: sits out
*** HOLE CARDS ***
voSAIKXtXUUbJnds83sYfQ: folds
kykGjpk/IjfbH8Gi6SIm5w: folds
3mTlg4g0FJN2bo939h/0Wg: calls $5
is0C+o+4W8624tMaRmJg7A: checks
*** FLOP *** [9s 4s Ah]
3mTlg4g0FJN2bo939h/0Wg: checks
is0C+o+4W8624tMaRmJg7A: bets $15
3mTlg4g0FJN2bo939h/0Wg: folds
is0C+o+4W8624tMaRmJg7A collected $19 from pot
*** SUMMARY ***
Total pot $20 | Rake $1
Board [9s 4s Ah]
Seat 1: is0C+o+4W8624tMaRmJg7A (big blind) collected ($19)
Seat 3: voSAIKXtXUUbJnds83sYfQ folded before Flop (didn't bet)
Seat 4: kykGjpk/IjfbH8Gi6SIm5w (button) folded before Flop (didn't bet)
Seat 6: 3mTlg4g0FJN2bo939h/0Wg (small blind) folded on the Flop



PokerStars Game #59960680476:  Hold'em No Limit ($5/$10) - 2009/07/01 10:59:12 ET
Table '2a86NK3xhs21kwGZmbj0QA' 6-max Seat #2 is the button
Seat 2: Xl+I49lxCJwPGRuegiaHoA ($2135 in chips)
Seat 3: voSAIKXtXUUbJnds83sYfQ ($1047 in chips)
Seat 4: Lne9leXjEzXWbU3BGFWsxQ ($1188.25 in chips)
Seat 5: jkH6qYMpn8JA/IyBOhQPMw ($1732.25 in chips)
Seat 6: 0OfLwED3kKs3FwY+JlHC0g ($1000 in chips)
voSAIKXtXUUbJnds83sYfQ: posts small blind $5
Lne9leXjEzXWbU3BGFWsxQ: posts big blind $10
*** HOLE CARDS ***
is0C+o+4W8624tMaRmJg7A joins the table at seat #1
jkH6qYMpn8JA/IyBOhQPMw: folds
0OfLwED3kKs3FwY+JlHC0g: folds
Xl+I49lxCJwPGRuegiaHoA: folds
voSAIKXtXUUbJnds83sYfQ: folds
Lne9leXjEzXWbU3BGFWsxQ collected $10 from pot
Lne9leXjEzXWbU3BGFWsxQ: doesn't show hand
*** SUMMARY ***
Total pot $10 | Rake $0
Seat 2: Xl+I49lxCJwPGRuegiaHoA (button) folded before Flop (didn't bet)
Seat 3: voSAIKXtXUUbJnds83sYfQ (small blind) folded before Flop
Seat 4: Lne9leXjEzXWbU3BGFWsxQ (big blind) collected ($10)
Seat 5: jkH6qYMpn8JA/IyBOhQPMw folded before Flop (didn't bet)
Seat 6: 0OfLwED3kKs3FwY+JlHC0g folded before Flop (didn't bet)



PokerStars Game #59960680654:  Hold'em No Limit ($5/$10) - 2009/07/01 10:59:13 ET
Table '1Dt9cpcLUVE6HYkx5dUEdQ' 6-max Seat #2 is the button
Seat 1: Xl+I49lxCJwPGRuegiaHoA ($1037 in chips)
Seat 2: zdS2zKkZYSRe8p+GVcXMgg ($1387.60 in chips)
Seat 3: Lne9leXjEzXWbU3BGFWsxQ ($1000 in chips)
Seat 4: voSAIKXtXUUbJnds83sYfQ ($1000 in chips)
Seat 5: 7SUIdtQak1SCtldWHjwnFA ($178 in chips)
Seat 6: 3mTlg4g0FJN2bo939h/0Wg ($1214 in chips)
Lne9leXjEzXWbU3BGFWsxQ: posts small blind $5
voSAIKXtXUUbJnds83sYfQ: posts big blind $10
*** HOLE CARDS ***
7SUIdtQak1SCtldWHjwnFA: folds
7SUIdtQak1SCtldWHjwnFA is sitting out
3mTlg4g0FJN2bo939h/0Wg: raises $20 to $30
Xl+I49lxCJwPGRuegiaHoA: folds
zdS2zKkZYSRe8p+GVcXMgg: calls $30
Lne9leXjEzXWbU3BGFWsxQ: folds
voSAIKXtXUUbJnds83sYfQ: folds
*** FLOP *** [2d Td 9s]
3mTlg4g0FJN2bo939h/0Wg: checks
zdS2zKkZYSRe8p+GVcXMgg: checks
*** TURN *** [2d Td 9s] [7h]
3mTlg4g0FJN2bo939h/0Wg: bets $50
zdS2zKkZYSRe8p+GVcXMgg: calls $50
*** RIVER *** [2d Td 9s 7h] [Ah]
3mTlg4g0FJN2bo939h/0Wg: bets $100
zdS2zKkZYSRe8p+GVcXMgg: folds
3mTlg4g0FJN2bo939h/0Wg collected $172 from pot
*** SUMMARY ***
Total pot $175 | Rake $3
Board [2d Td 9s 7h Ah]
Seat 1: Xl+I49lxCJwPGRuegiaHoA folded before Flop (didn't bet)
Seat 2: zdS2zKkZYSRe8p+GVcXMgg (button) folded on the River
Seat 3: Lne9leXjEzXWbU3BGFWsxQ (small blind) folded before Flop
Seat 4: voSAIKXtXUUbJnds83sYfQ (big blind) folded before Flop
Seat 5: 7SUIdtQak1SCtldWHjwnFA folded before Flop (didn't bet)
Seat 6: 3mTlg4g0FJN2bo939h/0Wg collected ($172)



PokerStars Game #59960690342:  Hold'em No Limit ($5/$10) - 2009/07/01 10:59:25 ET
Table '2a86NK3xhs21kwGZmbj0QA' 6-max Seat #3 is the button
Seat 2: Xl+I49lxCJwPGRuegiaHoA ($2135 in chips)
Seat 3: voSAIKXtXUUbJnds83sYfQ ($1042 in chips)
Seat 4: Lne9leXjEzXWbU3BGFWsxQ ($1193.25 in chips)
Seat 5: jkH6qYMpn8JA/IyBOhQPMw ($1732.25 in chips)
Seat 6: 0OfLwED3kKs3FwY+JlHC0g ($1000 in chips)
Lne9leXjEzXWbU3BGFWsxQ: posts small blind $5
jkH6qYMpn8JA/IyBOhQPMw: posts big blind $10
is0C+o+4W8624tMaRmJg7A: sits out
*** HOLE CARDS ***
0OfLwED3kKs3FwY+JlHC0g: folds
Xl+I49lxCJwPGRuegiaHoA: folds
voSAIKXtXUUbJnds83sYfQ: folds
Lne9leXjEzXWbU3BGFWsxQ: raises $20 to $30
jkH6qYMpn8JA/IyBOhQPMw: folds
Lne9leXjEzXWbU3BGFWsxQ collected $20 from pot
Lne9leXjEzXWbU3BGFWsxQ: doesn't show hand
*** SUMMARY ***
Total pot $20 | Rake $0
Seat 2: Xl+I49lxCJwPGRuegiaHoA folded before Flop (didn't bet)
Seat 3: voSAIKXtXUUbJnds83sYfQ (button) folded before Flop (didn't bet)
Seat 4: Lne9leXjEzXWbU3BGFWsxQ (small blind) collected ($20)
Seat 5: jkH6qYMpn8JA/IyBOhQPMw (big blind) folded before Flop
Seat 6: 0OfLwED3kKs3FwY+JlHC0g folded before Flop (didn't bet)



PokerStars Game #59960706032:  Hold'em No Limit ($5/$10) - 2009/07/01 10:59:45 ET
Table 'AiNa6yyp/njJVRYl/Lz1KQ' 6-max Seat #6 is the button
Seat 1: voSAIKXtXUUbJnds83sYfQ ($1770 in chips)
Seat 2: efhcaDPhNqQ/H48kMHLa8w ($1187.90 in chips)
Seat 5: jkH6qYMpn8JA/IyBOhQPMw ($1003 in chips)
Seat 6: Xl+I49lxCJwPGRuegiaHoA ($1133 in chips)
voSAIKXtXUUbJnds83sYfQ: posts small blind $5
efhcaDPhNqQ/H48kMHLa8w: posts big blind $10
*** HOLE CARDS ***
I1u3BrIcnPwCmkxtD03Q9A leaves the table
UcFkfWngu95uR8Jhrj+HrQ joins the table at seat #3
jkH6qYMpn8JA/IyBOhQPMw: folds
Xl+I49lxCJwPGRuegiaHoA: raises $20 to $30
voSAIKXtXUUbJnds83sYfQ: folds
efhcaDPhNqQ/H48kMHLa8w: folds
Xl+I49lxCJwPGRuegiaHoA collected $25 from pot
Xl+I49lxCJwPGRuegiaHoA: doesn't show hand
*** SUMMARY ***
Total pot $25 | Rake $0
Seat 1: voSAIKXtXUUbJnds83sYfQ (small blind) folded before Flop
Seat 2: efhcaDPhNqQ/H48kMHLa8w (big blind) folded before Flop
Seat 5: jkH6qYMpn8JA/IyBOhQPMw folded before Flop (didn't bet)
Seat 6: Xl+I49lxCJwPGRuegiaHoA (button) collected ($25)



PokerStars Game #59960706710:  Hold'em No Limit ($5/$10) - 2009/07/01 10:59:46 ET
Table '2a86NK3xhs21kwGZmbj0QA' 6-max Seat #4 is the button
Seat 2: Xl+I49lxCJwPGRuegiaHoA ($2135 in chips)
Seat 3: voSAIKXtXUUbJnds83sYfQ ($1042 in chips)
Seat 4: Lne9leXjEzXWbU3BGFWsxQ ($1203.25 in chips)
Seat 5: jkH6qYMpn8JA/IyBOhQPMw ($1722.25 in chips)
Seat 6: 0OfLwED3kKs3FwY+JlHC0g ($1000 in chips)
jkH6qYMpn8JA/IyBOhQPMw: posts small blind $5
0OfLwED3kKs3FwY+JlHC0g: posts big blind $10
is0C+o+4W8624tMaRmJg7A: sits out
*** HOLE CARDS ***
Xl+I49lxCJwPGRuegiaHoA: folds
voSAIKXtXUUbJnds83sYfQ: folds
Lne9leXjEzXWbU3BGFWsxQ: folds
jkH6qYMpn8JA/IyBOhQPMw: folds
0OfLwED3kKs3FwY+JlHC0g collected $10 from pot
0OfLwED3kKs3FwY+JlHC0g: doesn't show hand
*** SUMMARY ***
Total pot $10 | Rake $0
Seat 2: Xl+I49lxCJwPGRuegiaHoA folded before Flop (didn't bet)
Seat 3: voSAIKXtXUUbJnds83sYfQ folded before Flop (didn't bet)
Seat 4: Lne9leXjEzXWbU3BGFWsxQ (button) folded before Flop (didn't bet)
Seat 5: jkH6qYMpn8JA/IyBOhQPMw (small blind) folded before Flop
Seat 6: 0OfLwED3kKs3FwY+JlHC0g (big blind) collected ($10)



PokerStars Game #59961696898:  Hold'em No Limit ($5/$10) - 2009/07/01 11:19:54 ET
Table '1Dt9cpcLUVE6HYkx5dUEdQ' 6-max Seat #4 is the button
Seat 1: Xl+I49lxCJwPGRuegiaHoA ($1020 in chips)
Seat 2: zdS2zKkZYSRe8p+GVcXMgg ($1785.10 in chips)
Seat 3: Lne9leXjEzXWbU3BGFWsxQ ($1052 in chips)
Seat 4: voSAIKXtXUUbJnds83sYfQ ($1022 in chips)
Seat 5: jkH6qYMpn8JA/IyBOhQPMw ($1035 in chips)
Seat 6: 3mTlg4g0FJN2bo939h/0Wg ($1173 in chips)
jkH6qYMpn8JA/IyBOhQPMw: posts small blind $5
3mTlg4g0FJN2bo939h/0Wg: posts big blind $10
*** HOLE CARDS ***
Xl+I49lxCJwPGRuegiaHoA: folds
zdS2zKkZYSRe8p+GVcXMgg: raises $30 to $40
Lne9leXjEzXWbU3BGFWsxQ: folds
voSAIKXtXUUbJnds83sYfQ: folds
jkH6qYMpn8JA/IyBOhQPMw: folds
3mTlg4g0FJN2bo939h/0Wg: raises $50 to $90
zdS2zKkZYSRe8p+GVcXMgg: calls $50
*** FLOP *** [2d Jc 2c]
3mTlg4g0FJN2bo939h/0Wg: bets $50
zdS2zKkZYSRe8p+GVcXMgg: folds
3mTlg4g0FJN2bo939h/0Wg collected $182 from pot
*** SUMMARY ***
Total pot $185 | Rake $3
Board [2d Jc 2c]
Seat 1: Xl+I49lxCJwPGRuegiaHoA folded before Flop (didn't bet)
Seat 2: zdS2zKkZYSRe8p+GVcXMgg folded on the Flop
Seat 3: Lne9leXjEzXWbU3BGFWsxQ folded before Flop (didn't bet)
Seat 4: voSAIKXtXUUbJnds83sYfQ (button) folded before Flop (didn't bet)
Seat 5: jkH6qYMpn8JA/IyBOhQPMw (small blind) folded before Flop
Seat 6: 3mTlg4g0FJN2bo939h/0Wg (big blind) collected ($182)



PokerStars Game #59961765348:  Hold'em No Limit ($5/$10) - 2009/07/01 11:21:15 ET
Table 'AI1fZ7Tsbf9DI8mC4EWoQQ' 9-max Seat #7 is the button
Seat 1: ve1LEJosAmuFjNNCQuPnPg ($1022.75 in chips)
Seat 2: UcFkfWngu95uR8Jhrj+HrQ ($276.50 in chips)
Seat 3: vM2kcH3Ff9H6Drv0NwoocA ($185 in chips)
Seat 4: KVUX8NzxJOWN94yxutATnw ($190 in chips)
Seat 5: 2PHCSXghjbGk2qR6jDFe2g ($985 in chips)
Seat 6: /64L6nqH9VyZLH7veYXrJA ($985 in chips)
Seat 7: ettgJAblGnistIlqNz4Jww ($1000 in chips)
Seat 8: K/ETAn4GnsqZgUCBm9C9PQ ($1005 in chips)
Seat 9: 0htPWcyi7sLFKivEsEz4Gg ($1000 in chips)
K/ETAn4GnsqZgUCBm9C9PQ: posts small blind $5
0htPWcyi7sLFKivEsEz4Gg: posts big blind $10
*** HOLE CARDS ***
ve1LEJosAmuFjNNCQuPnPg: folds
UcFkfWngu95uR8Jhrj+HrQ: folds
vM2kcH3Ff9H6Drv0NwoocA: folds
KVUX8NzxJOWN94yxutATnw: folds
2PHCSXghjbGk2qR6jDFe2g: folds
/64L6nqH9VyZLH7veYXrJA: folds
ettgJAblGnistIlqNz4Jww: raises $20 to $30
K/ETAn4GnsqZgUCBm9C9PQ: folds
0htPWcyi7sLFKivEsEz4Gg: folds
ettgJAblGnistIlqNz4Jww collected $25 from pot
ettgJAblGnistIlqNz4Jww: doesn't show hand
*** SUMMARY ***
Total pot $25 | Rake $0
Seat 1: ve1LEJosAmuFjNNCQuPnPg folded before Flop (didn't bet)
Seat 2: UcFkfWngu95uR8Jhrj+HrQ folded before Flop (didn't bet)
Seat 3: vM2kcH3Ff9H6Drv0NwoocA folded before Flop (didn't bet)
Seat 4: KVUX8NzxJOWN94yxutATnw folded before Flop (didn't bet)
Seat 5: 2PHCSXghjbGk2qR6jDFe2g folded before Flop (didn't bet)
Seat 6: /64L6nqH9VyZLH7veYXrJA folded before Flop (didn't bet)
Seat 7: ettgJAblGnistIlqNz4Jww (button) collected ($25)
Seat 8: K/ETAn4GnsqZgUCBm9C9PQ (small blind) folded before Flop
Seat 9: 0htPWcyi7sLFKivEsEz4Gg (big blind) folded before Flop



PokerStars Game #59961766490:  Hold'em No Limit ($5/$10) - 2009/07/01 11:21:16 ET
Table '1Dt9cpcLUVE6HYkx5dUEdQ' 6-max Seat #5 is the button
Seat 1: Xl+I49lxCJwPGRuegiaHoA ($1020 in chips)
Seat 2: zdS2zKkZYSRe8p+GVcXMgg ($1695.10 in chips)
Seat 3: Lne9leXjEzXWbU3BGFWsxQ ($1052 in chips)
Seat 4: voSAIKXtXUUbJnds83sYfQ ($1022 in chips)
Seat 5: jkH6qYMpn8JA/IyBOhQPMw ($1030 in chips)
Seat 6: 3mTlg4g0FJN2bo939h/0Wg ($1265 in chips)
3mTlg4g0FJN2bo939h/0Wg: posts small blind $5
Xl+I49lxCJwPGRuegiaHoA: posts big blind $10
*** HOLE CARDS ***
zdS2zKkZYSRe8p+GVcXMgg: calls $10
Lne9leXjEzXWbU3BGFWsxQ: folds
voSAIKXtXUUbJnds83sYfQ: raises $30 to $40
jkH6qYMpn8JA/IyBOhQPMw: calls $40
3mTlg4g0FJN2bo939h/0Wg: folds
Xl+I49lxCJwPGRuegiaHoA: folds
zdS2zKkZYSRe8p+GVcXMgg: calls $30
*** FLOP *** [Ad 2d Ac]
zdS2zKkZYSRe8p+GVcXMgg: checks
voSAIKXtXUUbJnds83sYfQ: bets $90
jkH6qYMpn8JA/IyBOhQPMw: folds
zdS2zKkZYSRe8p+GVcXMgg: folds
voSAIKXtXUUbJnds83sYfQ collected $132 from pot
*** SUMMARY ***
Total pot $135 | Rake $3
Board [Ad 2d Ac]
Seat 1: Xl+I49lxCJwPGRuegiaHoA (big blind) folded before Flop
Seat 2: zdS2zKkZYSRe8p+GVcXMgg folded on the Flop
Seat 3: Lne9leXjEzXWbU3BGFWsxQ folded before Flop (didn't bet)
Seat 4: voSAIKXtXUUbJnds83sYfQ collected ($132)
Seat 5: jkH6qYMpn8JA/IyBOhQPMw (button) folded on the Flop
Seat 6: 3mTlg4g0FJN2bo939h/0Wg (small blind) folded before Flop



PokerStars Game #59961807092:  Hold'em No Limit ($5/$10) - 2009/07/01 11:22:02 ET
Table 'AiNa6yyp/njJVRYl/Lz1KQ' 6-max Seat #5 is the button
Seat 1: Xl/zzIZf2hmO234sDWM1HQ ($200 in chips)
Seat 3: UcFkfWngu95uR8Jhrj+HrQ ($175 in chips)
Seat 4: /F5e5TKT/1B9kgJVuQttsg ($507 in chips)
Seat 5: rA+z6d5kODql7MqPYd2i4Q ($553 in chips)
Seat 6: 715lGOaseTlrgDQ1nwU86w ($244.05 in chips)
715lGOaseTlrgDQ1nwU86w: posts small blind $5
Xl/zzIZf2hmO234sDWM1HQ: posts big blind $10
efhcaDPhNqQ/H48kMHLa8w: sits out
*** HOLE CARDS ***
UcFkfWngu95uR8Jhrj+HrQ: folds
/F5e5TKT/1B9kgJVuQttsg: folds
rA+z6d5kODql7MqPYd2i4Q: folds
715lGOaseTlrgDQ1nwU86w: folds
Xl/zzIZf2hmO234sDWM1HQ collected $10 from pot
Xl/zzIZf2hmO234sDWM1HQ: doesn't show hand
*** SUMMARY ***
Total pot $10 | Rake $0
Seat 1: Xl/zzIZf2hmO234sDWM1HQ (big blind) collected ($10)
Seat 3: UcFkfWngu95uR8Jhrj+HrQ folded before Flop (didn't bet)
Seat 4: /F5e5TKT/1B9kgJVuQttsg folded before Flop (didn't bet)
Seat 5: rA+z6d5kODql7MqPYd2i4Q (button) folded before Flop (didn't bet)
Seat 6: 715lGOaseTlrgDQ1nwU86w (small blind) folded before Flop



PokerStars Game #59961821346:  Hold'em No Limit ($5/$10) - 2009/07/01 11:22:19 ET
Table 'AiNa6yyp/njJVRYl/Lz1KQ' 6-max Seat #6 is the button
Seat 1: Xl/zzIZf2hmO234sDWM1HQ ($205 in chips)
Seat 2: efhcaDPhNqQ/H48kMHLa8w ($1178.90 in chips)
Seat 3: UcFkfWngu95uR8Jhrj+HrQ ($175 in chips)
Seat 4: /F5e5TKT/1B9kgJVuQttsg ($507 in chips)
Seat 5: rA+z6d5kODql7MqPYd2i4Q ($553 in chips)
Seat 6: 715lGOaseTlrgDQ1nwU86w ($239.05 in chips)
Xl/zzIZf2hmO234sDWM1HQ: posts small blind $5
efhcaDPhNqQ/H48kMHLa8w: posts big blind $10
*** HOLE CARDS ***
UcFkfWngu95uR8Jhrj+HrQ: folds
/F5e5TKT/1B9kgJVuQttsg: folds
rA+z6d5kODql7MqPYd2i4Q: folds
715lGOaseTlrgDQ1nwU86w: raises $10 to $20
Xl/zzIZf2hmO234sDWM1HQ: calls $15
efhcaDPhNqQ/H48kMHLa8w: folds
*** FLOP *** [Ts 7s 3h]
Xl/zzIZf2hmO234sDWM1HQ: checks
715lGOaseTlrgDQ1nwU86w: bets $10
Xl/zzIZf2hmO234sDWM1HQ: raises $10 to $20
715lGOaseTlrgDQ1nwU86w: calls $10
*** TURN *** [Ts 7s 3h] [5d]
Xl/zzIZf2hmO234sDWM1HQ: checks
715lGOaseTlrgDQ1nwU86w: checks
*** RIVER *** [Ts 7s 3h 5d] [5h]
Xl/zzIZf2hmO234sDWM1HQ: bets $50
715lGOaseTlrgDQ1nwU86w: raises $149.05 to $199.05 and is all-in
Xl/zzIZf2hmO234sDWM1HQ: folds
715lGOaseTlrgDQ1nwU86w collected $187 from pot
715lGOaseTlrgDQ1nwU86w: shows [Qs 8s] (a pair of Fives)
*** SUMMARY ***
Total pot $190 | Rake $3
Board [Ts 7s 3h 5d 5h]
Seat 1: Xl/zzIZf2hmO234sDWM1HQ (small blind) folded on the River
Seat 2: efhcaDPhNqQ/H48kMHLa8w (big blind) folded before Flop
Seat 3: UcFkfWngu95uR8Jhrj+HrQ folded before Flop (didn't bet)
Seat 4: /F5e5TKT/1B9kgJVuQttsg folded before Flop (didn't bet)
Seat 5: rA+z6d5kODql7MqPYd2i4Q folded before Flop (didn't bet)
Seat 6: 715lGOaseTlrgDQ1nwU86w (button) collected ($187)



PokerStars Game #59961863388:  Hold'em No Limit ($5/$10) - 2009/07/01 11:23:09 ET
Table 'AiNa6yyp/njJVRYl/Lz1KQ' 6-max Seat #1 is the button
Seat 1: Xl/zzIZf2hmO234sDWM1HQ ($115 in chips)
Seat 2: efhcaDPhNqQ/H48kMHLa8w ($1168.90 in chips)
Seat 3: UcFkfWngu95uR8Jhrj+HrQ ($175 in chips)
Seat 4: /F5e5TKT/1B9kgJVuQttsg ($507 in chips)
Seat 5: rA+z6d5kODql7MqPYd2i4Q ($553 in chips)
Seat 6: 715lGOaseTlrgDQ1nwU86w ($336.05 in chips)
efhcaDPhNqQ/H48kMHLa8w: posts small blind $5
UcFkfWngu95uR8Jhrj+HrQ: posts big blind $10
*** HOLE CARDS ***
/F5e5TKT/1B9kgJVuQttsg: folds
rA+z6d5kODql7MqPYd2i4Q: folds
715lGOaseTlrgDQ1nwU86w: raises $10 to $20
Xl/zzIZf2hmO234sDWM1HQ: calls $20
efhcaDPhNqQ/H48kMHLa8w: folds
UcFkfWngu95uR8Jhrj+HrQ: calls $10
*** FLOP *** [9h Ts 8s]
UcFkfWngu95uR8Jhrj+HrQ: checks
715lGOaseTlrgDQ1nwU86w: checks
Xl/zzIZf2hmO234sDWM1HQ: checks
*** TURN *** [9h Ts 8s] [6c]
UcFkfWngu95uR8Jhrj+HrQ: checks
715lGOaseTlrgDQ1nwU86w: bets $10
Xl/zzIZf2hmO234sDWM1HQ: calls $10
UcFkfWngu95uR8Jhrj+HrQ: folds
*** RIVER *** [9h Ts 8s 6c] [7s]
715lGOaseTlrgDQ1nwU86w: checks
Xl/zzIZf2hmO234sDWM1HQ: bets $85 and is all-in
715lGOaseTlrgDQ1nwU86w: folds
Xl/zzIZf2hmO234sDWM1HQ collected $82 from pot
Xl/zzIZf2hmO234sDWM1HQ: shows [3d 6h] (a straight, Six to Ten)
*** SUMMARY ***
Total pot $85 | Rake $3
Board [9h Ts 8s 6c 7s]
Seat 1: Xl/zzIZf2hmO234sDWM1HQ (button) collected ($82)
Seat 2: efhcaDPhNqQ/H48kMHLa8w (small blind) folded before Flop
Seat 3: UcFkfWngu95uR8Jhrj+HrQ (big blind) folded on the Turn
Seat 4: /F5e5TKT/1B9kgJVuQttsg folded before Flop (didn't bet)
Seat 5: rA+z6d5kODql7MqPYd2i4Q folded before Flop (didn't bet)
Seat 6: 715lGOaseTlrgDQ1nwU86w folded on the River



PokerStars Game #59961863758:  Hold'em No Limit ($5/$10) - 2009/07/01 11:23:09 ET
Table 'dwLGEw3aoH/cOAI7JsLdmw' 6-max Seat #4 is the button
Seat 1: is0C+o+4W8624tMaRmJg7A ($1010 in chips)
Seat 2: 1ScqYmNf7/uWx1XSBgPTBw ($200 in chips)
Seat 3: voSAIKXtXUUbJnds83sYfQ ($1000 in chips)
Seat 4: efhcaDPhNqQ/H48kMHLa8w ($1132 in chips)
Seat 5: jkH6qYMpn8JA/IyBOhQPMw ($2103 in chips)
Seat 6: 3mTlg4g0FJN2bo939h/0Wg ($405 in chips)
jkH6qYMpn8JA/IyBOhQPMw: posts small blind $5
3mTlg4g0FJN2bo939h/0Wg: posts big blind $10
*** HOLE CARDS ***
is0C+o+4W8624tMaRmJg7A: folds
1ScqYmNf7/uWx1XSBgPTBw: folds
voSAIKXtXUUbJnds83sYfQ: raises $20 to $30
efhcaDPhNqQ/H48kMHLa8w: calls $30
jkH6qYMpn8JA/IyBOhQPMw: folds
3mTlg4g0FJN2bo939h/0Wg: folds
*** FLOP *** [3h 8c 9s]
voSAIKXtXUUbJnds83sYfQ: checks
efhcaDPhNqQ/H48kMHLa8w: bets $50
voSAIKXtXUUbJnds83sYfQ: calls $50
*** TURN *** [3h 8c 9s] [7s]
voSAIKXtXUUbJnds83sYfQ: checks
efhcaDPhNqQ/H48kMHLa8w: checks
*** RIVER *** [3h 8c 9s 7s] [Kd]
voSAIKXtXUUbJnds83sYfQ: checks
efhcaDPhNqQ/H48kMHLa8w: checks
*** SHOW DOWN ***
voSAIKXtXUUbJnds83sYfQ: shows [8d 6d] (a pair of Eights)
efhcaDPhNqQ/H48kMHLa8w: mucks hand
voSAIKXtXUUbJnds83sYfQ collected $172 from pot
*** SUMMARY ***
Total pot $175 | Rake $3
Board [3h 8c 9s 7s Kd]
Seat 1: is0C+o+4W8624tMaRmJg7A folded before Flop (didn't bet)
Seat 2: 1ScqYmNf7/uWx1XSBgPTBw folded before Flop (didn't bet)
Seat 3: voSAIKXtXUUbJnds83sYfQ showed [8d 6d] and won ($172) with a pair of Eights
Seat 4: efhcaDPhNqQ/H48kMHLa8w (button) mucked
Seat 5: jkH6qYMpn8JA/IyBOhQPMw (small blind) folded before Flop
Seat 6: 3mTlg4g0FJN2bo939h/0Wg (big blind) folded before Flop



PokerStars Game #59961865496:  Hold'em No Limit ($5/$10) - 2009/07/01 11:23:11 ET
Table 'mRZYYSuRGoc67ZWgmXfShQ' 2-max Seat #1 is the button
Seat 1: lGaYjQwYaExY0I2oaRr1fw ($710 in chips)
Seat 2: 1s1h7qXmZxmowl9P1VNe2Q ($190 in chips)
lGaYjQwYaExY0I2oaRr1fw: posts small blind $5
1s1h7qXmZxmowl9P1VNe2Q: posts big blind $10
*** HOLE CARDS ***
lGaYjQwYaExY0I2oaRr1fw: raises $20 to $30
1s1h7qXmZxmowl9P1VNe2Q: calls $20
*** FLOP *** [Tc 5h 5d]
1s1h7qXmZxmowl9P1VNe2Q: checks
lGaYjQwYaExY0I2oaRr1fw: bets $40
1s1h7qXmZxmowl9P1VNe2Q: folds
lGaYjQwYaExY0I2oaRr1fw collected $59.50 from pot
lGaYjQwYaExY0I2oaRr1fw is sitting out
*** SUMMARY ***
Total pot $60 | Rake $0.50
Board [Tc 5h 5d]
Seat 1: lGaYjQwYaExY0I2oaRr1fw (button) (small blind) collected ($59.50)
Seat 2: 1s1h7qXmZxmowl9P1VNe2Q (big blind) folded on the Flop



PokerStars Game #59961866132:  Hold'em No Limit ($5/$10) - 2009/07/01 11:23:12 ET
Table '1Dt9cpcLUVE6HYkx5dUEdQ' 6-max Seat #6 is the button
Seat 1: Xl+I49lxCJwPGRuegiaHoA ($1010 in chips)
Seat 2: zdS2zKkZYSRe8p+GVcXMgg ($1655.10 in chips)
Seat 3: Lne9leXjEzXWbU3BGFWsxQ ($1052 in chips)
Seat 4: voSAIKXtXUUbJnds83sYfQ ($1114 in chips)
Seat 5: jkH6qYMpn8JA/IyBOhQPMw ($1000 in chips)
Seat 6: 3mTlg4g0FJN2bo939h/0Wg ($1260 in chips)
Xl+I49lxCJwPGRuegiaHoA: posts small blind $5
zdS2zKkZYSRe8p+GVcXMgg: posts big blind $10
*** HOLE CARDS ***
Lne9leXjEzXWbU3BGFWsxQ: folds
voSAIKXtXUUbJnds83sYfQ: folds
jkH6qYMpn8JA/IyBOhQPMw: raises $20 to $30
3mTlg4g0FJN2bo939h/0Wg: folds
Xl+I49lxCJwPGRuegiaHoA: calls $25
zdS2zKkZYSRe8p+GVcXMgg: calls $20
*** FLOP *** [4h 2c 4d]
Xl+I49lxCJwPGRuegiaHoA: checks
zdS2zKkZYSRe8p+GVcXMgg: checks
jkH6qYMpn8JA/IyBOhQPMw: checks
*** TURN *** [4h 2c 4d] [6d]
Xl+I49lxCJwPGRuegiaHoA: checks
zdS2zKkZYSRe8p+GVcXMgg: checks
jkH6qYMpn8JA/IyBOhQPMw: bets $62
Xl+I49lxCJwPGRuegiaHoA: folds
zdS2zKkZYSRe8p+GVcXMgg: folds
jkH6qYMpn8JA/IyBOhQPMw collected $87 from pot
*** SUMMARY ***
Total pot $90 | Rake $3
Board [4h 2c 4d 6d]
Seat 1: Xl+I49lxCJwPGRuegiaHoA (small blind) folded on the Turn
Seat 2: zdS2zKkZYSRe8p+GVcXMgg (big blind) folded on the Turn
Seat 3: Lne9leXjEzXWbU3BGFWsxQ folded before Flop (didn't bet)
Seat 4: voSAIKXtXUUbJnds83sYfQ folded before Flop (didn't bet)
Seat 5: jkH6qYMpn8JA/IyBOhQPMw collected ($87)
Seat 6: 3mTlg4g0FJN2bo939h/0Wg (button) folded before Flop (didn't bet)



PokerStars Game #59961916494:  Hold'em No Limit ($5/$10) - 2009/07/01 11:24:09 ET
Table 'AiNa6yyp/njJVRYl/Lz1KQ' 6-max Seat #2 is the button
Seat 1: Xl/zzIZf2hmO234sDWM1HQ ($167 in chips)
Seat 2: efhcaDPhNqQ/H48kMHLa8w ($1163.90 in chips)
Seat 3: UcFkfWngu95uR8Jhrj+HrQ ($155 in chips)
Seat 4: /F5e5TKT/1B9kgJVuQttsg ($507 in chips)
Seat 5: rA+z6d5kODql7MqPYd2i4Q ($553 in chips)
Seat 6: 715lGOaseTlrgDQ1nwU86w ($306.05 in chips)
UcFkfWngu95uR8Jhrj+HrQ: posts small blind $5
/F5e5TKT/1B9kgJVuQttsg: posts big blind $10
*** HOLE CARDS ***
rA+z6d5kODql7MqPYd2i4Q: folds
715lGOaseTlrgDQ1nwU86w: folds
Xl/zzIZf2hmO234sDWM1HQ: folds
efhcaDPhNqQ/H48kMHLa8w: folds
UcFkfWngu95uR8Jhrj+HrQ: calls $5
/F5e5TKT/1B9kgJVuQttsg: raises $20 to $30
UcFkfWngu95uR8Jhrj+HrQ: raises $125 to $155 and is all-in
/F5e5TKT/1B9kgJVuQttsg: calls $125
*** FLOP *** [4d 5s 5c]
*** TURN *** [4d 5s 5c] [2c]
*** RIVER *** [4d 5s 5c 2c] [Ts]
*** SHOW DOWN ***
UcFkfWngu95uR8Jhrj+HrQ: shows [3s Ac] (a straight, Ace to Five)
/F5e5TKT/1B9kgJVuQttsg: mucks hand
UcFkfWngu95uR8Jhrj+HrQ collected $307 from pot
*** SUMMARY ***
Total pot $310 | Rake $3
Board [4d 5s 5c 2c Ts]
Seat 1: Xl/zzIZf2hmO234sDWM1HQ folded before Flop (didn't bet)
Seat 2: efhcaDPhNqQ/H48kMHLa8w (button) folded before Flop (didn't bet)
Seat 3: UcFkfWngu95uR8Jhrj+HrQ (small blind) showed [3s Ac] and won ($307) with a straight, Ace to Five
Seat 4: /F5e5TKT/1B9kgJVuQttsg (big blind) mucked
Seat 5: rA+z6d5kODql7MqPYd2i4Q folded before Flop (didn't bet)
Seat 6: 715lGOaseTlrgDQ1nwU86w folded before Flop (didn't bet)



PokerStars Game #59961921288:  Hold'em No Limit ($5/$10) - 2009/07/01 11:24:15 ET
Table 'dwLGEw3aoH/cOAI7JsLdmw' 6-max Seat #5 is the button
Seat 1: is0C+o+4W8624tMaRmJg7A ($1010 in chips)
Seat 2: 1ScqYmNf7/uWx1XSBgPTBw ($200 in chips)
Seat 3: voSAIKXtXUUbJnds83sYfQ ($1092 in chips)
Seat 4: efhcaDPhNqQ/H48kMHLa8w ($1052 in chips)
Seat 5: jkH6qYMpn8JA/IyBOhQPMw ($2098 in chips)
Seat 6: 3mTlg4g0FJN2bo939h/0Wg ($395 in chips)
3mTlg4g0FJN2bo939h/0Wg: posts small blind $5
is0C+o+4W8624tMaRmJg7A: posts big blind $10
*** HOLE CARDS ***
1ScqYmNf7/uWx1XSBgPTBw: folds
voSAIKXtXUUbJnds83sYfQ: folds
efhcaDPhNqQ/H48kMHLa8w: folds
jkH6qYMpn8JA/IyBOhQPMw: folds
3mTlg4g0FJN2bo939h/0Wg: calls $5
is0C+o+4W8624tMaRmJg7A: checks
*** FLOP *** [Qd 8d 7c]
3mTlg4g0FJN2bo939h/0Wg: checks
is0C+o+4W8624tMaRmJg7A: checks
*** TURN *** [Qd 8d 7c] [Tc]
3mTlg4g0FJN2bo939h/0Wg: bets $20
3mTlg4g0FJN2bo939h/0Wg said, "what a ****ing joke site"
3mTlg4g0FJN2bo939h/0Wg said, "crazy"
is0C+o+4W8624tMaRmJg7A: calls $20
*** RIVER *** [Qd 8d 7c Tc] [Ts]
3mTlg4g0FJN2bo939h/0Wg: bets $50
is0C+o+4W8624tMaRmJg7A: calls $50
*** SHOW DOWN ***
3mTlg4g0FJN2bo939h/0Wg: shows [3h Td] (three of a kind, Tens)
is0C+o+4W8624tMaRmJg7A: mucks hand
3mTlg4g0FJN2bo939h/0Wg collected $157 from pot
*** SUMMARY ***
Total pot $160 | Rake $3
Board [Qd 8d 7c Tc Ts]
Seat 1: is0C+o+4W8624tMaRmJg7A (big blind) mucked
Seat 2: 1ScqYmNf7/uWx1XSBgPTBw folded before Flop (didn't bet)
Seat 3: voSAIKXtXUUbJnds83sYfQ folded before Flop (didn't bet)
Seat 4: efhcaDPhNqQ/H48kMHLa8w folded before Flop (didn't bet)
Seat 5: jkH6qYMpn8JA/IyBOhQPMw (button) folded before Flop (didn't bet)
Seat 6: 3mTlg4g0FJN2bo939h/0Wg (small blind) showed [3h Td] and won ($157) with three of a kind, Tens



PokerStars Game #59961934622:  Hold'em No Limit ($5/$10) - 2009/07/01 11:24:30 ET
Table '1Dt9cpcLUVE6HYkx5dUEdQ' 6-max Seat #1 is the button
Seat 1: Xl+I49lxCJwPGRuegiaHoA ($1000 in chips)
Seat 2: zdS2zKkZYSRe8p+GVcXMgg ($1625.10 in chips)
Seat 3: Lne9leXjEzXWbU3BGFWsxQ ($1052 in chips)
Seat 4: voSAIKXtXUUbJnds83sYfQ ($1114 in chips)
Seat 5: jkH6qYMpn8JA/IyBOhQPMw ($1057 in chips)
Seat 6: 3mTlg4g0FJN2bo939h/0Wg ($1260 in chips)
zdS2zKkZYSRe8p+GVcXMgg: posts small blind $5
Lne9leXjEzXWbU3BGFWsxQ: posts big blind $10
*** HOLE CARDS ***
voSAIKXtXUUbJnds83sYfQ: raises $20 to $30
jkH6qYMpn8JA/IyBOhQPMw: raises $70 to $100
3mTlg4g0FJN2bo939h/0Wg: folds
Xl+I49lxCJwPGRuegiaHoA: folds
zdS2zKkZYSRe8p+GVcXMgg: folds
Lne9leXjEzXWbU3BGFWsxQ: folds
voSAIKXtXUUbJnds83sYfQ: folds
jkH6qYMpn8JA/IyBOhQPMw collected $75 from pot
*** SUMMARY ***
Total pot $75 | Rake $0
Seat 1: Xl+I49lxCJwPGRuegiaHoA (button) folded before Flop (didn't bet)
Seat 2: zdS2zKkZYSRe8p+GVcXMgg (small blind) folded before Flop
Seat 3: Lne9leXjEzXWbU3BGFWsxQ (big blind) folded before Flop
Seat 4: voSAIKXtXUUbJnds83sYfQ folded before Flop
Seat 5: jkH6qYMpn8JA/IyBOhQPMw collected ($75)
Seat 6: 3mTlg4g0FJN2bo939h/0Wg folded before Flop (didn't bet)



PokerStars Game #59961950274:  Hold'em No Limit ($5/$10) - 2009/07/01 11:24:48 ET
Table 'AiNa6yyp/njJVRYl/Lz1KQ' 6-max Seat #3 is the button
Seat 1: Xl/zzIZf2hmO234sDWM1HQ ($167 in chips)
Seat 2: efhcaDPhNqQ/H48kMHLa8w ($1163.90 in chips)
Seat 3: UcFkfWngu95uR8Jhrj+HrQ ($307 in chips)
Seat 4: /F5e5TKT/1B9kgJVuQttsg ($352 in chips)
Seat 5: rA+z6d5kODql7MqPYd2i4Q ($553 in chips)
Seat 6: 715lGOaseTlrgDQ1nwU86w ($306.05 in chips)
/F5e5TKT/1B9kgJVuQttsg: posts small blind $5
rA+z6d5kODql7MqPYd2i4Q: posts big blind $10
*** HOLE CARDS ***
715lGOaseTlrgDQ1nwU86w: folds
Xl/zzIZf2hmO234sDWM1HQ: folds
efhcaDPhNqQ/H48kMHLa8w: folds
UcFkfWngu95uR8Jhrj+HrQ: folds
/F5e5TKT/1B9kgJVuQttsg: raises $10 to $20
rA+z6d5kODql7MqPYd2i4Q: folds
/F5e5TKT/1B9kgJVuQttsg collected $20 from pot
/F5e5TKT/1B9kgJVuQttsg: doesn't show hand
*** SUMMARY ***
Total pot $20 | Rake $0
Seat 1: Xl/zzIZf2hmO234sDWM1HQ folded before Flop (didn't bet)
Seat 2: efhcaDPhNqQ/H48kMHLa8w folded before Flop (didn't bet)
Seat 3: UcFkfWngu95uR8Jhrj+HrQ (button) folded before Flop (didn't bet)
Seat 4: /F5e5TKT/1B9kgJVuQttsg (small blind) collected ($20)
Seat 5: rA+z6d5kODql7MqPYd2i4Q (big blind) folded before Flop
Seat 6: 715lGOaseTlrgDQ1nwU86w folded before Flop (didn't bet)



PokerStars Game #59961960010:  Hold'em No Limit ($5/$10) - 2009/07/01 11:24:59 ET
Table '1Dt9cpcLUVE6HYkx5dUEdQ' 6-max Seat #2 is the button
Seat 1: Xl+I49lxCJwPGRuegiaHoA ($1000 in chips)
Seat 2: zdS2zKkZYSRe8p+GVcXMgg ($1620.10 in chips)
Seat 3: Lne9leXjEzXWbU3BGFWsxQ ($1042 in chips)
Seat 4: voSAIKXtXUUbJnds83sYfQ ($1084 in chips)
Seat 5: jkH6qYMpn8JA/IyBOhQPMw ($1102 in chips)
Seat 6: 3mTlg4g0FJN2bo939h/0Wg ($1260 in chips)
Lne9leXjEzXWbU3BGFWsxQ: posts small blind $5
voSAIKXtXUUbJnds83sYfQ: posts big blind $10
*** HOLE CARDS ***
jkH6qYMpn8JA/IyBOhQPMw: folds
3mTlg4g0FJN2bo939h/0Wg: folds
Xl+I49lxCJwPGRuegiaHoA: folds
zdS2zKkZYSRe8p+GVcXMgg: folds
Lne9leXjEzXWbU3BGFWsxQ: folds
voSAIKXtXUUbJnds83sYfQ collected $10 from pot
*** SUMMARY ***
Total pot $10 | Rake $0
Seat 1: Xl+I49lxCJwPGRuegiaHoA folded before Flop (didn't bet)
Seat 2: zdS2zKkZYSRe8p+GVcXMgg (button) folded before Flop (didn't bet)
Seat 3: Lne9leXjEzXWbU3BGFWsxQ (small blind) folded before Flop
Seat 4: voSAIKXtXUUbJnds83sYfQ (big blind) collected ($10)
Seat 5: jkH6qYMpn8JA/IyBOhQPMw folded before Flop (didn't bet)
Seat 6: 3mTlg4g0FJN2bo939h/0Wg folded before Flop (didn't bet)



PokerStars Game #59961965716:  Hold'em No Limit ($5/$10) - 2009/07/01 11:25:06 ET
Table 'AiNa6yyp/njJVRYl/Lz1KQ' 6-max Seat #4 is the button
Seat 1: Xl/zzIZf2hmO234sDWM1HQ ($167 in chips)
Seat 2: efhcaDPhNqQ/H48kMHLa8w ($1163.90 in chips)
Seat 3: UcFkfWngu95uR8Jhrj+HrQ ($307 in chips)
Seat 4: /F5e5TKT/1B9kgJVuQttsg ($362 in chips)
Seat 5: rA+z6d5kODql7MqPYd2i4Q ($543 in chips)
Seat 6: 715lGOaseTlrgDQ1nwU86w ($306.05 in chips)
rA+z6d5kODql7MqPYd2i4Q: posts small blind $5
715lGOaseTlrgDQ1nwU86w: posts big blind $10
*** HOLE CARDS ***
Xl/zzIZf2hmO234sDWM1HQ: calls $10
efhcaDPhNqQ/H48kMHLa8w: folds
UcFkfWngu95uR8Jhrj+HrQ: folds
/F5e5TKT/1B9kgJVuQttsg: folds
rA+z6d5kODql7MqPYd2i4Q: folds
715lGOaseTlrgDQ1nwU86w: checks
*** FLOP *** [7c Qc 9h]
715lGOaseTlrgDQ1nwU86w: checks
Xl/zzIZf2hmO234sDWM1HQ: bets $20
715lGOaseTlrgDQ1nwU86w: folds
Xl/zzIZf2hmO234sDWM1HQ collected $23.75 from pot
Xl/zzIZf2hmO234sDWM1HQ: doesn't show hand
*** SUMMARY ***
Total pot $25 | Rake $1.25
Board [7c Qc 9h]
Seat 1: Xl/zzIZf2hmO234sDWM1HQ collected ($23.75)
Seat 2: efhcaDPhNqQ/H48kMHLa8w folded before Flop (didn't bet)
Seat 3: UcFkfWngu95uR8Jhrj+HrQ folded before Flop (didn't bet)
Seat 4: /F5e5TKT/1B9kgJVuQttsg (button) folded before Flop (didn't bet)
Seat 5: rA+z6d5kODql7MqPYd2i4Q (small blind) folded before Flop
Seat 6: 715lGOaseTlrgDQ1nwU86w (big blind) folded on the Flop



PokerStars Game #59961970444:  Hold'em No Limit ($5/$10) - 2009/07/01 11:25:11 ET
Table '2a86NK3xhs21kwGZmbj0QA' 6-max Seat #3 is the button
Seat 1: is0C+o+4W8624tMaRmJg7A ($1042 in chips)
Seat 2: Xl+I49lxCJwPGRuegiaHoA ($2556 in chips)
Seat 3: voSAIKXtXUUbJnds83sYfQ ($1047 in chips)
Seat 5: jkH6qYMpn8JA/IyBOhQPMw ($1729.25 in chips)
Seat 6: 0OfLwED3kKs3FwY+JlHC0g ($1132 in chips)
1ScqYmNf7/uWx1XSBgPTBw will be allowed to play after the button
jkH6qYMpn8JA/IyBOhQPMw: posts small blind $5
0OfLwED3kKs3FwY+JlHC0g: posts big blind $10
*** HOLE CARDS ***
is0C+o+4W8624tMaRmJg7A: folds
Xl+I49lxCJwPGRuegiaHoA: folds
voSAIKXtXUUbJnds83sYfQ: raises $20 to $30
jkH6qYMpn8JA/IyBOhQPMw: folds
0OfLwED3kKs3FwY+JlHC0g: raises $80 to $110
voSAIKXtXUUbJnds83sYfQ: folds
0OfLwED3kKs3FwY+JlHC0g collected $65 from pot
0OfLwED3kKs3FwY+JlHC0g: doesn't show hand
*** SUMMARY ***
Total pot $65 | Rake $0
Seat 1: is0C+o+4W8624tMaRmJg7A folded before Flop (didn't bet)
Seat 2: Xl+I49lxCJwPGRuegiaHoA folded before Flop (didn't bet)
Seat 3: voSAIKXtXUUbJnds83sYfQ (button) folded before Flop
Seat 5: jkH6qYMpn8JA/IyBOhQPMw (small blind) folded before Flop
Seat 6: 0OfLwED3kKs3FwY+JlHC0g (big blind) collected ($65)



PokerStars Game #59961978928:  Hold'em No Limit ($5/$10) - 2009/07/01 11:25:21 ET
Table '1Dt9cpcLUVE6HYkx5dUEdQ' 6-max Seat #3 is the button
Seat 1: Xl+I49lxCJwPGRuegiaHoA ($1000 in chips)
Seat 2: zdS2zKkZYSRe8p+GVcXMgg ($1620.10 in chips)
Seat 3: Lne9leXjEzXWbU3BGFWsxQ ($1037 in chips)
Seat 4: voSAIKXtXUUbJnds83sYfQ ($1089 in chips)
Seat 5: jkH6qYMpn8JA/IyBOhQPMw ($1102 in chips)
Seat 6: 3mTlg4g0FJN2bo939h/0Wg ($1260 in chips)
voSAIKXtXUUbJnds83sYfQ: posts small blind $5
jkH6qYMpn8JA/IyBOhQPMw: posts big blind $10
*** HOLE CARDS ***
3mTlg4g0FJN2bo939h/0Wg: folds
Xl+I49lxCJwPGRuegiaHoA: raises $20 to $30
zdS2zKkZYSRe8p+GVcXMgg: calls $30
Lne9leXjEzXWbU3BGFWsxQ: folds
voSAIKXtXUUbJnds83sYfQ: folds
jkH6qYMpn8JA/IyBOhQPMw: folds
*** FLOP *** [Qh Kh 3d]
Xl+I49lxCJwPGRuegiaHoA: bets $50
zdS2zKkZYSRe8p+GVcXMgg: calls $50
*** TURN *** [Qh Kh 3d] [6h]
Xl+I49lxCJwPGRuegiaHoA: checks
zdS2zKkZYSRe8p+GVcXMgg: checks
*** RIVER *** [Qh Kh 3d 6h] [Qs]
Xl+I49lxCJwPGRuegiaHoA: checks
zdS2zKkZYSRe8p+GVcXMgg: bets $50
Xl+I49lxCJwPGRuegiaHoA: calls $50
*** SHOW DOWN ***
zdS2zKkZYSRe8p+GVcXMgg: shows [7s 7h] (two pair, Queens and Sevens)
Xl+I49lxCJwPGRuegiaHoA: mucks hand
zdS2zKkZYSRe8p+GVcXMgg collected $272 from pot
*** SUMMARY ***
Total pot $275 | Rake $3
Board [Qh Kh 3d 6h Qs]
Seat 1: Xl+I49lxCJwPGRuegiaHoA mucked
Seat 2: zdS2zKkZYSRe8p+GVcXMgg showed [7s 7h] and won ($272) with two pair, Queens and Sevens
Seat 3: Lne9leXjEzXWbU3BGFWsxQ (button) folded before Flop (didn't bet)
Seat 4: voSAIKXtXUUbJnds83sYfQ (small blind) folded before Flop
Seat 5: jkH6qYMpn8JA/IyBOhQPMw (big blind) folded before Flop
Seat 6: 3mTlg4g0FJN2bo939h/0Wg folded before Flop (didn't bet)



PokerStars Game #59961982024:  Hold'em No Limit ($5/$10) - 2009/07/01 11:25:24 ET
Table 'dwLGEw3aoH/cOAI7JsLdmw' 6-max Seat #6 is the button
Seat 1: is0C+o+4W8624tMaRmJg7A ($1000 in chips)
Seat 2: 1ScqYmNf7/uWx1XSBgPTBw ($200 in chips)
Seat 3: voSAIKXtXUUbJnds83sYfQ ($1092 in chips)
Seat 4: efhcaDPhNqQ/H48kMHLa8w ($1052 in chips)
Seat 5: jkH6qYMpn8JA/IyBOhQPMw ($2098 in chips)
Seat 6: 3mTlg4g0FJN2bo939h/0Wg ($472 in chips)
is0C+o+4W8624tMaRmJg7A: posts small blind $5
1ScqYmNf7/uWx1XSBgPTBw: posts big blind $10
*** HOLE CARDS ***
voSAIKXtXUUbJnds83sYfQ: folds
jkH6qYMpn8JA/IyBOhQPMw said, "do you know whats funny"
efhcaDPhNqQ/H48kMHLa8w: folds
jkH6qYMpn8JA/IyBOhQPMw said, "around 5 hours ago"
jkH6qYMpn8JA/IyBOhQPMw: folds
3mTlg4g0FJN2bo939h/0Wg: raises $20 to $30
is0C+o+4W8624tMaRmJg7A: folds
jkH6qYMpn8JA/IyBOhQPMw said, "i lost exactly Kk vs 89s  all-in pf vs some random guy"
1ScqYmNf7/uWx1XSBgPTBw: folds
3mTlg4g0FJN2bo939h/0Wg collected $25 from pot
*** SUMMARY ***
Total pot $25 | Rake $0
Seat 1: is0C+o+4W8624tMaRmJg7A (small blind) folded before Flop
Seat 2: 1ScqYmNf7/uWx1XSBgPTBw (big blind) folded before Flop
Seat 3: voSAIKXtXUUbJnds83sYfQ folded before Flop (didn't bet)
Seat 4: efhcaDPhNqQ/H48kMHLa8w folded before Flop (didn't bet)
Seat 5: jkH6qYMpn8JA/IyBOhQPMw folded before Flop (didn't bet)
Seat 6: 3mTlg4g0FJN2bo939h/0Wg (button) collected ($25)



PokerStars Game #59961988250:  Hold'em No Limit ($5/$10) - 2009/07/01 11:25:31 ET
Table 'AiNa6yyp/njJVRYl/Lz1KQ' 6-max Seat #5 is the button
Seat 1: Xl/zzIZf2hmO234sDWM1HQ ($180.75 in chips)
Seat 2: efhcaDPhNqQ/H48kMHLa8w ($1163.90 in chips)
Seat 3: UcFkfWngu95uR8Jhrj+HrQ ($307 in chips)
Seat 4: /F5e5TKT/1B9kgJVuQttsg ($362 in chips)
Seat 5: rA+z6d5kODql7MqPYd2i4Q ($538 in chips)
Seat 6: 715lGOaseTlrgDQ1nwU86w ($296.05 in chips)
715lGOaseTlrgDQ1nwU86w: posts small blind $5
Xl/zzIZf2hmO234sDWM1HQ: posts big blind $10
*** HOLE CARDS ***
efhcaDPhNqQ/H48kMHLa8w: folds
UcFkfWngu95uR8Jhrj+HrQ: folds
/F5e5TKT/1B9kgJVuQttsg: folds
rA+z6d5kODql7MqPYd2i4Q: folds
715lGOaseTlrgDQ1nwU86w: folds
Xl/zzIZf2hmO234sDWM1HQ collected $10 from pot
*** SUMMARY ***
Total pot $10 | Rake $0
Seat 1: Xl/zzIZf2hmO234sDWM1HQ (big blind) collected ($10)
Seat 2: efhcaDPhNqQ/H48kMHLa8w folded before Flop (didn't bet)
Seat 3: UcFkfWngu95uR8Jhrj+HrQ folded before Flop (didn't bet)
Seat 4: /F5e5TKT/1B9kgJVuQttsg folded before Flop (didn't bet)
Seat 5: rA+z6d5kODql7MqPYd2i4Q (button) folded before Flop (didn't bet)
Seat 6: 715lGOaseTlrgDQ1nwU86w (small blind) folded before Flop



PokerStars Game #59961995044:  Hold'em No Limit ($5/$10) - 2009/07/01 11:25:39 ET
Table '2a86NK3xhs21kwGZmbj0QA' 6-max Seat #5 is the button
Seat 1: is0C+o+4W8624tMaRmJg7A ($1042 in chips)
Seat 2: Xl+I49lxCJwPGRuegiaHoA ($2556 in chips)
Seat 3: voSAIKXtXUUbJnds83sYfQ ($1017 in chips)
Seat 5: jkH6qYMpn8JA/IyBOhQPMw ($1724.25 in chips)
Seat 6: 0OfLwED3kKs3FwY+JlHC0g ($1167 in chips)
0OfLwED3kKs3FwY+JlHC0g: posts small blind $5
is0C+o+4W8624tMaRmJg7A: posts big blind $10
1ScqYmNf7/uWx1XSBgPTBw: sits out
*** HOLE CARDS ***
Xl+I49lxCJwPGRuegiaHoA: folds
voSAIKXtXUUbJnds83sYfQ: folds
jkH6qYMpn8JA/IyBOhQPMw: raises $20 to $30
0OfLwED3kKs3FwY+JlHC0g: raises $80 to $110
is0C+o+4W8624tMaRmJg7A: folds
jkH6qYMpn8JA/IyBOhQPMw: calls $80
*** FLOP *** [6h Ks 5d]
0OfLwED3kKs3FwY+JlHC0g: bets $140
jkH6qYMpn8JA/IyBOhQPMw: folds
0OfLwED3kKs3FwY+JlHC0g collected $228 from pot
*** SUMMARY ***
Total pot $230 | Rake $2
Board [6h Ks 5d]
Seat 1: is0C+o+4W8624tMaRmJg7A (big blind) folded before Flop
Seat 2: Xl+I49lxCJwPGRuegiaHoA folded before Flop (didn't bet)
Seat 3: voSAIKXtXUUbJnds83sYfQ folded before Flop (didn't bet)
Seat 5: jkH6qYMpn8JA/IyBOhQPMw (button) folded on the Flop
Seat 6: 0OfLwED3kKs3FwY+JlHC0g (small blind) collected ($228)



PokerStars Game #59962004654:  Hold'em No Limit ($5/$10) - 2009/07/01 11:25:50 ET
Table 'AiNa6yyp/njJVRYl/Lz1KQ' 6-max Seat #6 is the button
Seat 1: Xl/zzIZf2hmO234sDWM1HQ ($185.75 in chips)
Seat 4: /F5e5TKT/1B9kgJVuQttsg ($362 in chips)
Seat 5: rA+z6d5kODql7MqPYd2i4Q ($538 in chips)
Seat 6: 715lGOaseTlrgDQ1nwU86w ($291.05 in chips)
Xl/zzIZf2hmO234sDWM1HQ: posts small blind $5
efhcaDPhNqQ/H48kMHLa8w: is sitting out
UcFkfWngu95uR8Jhrj+HrQ: is sitting out
/F5e5TKT/1B9kgJVuQttsg: posts big blind $10
*** HOLE CARDS ***
UcFkfWngu95uR8Jhrj+HrQ has returned
efhcaDPhNqQ/H48kMHLa8w leaves the table
rA+z6d5kODql7MqPYd2i4Q: raises $10 to $20
UcFkfWngu95uR8Jhrj+HrQ leaves the table
715lGOaseTlrgDQ1nwU86w: calls $20
Xl/zzIZf2hmO234sDWM1HQ: calls $15
/F5e5TKT/1B9kgJVuQttsg: folds
*** FLOP *** [3c 4s Jh]
Xl/zzIZf2hmO234sDWM1HQ: checks
1s1h7qXmZxmowl9P1VNe2Q joins the table at seat #2
rA+z6d5kODql7MqPYd2i4Q: bets $40
715lGOaseTlrgDQ1nwU86w: folds
Xl/zzIZf2hmO234sDWM1HQ: folds
rA+z6d5kODql7MqPYd2i4Q collected $68 from pot
rA+z6d5kODql7MqPYd2i4Q: doesn't show hand
*** SUMMARY ***
Total pot $70 | Rake $2
Board [3c 4s Jh]
Seat 1: Xl/zzIZf2hmO234sDWM1HQ (small blind) folded on the Flop
Seat 4: /F5e5TKT/1B9kgJVuQttsg (big blind) folded before Flop
Seat 5: rA+z6d5kODql7MqPYd2i4Q collected ($68)
Seat 6: 715lGOaseTlrgDQ1nwU86w (button) folded on the Flop



PokerStars Game #59962008718:  Hold'em No Limit ($5/$10) - 2009/07/01 11:25:55 ET
Table 'dwLGEw3aoH/cOAI7JsLdmw' 6-max Seat #1 is the button
Seat 1: is0C+o+4W8624tMaRmJg7A ($1000 in chips)
Seat 2: 1ScqYmNf7/uWx1XSBgPTBw ($190 in chips)
Seat 3: voSAIKXtXUUbJnds83sYfQ ($1092 in chips)
Seat 4: efhcaDPhNqQ/H48kMHLa8w ($1052 in chips)
Seat 5: jkH6qYMpn8JA/IyBOhQPMw ($2098 in chips)
Seat 6: 3mTlg4g0FJN2bo939h/0Wg ($487 in chips)
1ScqYmNf7/uWx1XSBgPTBw: posts small blind $5
voSAIKXtXUUbJnds83sYfQ: posts big blind $10
*** HOLE CARDS ***
efhcaDPhNqQ/H48kMHLa8w: folds
jkH6qYMpn8JA/IyBOhQPMw: folds
jkH6qYMpn8JA/IyBOhQPMw said, "it just evened out : p"
3mTlg4g0FJN2bo939h/0Wg said, "what you give us when we raise unbelievable"
3mTlg4g0FJN2bo939h/0Wg: folds
is0C+o+4W8624tMaRmJg7A: folds
1ScqYmNf7/uWx1XSBgPTBw: folds
voSAIKXtXUUbJnds83sYfQ collected $10 from pot
*** SUMMARY ***
Total pot $10 | Rake $0
Seat 1: is0C+o+4W8624tMaRmJg7A (button) folded before Flop (didn't bet)
Seat 2: 1ScqYmNf7/uWx1XSBgPTBw (small blind) folded before Flop
Seat 3: voSAIKXtXUUbJnds83sYfQ (big blind) collected ($10)
Seat 4: efhcaDPhNqQ/H48kMHLa8w folded before Flop (didn't bet)
Seat 5: jkH6qYMpn8JA/IyBOhQPMw folded before Flop (didn't bet)
Seat 6: 3mTlg4g0FJN2bo939h/0Wg folded before Flop (didn't bet)



PokerStars Game #59962024440:  Hold'em No Limit ($5/$10) - 2009/07/01 11:26:13 ET
Table 'AiNa6yyp/njJVRYl/Lz1KQ' 6-max Seat #1 is the button
Seat 1: Xl/zzIZf2hmO234sDWM1HQ ($165.75 in chips)
Seat 4: /F5e5TKT/1B9kgJVuQttsg ($352 in chips)
Seat 5: rA+z6d5kODql7MqPYd2i4Q ($586 in chips)
Seat 6: 715lGOaseTlrgDQ1nwU86w ($271.05 in chips)
1s1h7qXmZxmowl9P1VNe2Q will be allowed to play after the button
/F5e5TKT/1B9kgJVuQttsg: posts small blind $5
rA+z6d5kODql7MqPYd2i4Q: posts big blind $10
*** HOLE CARDS ***
fs6KvO7rGEyw4MYb4z5cQQ joins the table at seat #3
715lGOaseTlrgDQ1nwU86w: raises $10 to $20
Xl/zzIZf2hmO234sDWM1HQ: calls $20
/F5e5TKT/1B9kgJVuQttsg: raises $140 to $160
rA+z6d5kODql7MqPYd2i4Q: folds
715lGOaseTlrgDQ1nwU86w: folds
Xl/zzIZf2hmO234sDWM1HQ: calls $140
*** FLOP *** [9h 5s 3h]
/F5e5TKT/1B9kgJVuQttsg: bets $50
Xl/zzIZf2hmO234sDWM1HQ: calls $5.75 and is all-in
*** TURN *** [9h 5s 3h] [6d]
*** RIVER *** [9h 5s 3h 6d] [Kh]
*** SHOW DOWN ***
/F5e5TKT/1B9kgJVuQttsg: shows [Js Ad] (high card Ace)
Xl/zzIZf2hmO234sDWM1HQ: shows [Ks 9s] (two pair, Kings and Nines)
Xl/zzIZf2hmO234sDWM1HQ collected $359.50 from pot
*** SUMMARY ***
Total pot $361.50 | Rake $2
Board [9h 5s 3h 6d Kh]
Seat 1: Xl/zzIZf2hmO234sDWM1HQ (button) showed [Ks 9s] and won ($359.50) with two pair, Kings and Nines
Seat 4: /F5e5TKT/1B9kgJVuQttsg (small blind) showed [Js Ad] and lost with high card Ace
Seat 5: rA+z6d5kODql7MqPYd2i4Q (big blind) folded before Flop
Seat 6: 715lGOaseTlrgDQ1nwU86w folded before Flop



PokerStars Game #59962035148:  Hold'em No Limit ($5/$10) - 2009/07/01 11:26:25 ET
Table 'dwLGEw3aoH/cOAI7JsLdmw' 6-max Seat #2 is the button
Seat 1: is0C+o+4W8624tMaRmJg7A ($1000 in chips)
Seat 2: 1ScqYmNf7/uWx1XSBgPTBw ($185 in chips)
Seat 3: voSAIKXtXUUbJnds83sYfQ ($1097 in chips)
Seat 4: efhcaDPhNqQ/H48kMHLa8w ($1052 in chips)
Seat 5: jkH6qYMpn8JA/IyBOhQPMw ($2098 in chips)
Seat 6: 3mTlg4g0FJN2bo939h/0Wg ($487 in chips)
voSAIKXtXUUbJnds83sYfQ: posts small blind $5
efhcaDPhNqQ/H48kMHLa8w: posts big blind $10
*** HOLE CARDS ***
jkH6qYMpn8JA/IyBOhQPMw: folds
3mTlg4g0FJN2bo939h/0Wg said, "youspent ypur money with 98 thats crazy"
3mTlg4g0FJN2bo939h/0Wg: folds
is0C+o+4W8624tMaRmJg7A: folds
1ScqYmNf7/uWx1XSBgPTBw: raises $10 to $20
voSAIKXtXUUbJnds83sYfQ: raises $40 to $60
jkH6qYMpn8JA/IyBOhQPMw said, "you lost a 80/20 get over it"
3mTlg4g0FJN2bo939h/0Wg said, "when you play more so you lost all of your money"
efhcaDPhNqQ/H48kMHLa8w: folds
1ScqYmNf7/uWx1XSBgPTBw: folds
voSAIKXtXUUbJnds83sYfQ collected $50 from pot
voSAIKXtXUUbJnds83sYfQ: doesn't show hand
*** SUMMARY ***
Total pot $50 | Rake $0
Seat 1: is0C+o+4W8624tMaRmJg7A folded before Flop (didn't bet)
Seat 2: 1ScqYmNf7/uWx1XSBgPTBw (button) folded before Flop
Seat 3: voSAIKXtXUUbJnds83sYfQ (small blind) collected ($50)
Seat 4: efhcaDPhNqQ/H48kMHLa8w (big blind) folded before Flop
Seat 5: jkH6qYMpn8JA/IyBOhQPMw folded before Flop (didn't bet)
Seat 6: 3mTlg4g0FJN2bo939h/0Wg folded before Flop (didn't bet)



PokerStars Game #59962046020:  Hold'em No Limit ($5/$10) - 2009/07/01 11:26:37 ET
Table '1Dt9cpcLUVE6HYkx5dUEdQ' 6-max Seat #4 is the button
Seat 1: Xl+I49lxCJwPGRuegiaHoA ($1000 in chips)
Seat 2: zdS2zKkZYSRe8p+GVcXMgg ($1762.10 in chips)
Seat 3: Lne9leXjEzXWbU3BGFWsxQ ($1037 in chips)
Seat 4: voSAIKXtXUUbJnds83sYfQ ($1084 in chips)
Seat 5: jkH6qYMpn8JA/IyBOhQPMw ($1092 in chips)
Seat 6: 3mTlg4g0FJN2bo939h/0Wg ($1260 in chips)
jkH6qYMpn8JA/IyBOhQPMw: posts small blind $5
3mTlg4g0FJN2bo939h/0Wg: posts big blind $10
*** HOLE CARDS ***
Xl+I49lxCJwPGRuegiaHoA: folds
zdS2zKkZYSRe8p+GVcXMgg: calls $10
Lne9leXjEzXWbU3BGFWsxQ: raises $30 to $40
voSAIKXtXUUbJnds83sYfQ: folds
jkH6qYMpn8JA/IyBOhQPMw: folds
3mTlg4g0FJN2bo939h/0Wg: folds
zdS2zKkZYSRe8p+GVcXMgg: calls $30
*** FLOP *** [6h 2c Kh]
zdS2zKkZYSRe8p+GVcXMgg: checks
Lne9leXjEzXWbU3BGFWsxQ: bets $50
zdS2zKkZYSRe8p+GVcXMgg: calls $50
*** TURN *** [6h 2c Kh] [2h]
zdS2zKkZYSRe8p+GVcXMgg: checks
Lne9leXjEzXWbU3BGFWsxQ: checks
*** RIVER *** [6h 2c Kh 2h] [5d]
zdS2zKkZYSRe8p+GVcXMgg: bets $50
Lne9leXjEzXWbU3BGFWsxQ: folds
zdS2zKkZYSRe8p+GVcXMgg collected $192 from pot
*** SUMMARY ***
Total pot $195 | Rake $3
Board [6h 2c Kh 2h 5d]
Seat 1: Xl+I49lxCJwPGRuegiaHoA folded before Flop (didn't bet)
Seat 2: zdS2zKkZYSRe8p+GVcXMgg collected ($192)
Seat 3: Lne9leXjEzXWbU3BGFWsxQ folded on the River
Seat 4: voSAIKXtXUUbJnds83sYfQ (button) folded before Flop (didn't bet)
Seat 5: jkH6qYMpn8JA/IyBOhQPMw (small blind) folded before Flop
Seat 6: 3mTlg4g0FJN2bo939h/0Wg (big blind) folded before Flop



PokerStars Game #59962052480:  Hold'em No Limit ($5/$10) - 2009/07/01 11:26:45 ET
Table '2a86NK3xhs21kwGZmbj0QA' 6-max Seat #6 is the button
Seat 1: is0C+o+4W8624tMaRmJg7A ($1032 in chips)
Seat 2: Xl+I49lxCJwPGRuegiaHoA ($2556 in chips)
Seat 3: voSAIKXtXUUbJnds83sYfQ ($1017 in chips)
Seat 5: jkH6qYMpn8JA/IyBOhQPMw ($1614.25 in chips)
Seat 6: 0OfLwED3kKs3FwY+JlHC0g ($1285 in chips)
is0C+o+4W8624tMaRmJg7A: posts small blind $5
Xl+I49lxCJwPGRuegiaHoA: posts big blind $10
1ScqYmNf7/uWx1XSBgPTBw: sits out
*** HOLE CARDS ***
voSAIKXtXUUbJnds83sYfQ: folds
jkH6qYMpn8JA/IyBOhQPMw: folds
0OfLwED3kKs3FwY+JlHC0g: raises $15 to $25
is0C+o+4W8624tMaRmJg7A: raises $65 to $90
Xl+I49lxCJwPGRuegiaHoA: folds
0OfLwED3kKs3FwY+JlHC0g: folds
is0C+o+4W8624tMaRmJg7A collected $60 from pot
is0C+o+4W8624tMaRmJg7A: doesn't show hand
*** SUMMARY ***
Total pot $60 | Rake $0
Seat 1: is0C+o+4W8624tMaRmJg7A (small blind) collected ($60)
Seat 2: Xl+I49lxCJwPGRuegiaHoA (big blind) folded before Flop
Seat 3: voSAIKXtXUUbJnds83sYfQ folded before Flop (didn't bet)
Seat 5: jkH6qYMpn8JA/IyBOhQPMw folded before Flop (didn't bet)
Seat 6: 0OfLwED3kKs3FwY+JlHC0g (button) folded before Flop



PokerStars Game #59962054544:  Hold'em No Limit ($5/$10) - 2009/07/01 11:26:47 ET
Table 'AiNa6yyp/njJVRYl/Lz1KQ' 6-max Seat #4 is the button
Seat 1: Xl/zzIZf2hmO234sDWM1HQ ($359.50 in chips)
Seat 4: /F5e5TKT/1B9kgJVuQttsg ($300 in chips)
Seat 5: rA+z6d5kODql7MqPYd2i4Q ($576 in chips)
Seat 6: 715lGOaseTlrgDQ1nwU86w ($251.05 in chips)
rA+z6d5kODql7MqPYd2i4Q: posts small blind $5
715lGOaseTlrgDQ1nwU86w: posts big blind $10
1s1h7qXmZxmowl9P1VNe2Q: sits out
fs6KvO7rGEyw4MYb4z5cQQ: sits out
*** HOLE CARDS ***
Xl/zzIZf2hmO234sDWM1HQ: calls $10
/F5e5TKT/1B9kgJVuQttsg: raises $25 to $35
rA+z6d5kODql7MqPYd2i4Q: folds
715lGOaseTlrgDQ1nwU86w: folds
Xl/zzIZf2hmO234sDWM1HQ: calls $25
*** FLOP *** [3h Td 8c]
Xl/zzIZf2hmO234sDWM1HQ: bets $30
/F5e5TKT/1B9kgJVuQttsg: folds
Xl/zzIZf2hmO234sDWM1HQ collected $83 from pot
*** SUMMARY ***
Total pot $85 | Rake $2
Board [3h Td 8c]
Seat 1: Xl/zzIZf2hmO234sDWM1HQ collected ($83)
Seat 4: /F5e5TKT/1B9kgJVuQttsg (button) folded on the Flop
Seat 5: rA+z6d5kODql7MqPYd2i4Q (small blind) folded before Flop
Seat 6: 715lGOaseTlrgDQ1nwU86w (big blind) folded before Flop



PokerStars Game #59962066498:  Hold'em No Limit ($5/$10) - 2009/07/01 11:27:01 ET
Table 'dwLGEw3aoH/cOAI7JsLdmw' 6-max Seat #3 is the button
Seat 1: is0C+o+4W8624tMaRmJg7A ($1000 in chips)
Seat 2: 1ScqYmNf7/uWx1XSBgPTBw ($165 in chips)
Seat 3: voSAIKXtXUUbJnds83sYfQ ($1127 in chips)
Seat 4: efhcaDPhNqQ/H48kMHLa8w ($1042 in chips)
Seat 5: jkH6qYMpn8JA/IyBOhQPMw ($2098 in chips)
Seat 6: 3mTlg4g0FJN2bo939h/0Wg ($487 in chips)
efhcaDPhNqQ/H48kMHLa8w: posts small blind $5
jkH6qYMpn8JA/IyBOhQPMw: posts big blind $10
*** HOLE CARDS ***
3mTlg4g0FJN2bo939h/0Wg: folds
is0C+o+4W8624tMaRmJg7A: folds
1ScqYmNf7/uWx1XSBgPTBw: folds
voSAIKXtXUUbJnds83sYfQ: raises $20 to $30
efhcaDPhNqQ/H48kMHLa8w: folds
jkH6qYMpn8JA/IyBOhQPMw: raises $70 to $100
3mTlg4g0FJN2bo939h/0Wg said, "this site is for donks"
voSAIKXtXUUbJnds83sYfQ: folds
jkH6qYMpn8JA/IyBOhQPMw collected $65 from pot
*** SUMMARY ***
Total pot $65 | Rake $0
Seat 1: is0C+o+4W8624tMaRmJg7A folded before Flop (didn't bet)
Seat 2: 1ScqYmNf7/uWx1XSBgPTBw folded before Flop (didn't bet)
Seat 3: voSAIKXtXUUbJnds83sYfQ (button) folded before Flop
Seat 4: efhcaDPhNqQ/H48kMHLa8w (small blind) folded before Flop
Seat 5: jkH6qYMpn8JA/IyBOhQPMw (big blind) collected ($65)
Seat 6: 3mTlg4g0FJN2bo939h/0Wg folded before Flop (didn't bet)



PokerStars Game #59962078838:  Hold'em No Limit ($5/$10) - 2009/07/01 11:27:15 ET
Table '2a86NK3xhs21kwGZmbj0QA' 6-max Seat #1 is the button
Seat 1: is0C+o+4W8624tMaRmJg7A ($1067 in chips)
Seat 2: Xl+I49lxCJwPGRuegiaHoA ($2546 in chips)
Seat 3: voSAIKXtXUUbJnds83sYfQ ($1017 in chips)
Seat 5: jkH6qYMpn8JA/IyBOhQPMw ($1614.25 in chips)
Seat 6: 0OfLwED3kKs3FwY+JlHC0g ($1260 in chips)
Xl+I49lxCJwPGRuegiaHoA: posts small blind $5
voSAIKXtXUUbJnds83sYfQ: posts big blind $10
1ScqYmNf7/uWx1XSBgPTBw: sits out
*** HOLE CARDS ***
jkH6qYMpn8JA/IyBOhQPMw: folds
0OfLwED3kKs3FwY+JlHC0g: folds
is0C+o+4W8624tMaRmJg7A: folds
Xl+I49lxCJwPGRuegiaHoA: raises $20 to $30
voSAIKXtXUUbJnds83sYfQ: raises $60 to $90
Xl+I49lxCJwPGRuegiaHoA: folds
voSAIKXtXUUbJnds83sYfQ collected $60 from pot
voSAIKXtXUUbJnds83sYfQ: doesn't show hand
*** SUMMARY ***
Total pot $60 | Rake $0
Seat 1: is0C+o+4W8624tMaRmJg7A (button) folded before Flop (didn't bet)
Seat 2: Xl+I49lxCJwPGRuegiaHoA (small blind) folded before Flop
Seat 3: voSAIKXtXUUbJnds83sYfQ (big blind) collected ($60)
Seat 5: jkH6qYMpn8JA/IyBOhQPMw folded before Flop (didn't bet)
Seat 6: 0OfLwED3kKs3FwY+JlHC0g folded before Flop (didn't bet)



PokerStars Game #59962082494:  Hold'em No Limit ($5/$10) - 2009/07/01 11:27:19 ET
Table 'AiNa6yyp/njJVRYl/Lz1KQ' 6-max Seat #5 is the button
Seat 1: Xl/zzIZf2hmO234sDWM1HQ ($407.50 in chips)
Seat 4: /F5e5TKT/1B9kgJVuQttsg ($300 in chips)
Seat 5: rA+z6d5kODql7MqPYd2i4Q ($571 in chips)
Seat 6: 715lGOaseTlrgDQ1nwU86w ($241.05 in chips)
715lGOaseTlrgDQ1nwU86w: posts small blind $5
Xl/zzIZf2hmO234sDWM1HQ: posts big blind $10
1s1h7qXmZxmowl9P1VNe2Q: sits out
fs6KvO7rGEyw4MYb4z5cQQ: sits out
*** HOLE CARDS ***
/F5e5TKT/1B9kgJVuQttsg: folds
rA+z6d5kODql7MqPYd2i4Q: folds
715lGOaseTlrgDQ1nwU86w: raises $10 to $20
Xl/zzIZf2hmO234sDWM1HQ: calls $10
*** FLOP *** [Ac Qd Js]
715lGOaseTlrgDQ1nwU86w: bets $20
Xl/zzIZf2hmO234sDWM1HQ: calls $20
*** TURN *** [Ac Qd Js] [Td]
715lGOaseTlrgDQ1nwU86w: checks
Xl/zzIZf2hmO234sDWM1HQ: checks
*** RIVER *** [Ac Qd Js Td] [8c]
715lGOaseTlrgDQ1nwU86w: bets $30
Xl/zzIZf2hmO234sDWM1HQ: calls $30
*** SHOW DOWN ***
715lGOaseTlrgDQ1nwU86w: shows [Tc 2c] (a pair of Tens)
Xl/zzIZf2hmO234sDWM1HQ: shows [Ah Jh] (two pair, Aces and Jacks)
Xl/zzIZf2hmO234sDWM1HQ collected $138 from pot
*** SUMMARY ***
Total pot $140 | Rake $2
Board [Ac Qd Js Td 8c]
Seat 1: Xl/zzIZf2hmO234sDWM1HQ (big blind) showed [Ah Jh] and won ($138) with two pair, Aces and Jacks
Seat 4: /F5e5TKT/1B9kgJVuQttsg folded before Flop (didn't bet)
Seat 5: rA+z6d5kODql7MqPYd2i4Q (button) folded before Flop (didn't bet)
Seat 6: 715lGOaseTlrgDQ1nwU86w (small blind) showed [Tc 2c] and lost with a pair of Tens



PokerStars Game #59962090864:  Hold'em No Limit ($5/$10) - 2009/07/01 11:27:29 ET
Table 'dwLGEw3aoH/cOAI7JsLdmw' 6-max Seat #4 is the button
Seat 1: is0C+o+4W8624tMaRmJg7A ($1000 in chips)
Seat 2: 1ScqYmNf7/uWx1XSBgPTBw ($165 in chips)
Seat 3: voSAIKXtXUUbJnds83sYfQ ($1097 in chips)
Seat 4: efhcaDPhNqQ/H48kMHLa8w ($1037 in chips)
Seat 5: jkH6qYMpn8JA/IyBOhQPMw ($2133 in chips)
Seat 6: 3mTlg4g0FJN2bo939h/0Wg ($487 in chips)
jkH6qYMpn8JA/IyBOhQPMw: posts small blind $5
3mTlg4g0FJN2bo939h/0Wg: posts big blind $10
*** HOLE CARDS ***
jkH6qYMpn8JA/IyBOhQPMw said, "u will get rich"
is0C+o+4W8624tMaRmJg7A: raises $15 to $25
1ScqYmNf7/uWx1XSBgPTBw: folds
voSAIKXtXUUbJnds83sYfQ: folds
efhcaDPhNqQ/H48kMHLa8w: folds
jkH6qYMpn8JA/IyBOhQPMw: folds
3mTlg4g0FJN2bo939h/0Wg: folds
is0C+o+4W8624tMaRmJg7A collected $25 from pot
*** SUMMARY ***
Total pot $25 | Rake $0
Seat 1: is0C+o+4W8624tMaRmJg7A collected ($25)
Seat 2: 1ScqYmNf7/uWx1XSBgPTBw folded before Flop (didn't bet)
Seat 3: voSAIKXtXUUbJnds83sYfQ folded before Flop (didn't bet)
Seat 4: efhcaDPhNqQ/H48kMHLa8w (button) folded before Flop (didn't bet)
Seat 5: jkH6qYMpn8JA/IyBOhQPMw (small blind) folded before Flop
Seat 6: 3mTlg4g0FJN2bo939h/0Wg (big blind) folded before Flop



PokerStars Game #59962102934:  Hold'em No Limit ($5/$10) - 2009/07/01 11:27:43 ET
Table '1Dt9cpcLUVE6HYkx5dUEdQ' 6-max Seat #5 is the button
Seat 1: Xl+I49lxCJwPGRuegiaHoA ($1000 in chips)
Seat 2: zdS2zKkZYSRe8p+GVcXMgg ($1864.10 in chips)
Seat 3: Lne9leXjEzXWbU3BGFWsxQ ($1000 in chips)
Seat 4: voSAIKXtXUUbJnds83sYfQ ($1084 in chips)
Seat 5: jkH6qYMpn8JA/IyBOhQPMw ($1087 in chips)
Seat 6: 3mTlg4g0FJN2bo939h/0Wg ($1250 in chips)
3mTlg4g0FJN2bo939h/0Wg: posts small blind $5
Xl+I49lxCJwPGRuegiaHoA: posts big blind $10
*** HOLE CARDS ***
zdS2zKkZYSRe8p+GVcXMgg: folds
Lne9leXjEzXWbU3BGFWsxQ: folds
voSAIKXtXUUbJnds83sYfQ: folds
jkH6qYMpn8JA/IyBOhQPMw: folds
3mTlg4g0FJN2bo939h/0Wg: raises $10 to $20
Xl+I49lxCJwPGRuegiaHoA: raises $60 to $80
3mTlg4g0FJN2bo939h/0Wg: folds
Xl+I49lxCJwPGRuegiaHoA collected $40 from pot
*** SUMMARY ***
Total pot $40 | Rake $0
Seat 1: Xl+I49lxCJwPGRuegiaHoA (big blind) collected ($40)
Seat 2: zdS2zKkZYSRe8p+GVcXMgg folded before Flop (didn't bet)
Seat 3: Lne9leXjEzXWbU3BGFWsxQ folded before Flop (didn't bet)
Seat 4: voSAIKXtXUUbJnds83sYfQ folded before Flop (didn't bet)
Seat 5: jkH6qYMpn8JA/IyBOhQPMw (button) folded before Flop (didn't bet)
Seat 6: 3mTlg4g0FJN2bo939h/0Wg (small blind) folded before Flop



PokerStars Game #59962104286:  Hold'em No Limit ($5/$10) - 2009/07/01 11:27:44 ET
Table '2a86NK3xhs21kwGZmbj0QA' 6-max Seat #2 is the button
Seat 1: is0C+o+4W8624tMaRmJg7A ($1067 in chips)
Seat 2: Xl+I49lxCJwPGRuegiaHoA ($2516 in chips)
Seat 3: voSAIKXtXUUbJnds83sYfQ ($1047 in chips)
Seat 4: 1ScqYmNf7/uWx1XSBgPTBw ($200 in chips)
Seat 5: jkH6qYMpn8JA/IyBOhQPMw ($1614.25 in chips)
Seat 6: 0OfLwED3kKs3FwY+JlHC0g ($1260 in chips)
voSAIKXtXUUbJnds83sYfQ: posts small blind $5
1ScqYmNf7/uWx1XSBgPTBw: posts big blind $10
*** HOLE CARDS ***
jkH6qYMpn8JA/IyBOhQPMw: folds
0OfLwED3kKs3FwY+JlHC0g: folds
is0C+o+4W8624tMaRmJg7A: folds
Xl+I49lxCJwPGRuegiaHoA: folds
voSAIKXtXUUbJnds83sYfQ: folds
1ScqYmNf7/uWx1XSBgPTBw collected $10 from pot
1ScqYmNf7/uWx1XSBgPTBw: doesn't show hand
*** SUMMARY ***
Total pot $10 | Rake $0
Seat 1: is0C+o+4W8624tMaRmJg7A folded before Flop (didn't bet)
Seat 2: Xl+I49lxCJwPGRuegiaHoA (button) folded before Flop (didn't bet)
Seat 3: voSAIKXtXUUbJnds83sYfQ (small blind) folded before Flop
Seat 4: 1ScqYmNf7/uWx1XSBgPTBw (big blind) collected ($10)
Seat 5: jkH6qYMpn8JA/IyBOhQPMw folded before Flop (didn't bet)
Seat 6: 0OfLwED3kKs3FwY+JlHC0g folded before Flop (didn't bet)



PokerStars Game #59962110988:  Hold'em No Limit ($5/$10) - 2009/07/01 11:27:52 ET
Table 'AiNa6yyp/njJVRYl/Lz1KQ' 6-max Seat #6 is the button
Seat 1: Xl/zzIZf2hmO234sDWM1HQ ($475.50 in chips)
Seat 2: 1s1h7qXmZxmowl9P1VNe2Q ($200 in chips)
Seat 4: /F5e5TKT/1B9kgJVuQttsg ($300 in chips)
Seat 5: rA+z6d5kODql7MqPYd2i4Q ($571 in chips)
Seat 6: 715lGOaseTlrgDQ1nwU86w ($171.05 in chips)
Xl/zzIZf2hmO234sDWM1HQ: posts small blind $5
1s1h7qXmZxmowl9P1VNe2Q: posts big blind $10
fs6KvO7rGEyw4MYb4z5cQQ: sits out
*** HOLE CARDS ***
/F5e5TKT/1B9kgJVuQttsg: raises $10 to $20
rA+z6d5kODql7MqPYd2i4Q: folds
715lGOaseTlrgDQ1nwU86w: calls $20
Xl/zzIZf2hmO234sDWM1HQ: folds
1s1h7qXmZxmowl9P1VNe2Q: folds
*** FLOP *** [6h 2d 7d]
Xl/zzIZf2hmO234sDWM1HQ leaves the table
/F5e5TKT/1B9kgJVuQttsg: bets $20
715lGOaseTlrgDQ1nwU86w: folds
/F5e5TKT/1B9kgJVuQttsg collected $53 from pot
/F5e5TKT/1B9kgJVuQttsg: doesn't show hand
*** SUMMARY ***
Total pot $55 | Rake $2
Board [6h 2d 7d]
Seat 1: Xl/zzIZf2hmO234sDWM1HQ (small blind) folded before Flop
Seat 2: 1s1h7qXmZxmowl9P1VNe2Q (big blind) folded before Flop
Seat 4: /F5e5TKT/1B9kgJVuQttsg collected ($53)
Seat 5: rA+z6d5kODql7MqPYd2i4Q folded before Flop (didn't bet)
Seat 6: 715lGOaseTlrgDQ1nwU86w (button) folded on the Flop



PokerStars Game #59962111272:  Hold'em No Limit ($5/$10) - 2009/07/01 11:27:52 ET
Table 'Q/w/Js5qqrmjD3PYvaqoBg' 2-max Seat #1 is the button
Seat 1: 1s1h7qXmZxmowl9P1VNe2Q ($259 in chips)
Seat 2: lhkk4tvkAIWjBBrsHuNe/A ($1139.50 in chips)
1s1h7qXmZxmowl9P1VNe2Q: posts small blind $5
lhkk4tvkAIWjBBrsHuNe/A: posts big blind $10
*** HOLE CARDS ***
1s1h7qXmZxmowl9P1VNe2Q: raises $10 to $20
lhkk4tvkAIWjBBrsHuNe/A: folds
1s1h7qXmZxmowl9P1VNe2Q collected $20 from pot
1s1h7qXmZxmowl9P1VNe2Q: doesn't show hand
*** SUMMARY ***
Total pot $20 | Rake $0
Seat 1: 1s1h7qXmZxmowl9P1VNe2Q (button) (small blind) collected ($20)
Seat 2: lhkk4tvkAIWjBBrsHuNe/A (big blind) folded before Flop



PokerStars Game #59962114962:  Hold'em No Limit ($5/$10) - 2009/07/01 11:27:56 ET
Table '2a86NK3xhs21kwGZmbj0QA' 6-max Seat #3 is the button
Seat 1: is0C+o+4W8624tMaRmJg7A ($1067 in chips)
Seat 2: Xl+I49lxCJwPGRuegiaHoA ($2516 in chips)
Seat 3: voSAIKXtXUUbJnds83sYfQ ($1042 in chips)
Seat 4: 1ScqYmNf7/uWx1XSBgPTBw ($205 in chips)
Seat 5: jkH6qYMpn8JA/IyBOhQPMw ($1614.25 in chips)
Seat 6: 0OfLwED3kKs3FwY+JlHC0g ($1260 in chips)
1ScqYmNf7/uWx1XSBgPTBw: posts small blind $5
jkH6qYMpn8JA/IyBOhQPMw: posts big blind $10
*** HOLE CARDS ***
0OfLwED3kKs3FwY+JlHC0g: folds
is0C+o+4W8624tMaRmJg7A: raises $15 to $25
Xl+I49lxCJwPGRuegiaHoA: folds
voSAIKXtXUUbJnds83sYfQ: folds
1ScqYmNf7/uWx1XSBgPTBw: folds
jkH6qYMpn8JA/IyBOhQPMw: calls $15
*** FLOP *** [7h Ah 9s]
jkH6qYMpn8JA/IyBOhQPMw: checks
is0C+o+4W8624tMaRmJg7A: checks
*** TURN *** [7h Ah 9s] [9c]
jkH6qYMpn8JA/IyBOhQPMw: bets $48
is0C+o+4W8624tMaRmJg7A: calls $48
*** RIVER *** [7h Ah 9s 9c] [3h]
jkH6qYMpn8JA/IyBOhQPMw: bets $240
is0C+o+4W8624tMaRmJg7A: folds
jkH6qYMpn8JA/IyBOhQPMw collected $148 from pot
jkH6qYMpn8JA/IyBOhQPMw: doesn't show hand
*** SUMMARY ***
Total pot $151 | Rake $3
Board [7h Ah 9s 9c 3h]
Seat 1: is0C+o+4W8624tMaRmJg7A folded on the River
Seat 2: Xl+I49lxCJwPGRuegiaHoA folded before Flop (didn't bet)
Seat 3: voSAIKXtXUUbJnds83sYfQ (button) folded before Flop (didn't bet)
Seat 4: 1ScqYmNf7/uWx1XSBgPTBw (small blind) folded before Flop
Seat 5: jkH6qYMpn8JA/IyBOhQPMw (big blind) collected ($148)
Seat 6: 0OfLwED3kKs3FwY+JlHC0g folded before Flop (didn't bet)



PokerStars Game #59962118990:  Hold'em No Limit ($5/$10) - 2009/07/01 11:28:01 ET
Table 'dwLGEw3aoH/cOAI7JsLdmw' 6-max Seat #5 is the button
Seat 1: is0C+o+4W8624tMaRmJg7A ($1015 in chips)
Seat 2: 1ScqYmNf7/uWx1XSBgPTBw ($165 in chips)
Seat 3: voSAIKXtXUUbJnds83sYfQ ($1097 in chips)
Seat 4: efhcaDPhNqQ/H48kMHLa8w ($1037 in chips)
Seat 5: jkH6qYMpn8JA/IyBOhQPMw ($2128 in chips)
Seat 6: 3mTlg4g0FJN2bo939h/0Wg ($477 in chips)
3mTlg4g0FJN2bo939h/0Wg: posts small blind $5
is0C+o+4W8624tMaRmJg7A: posts big blind $10
*** HOLE CARDS ***
1ScqYmNf7/uWx1XSBgPTBw: folds
voSAIKXtXUUbJnds83sYfQ: raises $20 to $30
efhcaDPhNqQ/H48kMHLa8w: folds
jkH6qYMpn8JA/IyBOhQPMw: calls $30
3mTlg4g0FJN2bo939h/0Wg: folds
is0C+o+4W8624tMaRmJg7A: folds
*** FLOP *** [Jh 6c Ks]
voSAIKXtXUUbJnds83sYfQ: bets $50
jkH6qYMpn8JA/IyBOhQPMw: calls $50
*** TURN *** [Jh 6c Ks] [Ts]
voSAIKXtXUUbJnds83sYfQ: bets $130
jkH6qYMpn8JA/IyBOhQPMw: calls $130
*** RIVER *** [Jh 6c Ks Ts] [8c]
voSAIKXtXUUbJnds83sYfQ: bets $325
jkH6qYMpn8JA/IyBOhQPMw: folds
voSAIKXtXUUbJnds83sYfQ collected $432 from pot
*** SUMMARY ***
Total pot $435 | Rake $3
Board [Jh 6c Ks Ts 8c]
Seat 1: is0C+o+4W8624tMaRmJg7A (big blind) folded before Flop
Seat 2: 1ScqYmNf7/uWx1XSBgPTBw folded before Flop (didn't bet)
Seat 3: voSAIKXtXUUbJnds83sYfQ collected ($432)
Seat 4: efhcaDPhNqQ/H48kMHLa8w folded before Flop (didn't bet)
Seat 5: jkH6qYMpn8JA/IyBOhQPMw (button) folded on the River
Seat 6: 3mTlg4g0FJN2bo939h/0Wg (small blind) folded before Flop



PokerStars Game #59962126464:  Hold'em No Limit ($5/$10) - 2009/07/01 11:28:09 ET
Table '1Dt9cpcLUVE6HYkx5dUEdQ' 6-max Seat #6 is the button
Seat 1: Xl+I49lxCJwPGRuegiaHoA ($1020 in chips)
Seat 2: zdS2zKkZYSRe8p+GVcXMgg ($1864.10 in chips)
Seat 3: Lne9leXjEzXWbU3BGFWsxQ ($1000 in chips)
Seat 4: voSAIKXtXUUbJnds83sYfQ ($1084 in chips)
Seat 5: jkH6qYMpn8JA/IyBOhQPMw ($1087 in chips)
Seat 6: 3mTlg4g0FJN2bo939h/0Wg ($1230 in chips)
Xl+I49lxCJwPGRuegiaHoA: posts small blind $5
zdS2zKkZYSRe8p+GVcXMgg: posts big blind $10
*** HOLE CARDS ***
Lne9leXjEzXWbU3BGFWsxQ: folds
voSAIKXtXUUbJnds83sYfQ: raises $20 to $30
jkH6qYMpn8JA/IyBOhQPMw: calls $30
3mTlg4g0FJN2bo939h/0Wg: folds
Xl+I49lxCJwPGRuegiaHoA: folds
zdS2zKkZYSRe8p+GVcXMgg: calls $20
*** FLOP *** [3h Ks Ad]
zdS2zKkZYSRe8p+GVcXMgg: checks
voSAIKXtXUUbJnds83sYfQ: checks
jkH6qYMpn8JA/IyBOhQPMw: checks
*** TURN *** [3h Ks Ad] [5c]
zdS2zKkZYSRe8p+GVcXMgg: checks
voSAIKXtXUUbJnds83sYfQ: checks
jkH6qYMpn8JA/IyBOhQPMw: checks
*** RIVER *** [3h Ks Ad 5c] [3d]
zdS2zKkZYSRe8p+GVcXMgg: bets $30
voSAIKXtXUUbJnds83sYfQ: folds
jkH6qYMpn8JA/IyBOhQPMw: folds
zdS2zKkZYSRe8p+GVcXMgg collected $92 from pot
*** SUMMARY ***
Total pot $95 | Rake $3
Board [3h Ks Ad 5c 3d]
Seat 1: Xl+I49lxCJwPGRuegiaHoA (small blind) folded before Flop
Seat 2: zdS2zKkZYSRe8p+GVcXMgg (big blind) collected ($92)
Seat 3: Lne9leXjEzXWbU3BGFWsxQ folded before Flop (didn't bet)
Seat 4: voSAIKXtXUUbJnds83sYfQ folded on the River
Seat 5: jkH6qYMpn8JA/IyBOhQPMw folded on the River
Seat 6: 3mTlg4g0FJN2bo939h/0Wg (button) folded before Flop (didn't bet)



PokerStars Game #59962172004:  Hold'em No Limit ($5/$10) - 2009/07/01 11:29:02 ET
Table '2a86NK3xhs21kwGZmbj0QA' 6-max Seat #4 is the button
Seat 1: is0C+o+4W8624tMaRmJg7A ($1000 in chips)
Seat 2: Xl+I49lxCJwPGRuegiaHoA ($2516 in chips)
Seat 3: voSAIKXtXUUbJnds83sYfQ ($1042 in chips)
Seat 4: 1ScqYmNf7/uWx1XSBgPTBw ($200 in chips)
Seat 5: jkH6qYMpn8JA/IyBOhQPMw ($1689.25 in chips)
Seat 6: 0OfLwED3kKs3FwY+JlHC0g ($1260 in chips)
jkH6qYMpn8JA/IyBOhQPMw: posts small blind $5
0OfLwED3kKs3FwY+JlHC0g: posts big blind $10
*** HOLE CARDS ***
is0C+o+4W8624tMaRmJg7A: folds
Xl+I49lxCJwPGRuegiaHoA: folds
voSAIKXtXUUbJnds83sYfQ: folds
1ScqYmNf7/uWx1XSBgPTBw: folds
jkH6qYMpn8JA/IyBOhQPMw: folds
0OfLwED3kKs3FwY+JlHC0g collected $10 from pot
0OfLwED3kKs3FwY+JlHC0g: doesn't show hand
*** SUMMARY ***
Total pot $10 | Rake $0
Seat 1: is0C+o+4W8624tMaRmJg7A folded before Flop (didn't bet)
Seat 2: Xl+I49lxCJwPGRuegiaHoA folded before Flop (didn't bet)
Seat 3: voSAIKXtXUUbJnds83sYfQ folded before Flop (didn't bet)
Seat 4: 1ScqYmNf7/uWx1XSBgPTBw (button) folded before Flop (didn't bet)
Seat 5: jkH6qYMpn8JA/IyBOhQPMw (small blind) folded before Flop
Seat 6: 0OfLwED3kKs3FwY+JlHC0g (big blind) collected ($10)



PokerStars Game #59962188602:  Hold'em No Limit ($5/$10) - 2009/07/01 11:29:21 ET
Table '2a86NK3xhs21kwGZmbj0QA' 6-max Seat #5 is the button
Seat 1: is0C+o+4W8624tMaRmJg7A ($1000 in chips)
Seat 2: Xl+I49lxCJwPGRuegiaHoA ($2516 in chips)
Seat 3: voSAIKXtXUUbJnds83sYfQ ($1042 in chips)
Seat 4: 1ScqYmNf7/uWx1XSBgPTBw ($200 in chips)
Seat 5: jkH6qYMpn8JA/IyBOhQPMw ($1684.25 in chips)
Seat 6: 0OfLwED3kKs3FwY+JlHC0g ($1265 in chips)
0OfLwED3kKs3FwY+JlHC0g: posts small blind $5
is0C+o+4W8624tMaRmJg7A: posts big blind $10
*** HOLE CARDS ***
Xl+I49lxCJwPGRuegiaHoA: folds
voSAIKXtXUUbJnds83sYfQ: folds
1ScqYmNf7/uWx1XSBgPTBw: raises $10 to $20
jkH6qYMpn8JA/IyBOhQPMw: calls $20
0OfLwED3kKs3FwY+JlHC0g: folds
is0C+o+4W8624tMaRmJg7A: folds
*** FLOP *** [Kh 9d Kd]
1ScqYmNf7/uWx1XSBgPTBw: bets $20
jkH6qYMpn8JA/IyBOhQPMw: folds
1ScqYmNf7/uWx1XSBgPTBw collected $52.25 from pot
1ScqYmNf7/uWx1XSBgPTBw: doesn't show hand
*** SUMMARY ***
Total pot $55 | Rake $2.75
Board [Kh 9d Kd]
Seat 1: is0C+o+4W8624tMaRmJg7A (big blind) folded before Flop
Seat 2: Xl+I49lxCJwPGRuegiaHoA folded before Flop (didn't bet)
Seat 3: voSAIKXtXUUbJnds83sYfQ folded before Flop (didn't bet)
Seat 4: 1ScqYmNf7/uWx1XSBgPTBw collected ($52.25)
Seat 5: jkH6qYMpn8JA/IyBOhQPMw (button) folded on the Flop
Seat 6: 0OfLwED3kKs3FwY+JlHC0g (small blind) folded before Flop



PokerStars Game #59962208494:  Hold'em No Limit ($5/$10) - 2009/07/01 11:29:44 ET
Table '1Dt9cpcLUVE6HYkx5dUEdQ' 6-max Seat #1 is the button
Seat 1: Xl+I49lxCJwPGRuegiaHoA ($1015 in chips)
Seat 2: zdS2zKkZYSRe8p+GVcXMgg ($1926.10 in chips)
Seat 3: Lne9leXjEzXWbU3BGFWsxQ ($1000 in chips)
Seat 4: voSAIKXtXUUbJnds83sYfQ ($1054 in chips)
Seat 5: jkH6qYMpn8JA/IyBOhQPMw ($1057 in chips)
Seat 6: 3mTlg4g0FJN2bo939h/0Wg ($1230 in chips)
zdS2zKkZYSRe8p+GVcXMgg: posts small blind $5
Lne9leXjEzXWbU3BGFWsxQ: posts big blind $10
*** HOLE CARDS ***
voSAIKXtXUUbJnds83sYfQ: raises $20 to $30
jkH6qYMpn8JA/IyBOhQPMw: calls $30
3mTlg4g0FJN2bo939h/0Wg: folds
Xl+I49lxCJwPGRuegiaHoA: folds
zdS2zKkZYSRe8p+GVcXMgg: calls $25
Lne9leXjEzXWbU3BGFWsxQ: raises $150 to $180
voSAIKXtXUUbJnds83sYfQ: raises $874 to $1054 and is all-in
jkH6qYMpn8JA/IyBOhQPMw: folds
zdS2zKkZYSRe8p+GVcXMgg: folds
Lne9leXjEzXWbU3BGFWsxQ: calls $820 and is all-in
*** FLOP *** [4d Td Jc]
*** TURN *** [4d Td Jc] [Kc]
*** RIVER *** [4d Td Jc Kc] [9c]
*** SHOW DOWN ***
Lne9leXjEzXWbU3BGFWsxQ: shows [Ah Kd] (a pair of Kings)
voSAIKXtXUUbJnds83sYfQ: shows [Qc Qd] (a straight, Nine to King)
voSAIKXtXUUbJnds83sYfQ collected $2057 from pot
*** SUMMARY ***
Total pot $2060 | Rake $3
Board [4d Td Jc Kc 9c]
Seat 1: Xl+I49lxCJwPGRuegiaHoA (button) folded before Flop (didn't bet)
Seat 2: zdS2zKkZYSRe8p+GVcXMgg (small blind) folded before Flop
Seat 3: Lne9leXjEzXWbU3BGFWsxQ (big blind) showed [Ah Kd] and lost with a pair of Kings
Seat 4: voSAIKXtXUUbJnds83sYfQ showed [Qc Qd] and won ($2057) with a straight, Nine to King
Seat 5: jkH6qYMpn8JA/IyBOhQPMw folded before Flop
Seat 6: 3mTlg4g0FJN2bo939h/0Wg folded before Flop (didn't bet)



PokerStars Game #59962227048:  Hold'em No Limit ($5/$10) - 2009/07/01 11:30:04 ET
Table '2a86NK3xhs21kwGZmbj0QA' 6-max Seat #6 is the button
Seat 1: is0C+o+4W8624tMaRmJg7A ($1000 in chips)
Seat 2: Xl+I49lxCJwPGRuegiaHoA ($2516 in chips)
Seat 3: voSAIKXtXUUbJnds83sYfQ ($1042 in chips)
Seat 4: 1ScqYmNf7/uWx1XSBgPTBw ($232.25 in chips)
Seat 5: jkH6qYMpn8JA/IyBOhQPMw ($1664.25 in chips)
Seat 6: 0OfLwED3kKs3FwY+JlHC0g ($1260 in chips)
is0C+o+4W8624tMaRmJg7A: posts small blind $5
Xl+I49lxCJwPGRuegiaHoA: posts big blind $10
*** HOLE CARDS ***
voSAIKXtXUUbJnds83sYfQ: folds
1ScqYmNf7/uWx1XSBgPTBw: folds
jkH6qYMpn8JA/IyBOhQPMw: raises $20 to $30
0OfLwED3kKs3FwY+JlHC0g: folds
is0C+o+4W8624tMaRmJg7A: folds
Xl+I49lxCJwPGRuegiaHoA: folds
jkH6qYMpn8JA/IyBOhQPMw collected $25 from pot
jkH6qYMpn8JA/IyBOhQPMw: doesn't show hand
*** SUMMARY ***
Total pot $25 | Rake $0
Seat 1: is0C+o+4W8624tMaRmJg7A (small blind) folded before Flop
Seat 2: Xl+I49lxCJwPGRuegiaHoA (big blind) folded before Flop
Seat 3: voSAIKXtXUUbJnds83sYfQ folded before Flop (didn't bet)
Seat 4: 1ScqYmNf7/uWx1XSBgPTBw folded before Flop (didn't bet)
Seat 5: jkH6qYMpn8JA/IyBOhQPMw collected ($25)
Seat 6: 0OfLwED3kKs3FwY+JlHC0g (button) folded before Flop (didn't bet)



PokerStars Game #59962239138:  Hold'em No Limit ($5/$10) - 2009/07/01 11:30:17 ET
Table 'dwLGEw3aoH/cOAI7JsLdmw' 6-max Seat #6 is the button
Seat 1: is0C+o+4W8624tMaRmJg7A ($1005 in chips)
Seat 2: 1ScqYmNf7/uWx1XSBgPTBw ($165 in chips)
Seat 3: voSAIKXtXUUbJnds83sYfQ ($1319 in chips)
Seat 4: efhcaDPhNqQ/H48kMHLa8w ($1037 in chips)
Seat 5: jkH6qYMpn8JA/IyBOhQPMw ($1918 in chips)
Seat 6: 3mTlg4g0FJN2bo939h/0Wg ($472 in chips)
is0C+o+4W8624tMaRmJg7A: posts small blind $5
1ScqYmNf7/uWx1XSBgPTBw: posts big blind $10
*** HOLE CARDS ***
voSAIKXtXUUbJnds83sYfQ: folds
efhcaDPhNqQ/H48kMHLa8w: raises $20 to $30
jkH6qYMpn8JA/IyBOhQPMw: calls $30
3mTlg4g0FJN2bo939h/0Wg: folds
is0C+o+4W8624tMaRmJg7A: folds
1ScqYmNf7/uWx1XSBgPTBw: folds
*** FLOP *** [2h 8d 3s]
efhcaDPhNqQ/H48kMHLa8w: checks
jkH6qYMpn8JA/IyBOhQPMw: bets $62
efhcaDPhNqQ/H48kMHLa8w: calls $62
*** TURN *** [2h 8d 3s] [Qc]
efhcaDPhNqQ/H48kMHLa8w: checks
jkH6qYMpn8JA/IyBOhQPMw: checks
*** RIVER *** [2h 8d 3s Qc] [Ts]
efhcaDPhNqQ/H48kMHLa8w: checks
jkH6qYMpn8JA/IyBOhQPMw: bets $154
efhcaDPhNqQ/H48kMHLa8w: raises $246 to $400
jkH6qYMpn8JA/IyBOhQPMw: folds
efhcaDPhNqQ/H48kMHLa8w collected $504 from pot
*** SUMMARY ***
Total pot $507 | Rake $3
Board [2h 8d 3s Qc Ts]
Seat 1: is0C+o+4W8624tMaRmJg7A (small blind) folded before Flop
Seat 2: 1ScqYmNf7/uWx1XSBgPTBw (big blind) folded before Flop
Seat 3: voSAIKXtXUUbJnds83sYfQ folded before Flop (didn't bet)
Seat 4: efhcaDPhNqQ/H48kMHLa8w collected ($504)
Seat 5: jkH6qYMpn8JA/IyBOhQPMw folded on the River
Seat 6: 3mTlg4g0FJN2bo939h/0Wg (button) folded before Flop (didn't bet)



PokerStars Game #59962254916:  Hold'em No Limit ($5/$10) - 2009/07/01 11:30:36 ET
Table 'AI1fZ7Tsbf9DI8mC4EWoQQ' 9-max Seat #7 is the button
Seat 1: ve1LEJosAmuFjNNCQuPnPg ($1030.50 in chips)
Seat 2: voSAIKXtXUUbJnds83sYfQ ($1000 in chips)
Seat 3: vM2kcH3Ff9H6Drv0NwoocA ($177.75 in chips)
Seat 4: efhcaDPhNqQ/H48kMHLa8w ($1015 in chips)
Seat 5: 2PHCSXghjbGk2qR6jDFe2g ($1142 in chips)
Seat 6: l9mDFuns/ycIDiFx40BMVw ($800 in chips)
Seat 7: ettgJAblGnistIlqNz4Jww ($1000 in chips)
Seat 8: K/ETAn4GnsqZgUCBm9C9PQ ($1010 in chips)
Seat 9: 1s1h7qXmZxmowl9P1VNe2Q ($200 in chips)
K/ETAn4GnsqZgUCBm9C9PQ: posts small blind $5
1s1h7qXmZxmowl9P1VNe2Q: posts big blind $10
*** HOLE CARDS ***
ve1LEJosAmuFjNNCQuPnPg: raises $20 to $30
voSAIKXtXUUbJnds83sYfQ: calls $30
vM2kcH3Ff9H6Drv0NwoocA: folds
efhcaDPhNqQ/H48kMHLa8w: folds
2PHCSXghjbGk2qR6jDFe2g: folds
l9mDFuns/ycIDiFx40BMVw: folds
ettgJAblGnistIlqNz4Jww: folds
K/ETAn4GnsqZgUCBm9C9PQ: folds
1s1h7qXmZxmowl9P1VNe2Q: folds
*** FLOP *** [2h 9c Kh]
ve1LEJosAmuFjNNCQuPnPg: checks
voSAIKXtXUUbJnds83sYfQ: checks
*** TURN *** [2h 9c Kh] [Td]
ve1LEJosAmuFjNNCQuPnPg: bets $40
voSAIKXtXUUbJnds83sYfQ: folds
ve1LEJosAmuFjNNCQuPnPg collected $72 from pot
ve1LEJosAmuFjNNCQuPnPg: doesn't show hand
*** SUMMARY ***
Total pot $75 | Rake $3
Board [2h 9c Kh Td]
Seat 1: ve1LEJosAmuFjNNCQuPnPg collected ($72)
Seat 2: voSAIKXtXUUbJnds83sYfQ folded on the Turn
Seat 3: vM2kcH3Ff9H6Drv0NwoocA folded before Flop (didn't bet)
Seat 4: efhcaDPhNqQ/H48kMHLa8w folded before Flop (didn't bet)
Seat 5: 2PHCSXghjbGk2qR6jDFe2g folded before Flop (didn't bet)
Seat 6: l9mDFuns/ycIDiFx40BMVw folded before Flop (didn't bet)
Seat 7: ettgJAblGnistIlqNz4Jww (button) folded before Flop (didn't bet)
Seat 8: K/ETAn4GnsqZgUCBm9C9PQ (small blind) folded before Flop
Seat 9: 1s1h7qXmZxmowl9P1VNe2Q (big blind) folded before Flop



PokerStars Game #59962265472:  Hold'em No Limit ($5/$10) - 2009/07/01 11:30:47 ET
Table '2a86NK3xhs21kwGZmbj0QA' 6-max Seat #1 is the button
Seat 1: is0C+o+4W8624tMaRmJg7A ($1000 in chips)
Seat 2: Xl+I49lxCJwPGRuegiaHoA ($2506 in chips)
Seat 3: voSAIKXtXUUbJnds83sYfQ ($1042 in chips)
Seat 4: 1ScqYmNf7/uWx1XSBgPTBw ($232.25 in chips)
Seat 5: jkH6qYMpn8JA/IyBOhQPMw ($1679.25 in chips)
Seat 6: 0OfLwED3kKs3FwY+JlHC0g ($1260 in chips)
Xl+I49lxCJwPGRuegiaHoA: posts small blind $5
voSAIKXtXUUbJnds83sYfQ: posts big blind $10
*** HOLE CARDS ***
1ScqYmNf7/uWx1XSBgPTBw: folds
jkH6qYMpn8JA/IyBOhQPMw: folds
0OfLwED3kKs3FwY+JlHC0g: raises $20 to $30
is0C+o+4W8624tMaRmJg7A: raises $70 to $100
Xl+I49lxCJwPGRuegiaHoA: folds
voSAIKXtXUUbJnds83sYfQ: folds
0OfLwED3kKs3FwY+JlHC0g: folds
is0C+o+4W8624tMaRmJg7A collected $75 from pot
is0C+o+4W8624tMaRmJg7A: doesn't show hand
*** SUMMARY ***
Total pot $75 | Rake $0
Seat 1: is0C+o+4W8624tMaRmJg7A (button) collected ($75)
Seat 2: Xl+I49lxCJwPGRuegiaHoA (small blind) folded before Flop
Seat 3: voSAIKXtXUUbJnds83sYfQ (big blind) folded before Flop
Seat 4: 1ScqYmNf7/uWx1XSBgPTBw folded before Flop (didn't bet)
Seat 5: jkH6qYMpn8JA/IyBOhQPMw folded before Flop (didn't bet)
Seat 6: 0OfLwED3kKs3FwY+JlHC0g folded before Flop



PokerStars Game #59962270266:  Hold'em No Limit ($5/$10) - 2009/07/01 11:30:53 ET
Table '1Dt9cpcLUVE6HYkx5dUEdQ' 6-max Seat #2 is the button
Seat 1: Xl+I49lxCJwPGRuegiaHoA ($1015 in chips)
Seat 2: zdS2zKkZYSRe8p+GVcXMgg ($1896.10 in chips)
Seat 3: Lne9leXjEzXWbU3BGFWsxQ ($1000 in chips)
Seat 4: voSAIKXtXUUbJnds83sYfQ ($2111 in chips)
Seat 5: jkH6qYMpn8JA/IyBOhQPMw ($1027 in chips)
Seat 6: 3mTlg4g0FJN2bo939h/0Wg ($1230 in chips)
Lne9leXjEzXWbU3BGFWsxQ: posts small blind $5
voSAIKXtXUUbJnds83sYfQ: posts big blind $10
*** HOLE CARDS ***
jkH6qYMpn8JA/IyBOhQPMw: folds
3mTlg4g0FJN2bo939h/0Wg: folds
Xl+I49lxCJwPGRuegiaHoA: folds
zdS2zKkZYSRe8p+GVcXMgg: folds
Lne9leXjEzXWbU3BGFWsxQ: raises $20 to $30
voSAIKXtXUUbJnds83sYfQ: folds
Lne9leXjEzXWbU3BGFWsxQ collected $20 from pot
Lne9leXjEzXWbU3BGFWsxQ: doesn't show hand
*** SUMMARY ***
Total pot $20 | Rake $0
Seat 1: Xl+I49lxCJwPGRuegiaHoA folded before Flop (didn't bet)
Seat 2: zdS2zKkZYSRe8p+GVcXMgg (button) folded before Flop (didn't bet)
Seat 3: Lne9leXjEzXWbU3BGFWsxQ (small blind) collected ($20)
Seat 4: voSAIKXtXUUbJnds83sYfQ (big blind) folded before Flop
Seat 5: jkH6qYMpn8JA/IyBOhQPMw folded before Flop (didn't bet)
Seat 6: 3mTlg4g0FJN2bo939h/0Wg folded before Flop (didn't bet)



PokerStars Game #59962284248:  Hold'em No Limit ($5/$10) - 2009/07/01 11:31:08 ET
Table '2a86NK3xhs21kwGZmbj0QA' 6-max Seat #2 is the button
Seat 1: is0C+o+4W8624tMaRmJg7A ($1045 in chips)
Seat 2: Xl+I49lxCJwPGRuegiaHoA ($2501 in chips)
Seat 3: voSAIKXtXUUbJnds83sYfQ ($1032 in chips)
Seat 4: 1ScqYmNf7/uWx1XSBgPTBw ($232.25 in chips)
Seat 5: jkH6qYMpn8JA/IyBOhQPMw ($1679.25 in chips)
Seat 6: 0OfLwED3kKs3FwY+JlHC0g ($1230 in chips)
voSAIKXtXUUbJnds83sYfQ: posts small blind $5
1ScqYmNf7/uWx1XSBgPTBw: posts big blind $10
*** HOLE CARDS ***
jkH6qYMpn8JA/IyBOhQPMw: folds
0OfLwED3kKs3FwY+JlHC0g: raises $20 to $30
is0C+o+4W8624tMaRmJg7A: folds
Xl+I49lxCJwPGRuegiaHoA: folds
voSAIKXtXUUbJnds83sYfQ: folds
1ScqYmNf7/uWx1XSBgPTBw: folds
0OfLwED3kKs3FwY+JlHC0g collected $25 from pot
0OfLwED3kKs3FwY+JlHC0g: doesn't show hand
*** SUMMARY ***
Total pot $25 | Rake $0
Seat 1: is0C+o+4W8624tMaRmJg7A folded before Flop (didn't bet)
Seat 2: Xl+I49lxCJwPGRuegiaHoA (button) folded before Flop (didn't bet)
Seat 3: voSAIKXtXUUbJnds83sYfQ (small blind) folded before Flop
Seat 4: 1ScqYmNf7/uWx1XSBgPTBw (big blind) folded before Flop
Seat 5: jkH6qYMpn8JA/IyBOhQPMw folded before Flop (didn't bet)
Seat 6: 0OfLwED3kKs3FwY+JlHC0g collected ($25)



PokerStars Game #59962291664:  Hold'em No Limit ($5/$10) - 2009/07/01 11:31:16 ET
Table '1Dt9cpcLUVE6HYkx5dUEdQ' 6-max Seat #3 is the button
Seat 1: Xl+I49lxCJwPGRuegiaHoA ($1015 in chips)
Seat 2: zdS2zKkZYSRe8p+GVcXMgg ($1896.10 in chips)
Seat 3: Lne9leXjEzXWbU3BGFWsxQ ($1010 in chips)
Seat 4: voSAIKXtXUUbJnds83sYfQ ($2101 in chips)
Seat 5: jkH6qYMpn8JA/IyBOhQPMw ($1027 in chips)
Seat 6: 3mTlg4g0FJN2bo939h/0Wg ($1230 in chips)
voSAIKXtXUUbJnds83sYfQ: posts small blind $5
jkH6qYMpn8JA/IyBOhQPMw: posts big blind $10
*** HOLE CARDS ***
3mTlg4g0FJN2bo939h/0Wg: folds
Xl+I49lxCJwPGRuegiaHoA: folds
zdS2zKkZYSRe8p+GVcXMgg: calls $10
Lne9leXjEzXWbU3BGFWsxQ: folds
voSAIKXtXUUbJnds83sYfQ: calls $5
jkH6qYMpn8JA/IyBOhQPMw: checks
*** FLOP *** [2s Kc 5c]
voSAIKXtXUUbJnds83sYfQ: checks
jkH6qYMpn8JA/IyBOhQPMw: checks
zdS2zKkZYSRe8p+GVcXMgg: checks
*** TURN *** [2s Kc 5c] [Ks]
voSAIKXtXUUbJnds83sYfQ: checks
jkH6qYMpn8JA/IyBOhQPMw: bets $20
zdS2zKkZYSRe8p+GVcXMgg: folds
voSAIKXtXUUbJnds83sYfQ: folds
jkH6qYMpn8JA/IyBOhQPMw collected $28.50 from pot
*** SUMMARY ***
Total pot $30 | Rake $1.50
Board [2s Kc 5c Ks]
Seat 1: Xl+I49lxCJwPGRuegiaHoA folded before Flop (didn't bet)
Seat 2: zdS2zKkZYSRe8p+GVcXMgg folded on the Turn
Seat 3: Lne9leXjEzXWbU3BGFWsxQ (button) folded before Flop (didn't bet)
Seat 4: voSAIKXtXUUbJnds83sYfQ (small blind) folded on the Turn
Seat 5: jkH6qYMpn8JA/IyBOhQPMw (big blind) collected ($28.50)
Seat 6: 3mTlg4g0FJN2bo939h/0Wg folded before Flop (didn't bet)



PokerStars Game #59962304160:  Hold'em No Limit ($5/$10) - 2009/07/01 11:31:30 ET
Table '2a86NK3xhs21kwGZmbj0QA' 6-max Seat #3 is the button
Seat 1: is0C+o+4W8624tMaRmJg7A ($1045 in chips)
Seat 2: Xl+I49lxCJwPGRuegiaHoA ($2501 in chips)
Seat 3: voSAIKXtXUUbJnds83sYfQ ($1027 in chips)
Seat 4: 1ScqYmNf7/uWx1XSBgPTBw ($222.25 in chips)
Seat 5: jkH6qYMpn8JA/IyBOhQPMw ($1679.25 in chips)
Seat 6: 0OfLwED3kKs3FwY+JlHC0g ($1245 in chips)
1ScqYmNf7/uWx1XSBgPTBw: posts small blind $5
jkH6qYMpn8JA/IyBOhQPMw: posts big blind $10
*** HOLE CARDS ***
0OfLwED3kKs3FwY+JlHC0g: folds
is0C+o+4W8624tMaRmJg7A: folds
Xl+I49lxCJwPGRuegiaHoA: folds
voSAIKXtXUUbJnds83sYfQ: folds
1ScqYmNf7/uWx1XSBgPTBw: folds
jkH6qYMpn8JA/IyBOhQPMw collected $10 from pot
jkH6qYMpn8JA/IyBOhQPMw: doesn't show hand
*** SUMMARY ***
Total pot $10 | Rake $0
Seat 1: is0C+o+4W8624tMaRmJg7A folded before Flop (didn't bet)
Seat 2: Xl+I49lxCJwPGRuegiaHoA folded before Flop (didn't bet)
Seat 3: voSAIKXtXUUbJnds83sYfQ (button) folded before Flop (didn't bet)
Seat 4: 1ScqYmNf7/uWx1XSBgPTBw (small blind) folded before Flop
Seat 5: jkH6qYMpn8JA/IyBOhQPMw (big blind) collected ($10)
Seat 6: 0OfLwED3kKs3FwY+JlHC0g folded before Flop (didn't bet)



PokerStars Game #59962319740:  Hold'em No Limit ($5/$10) - 2009/07/01 11:31:48 ET
Table '2a86NK3xhs21kwGZmbj0QA' 6-max Seat #4 is the button
Seat 1: is0C+o+4W8624tMaRmJg7A ($1045 in chips)
Seat 2: Xl+I49lxCJwPGRuegiaHoA ($2501 in chips)
Seat 3: voSAIKXtXUUbJnds83sYfQ ($1027 in chips)
Seat 4: 1ScqYmNf7/uWx1XSBgPTBw ($217.25 in chips)
Seat 5: jkH6qYMpn8JA/IyBOhQPMw ($1684.25 in chips)
Seat 6: 0OfLwED3kKs3FwY+JlHC0g ($1245 in chips)
jkH6qYMpn8JA/IyBOhQPMw: posts small blind $5
0OfLwED3kKs3FwY+JlHC0g: posts big blind $10
*** HOLE CARDS ***
is0C+o+4W8624tMaRmJg7A: folds
Xl+I49lxCJwPGRuegiaHoA: folds
voSAIKXtXUUbJnds83sYfQ: folds
1ScqYmNf7/uWx1XSBgPTBw: folds
jkH6qYMpn8JA/IyBOhQPMw: raises $20 to $30
0OfLwED3kKs3FwY+JlHC0g: raises $70 to $100
jkH6qYMpn8JA/IyBOhQPMw: folds
0OfLwED3kKs3FwY+JlHC0g collected $60 from pot
0OfLwED3kKs3FwY+JlHC0g: doesn't show hand
*** SUMMARY ***
Total pot $60 | Rake $0
Seat 1: is0C+o+4W8624tMaRmJg7A folded before Flop (didn't bet)
Seat 2: Xl+I49lxCJwPGRuegiaHoA folded before Flop (didn't bet)
Seat 3: voSAIKXtXUUbJnds83sYfQ folded before Flop (didn't bet)
Seat 4: 1ScqYmNf7/uWx1XSBgPTBw (button) folded before Flop (didn't bet)
Seat 5: jkH6qYMpn8JA/IyBOhQPMw (small blind) folded before Flop
Seat 6: 0OfLwED3kKs3FwY+JlHC0g (big blind) collected ($60)



PokerStars Game #59962324196:  Hold'em No Limit ($5/$10) - 2009/07/01 11:31:53 ET
Table 'dwLGEw3aoH/cOAI7JsLdmw' 6-max Seat #1 is the button
Seat 1: is0C+o+4W8624tMaRmJg7A ($1000 in chips)
Seat 2: 1ScqYmNf7/uWx1XSBgPTBw ($155 in chips)
Seat 3: voSAIKXtXUUbJnds83sYfQ ($1319 in chips)
Seat 4: efhcaDPhNqQ/H48kMHLa8w ($1295 in chips)
Seat 5: jkH6qYMpn8JA/IyBOhQPMw ($1672 in chips)
Seat 6: 3mTlg4g0FJN2bo939h/0Wg ($472 in chips)
1ScqYmNf7/uWx1XSBgPTBw: posts small blind $5
voSAIKXtXUUbJnds83sYfQ: posts big blind $10
*** HOLE CARDS ***
efhcaDPhNqQ/H48kMHLa8w: raises $20 to $30
jkH6qYMpn8JA/IyBOhQPMw: calls $30
3mTlg4g0FJN2bo939h/0Wg: folds
is0C+o+4W8624tMaRmJg7A: folds
1ScqYmNf7/uWx1XSBgPTBw: folds
voSAIKXtXUUbJnds83sYfQ: folds
*** FLOP *** [Js Ts Tc]
efhcaDPhNqQ/H48kMHLa8w: bets $50
jkH6qYMpn8JA/IyBOhQPMw: raises $122 to $172
efhcaDPhNqQ/H48kMHLa8w: calls $122
*** TURN *** [Js Ts Tc] [3c]
efhcaDPhNqQ/H48kMHLa8w: bets $250
jkH6qYMpn8JA/IyBOhQPMw: calls $250
*** RIVER *** [Js Ts Tc 3c] [Qs]
efhcaDPhNqQ/H48kMHLa8w: checks
jkH6qYMpn8JA/IyBOhQPMw: bets $1220 and is all-in
efhcaDPhNqQ/H48kMHLa8w: folds
jkH6qYMpn8JA/IyBOhQPMw collected $916 from pot
*** SUMMARY ***
Total pot $919 | Rake $3
Board [Js Ts Tc 3c Qs]
Seat 1: is0C+o+4W8624tMaRmJg7A (button) folded before Flop (didn't bet)
Seat 2: 1ScqYmNf7/uWx1XSBgPTBw (small blind) folded before Flop
Seat 3: voSAIKXtXUUbJnds83sYfQ (big blind) folded before Flop
Seat 4: efhcaDPhNqQ/H48kMHLa8w folded on the River
Seat 5: jkH6qYMpn8JA/IyBOhQPMw collected ($916)
Seat 6: 3mTlg4g0FJN2bo939h/0Wg folded before Flop (didn't bet)



PokerStars Game #59962335504:  Hold'em No Limit ($5/$10) - 2009/07/01 11:32:05 ET
Table 'AI1fZ7Tsbf9DI8mC4EWoQQ' 9-max Seat #8 is the button
Seat 1: ve1LEJosAmuFjNNCQuPnPg ($1072.50 in chips)
Seat 2: voSAIKXtXUUbJnds83sYfQ ($1000 in chips)
Seat 3: vM2kcH3Ff9H6Drv0NwoocA ($177.75 in chips)
Seat 4: efhcaDPhNqQ/H48kMHLa8w ($1015 in chips)
Seat 5: 2PHCSXghjbGk2qR6jDFe2g ($1142 in chips)
Seat 6: l9mDFuns/ycIDiFx40BMVw ($800 in chips)
Seat 7: ettgJAblGnistIlqNz4Jww ($1000 in chips)
Seat 8: K/ETAn4GnsqZgUCBm9C9PQ ($1005 in chips)
Seat 9: 1s1h7qXmZxmowl9P1VNe2Q ($190 in chips)
1s1h7qXmZxmowl9P1VNe2Q: posts small blind $5
ve1LEJosAmuFjNNCQuPnPg: posts big blind $10
*** HOLE CARDS ***
voSAIKXtXUUbJnds83sYfQ: folds
vM2kcH3Ff9H6Drv0NwoocA: folds
efhcaDPhNqQ/H48kMHLa8w: folds
2PHCSXghjbGk2qR6jDFe2g: folds
l9mDFuns/ycIDiFx40BMVw: folds
ettgJAblGnistIlqNz4Jww: folds
K/ETAn4GnsqZgUCBm9C9PQ: raises $20 to $30
1s1h7qXmZxmowl9P1VNe2Q: folds
ve1LEJosAmuFjNNCQuPnPg: folds
K/ETAn4GnsqZgUCBm9C9PQ collected $25 from pot
*** SUMMARY ***
Total pot $25 | Rake $0
Seat 1: ve1LEJosAmuFjNNCQuPnPg (big blind) folded before Flop
Seat 2: voSAIKXtXUUbJnds83sYfQ folded before Flop (didn't bet)
Seat 3: vM2kcH3Ff9H6Drv0NwoocA folded before Flop (didn't bet)
Seat 4: efhcaDPhNqQ/H48kMHLa8w folded before Flop (didn't bet)
Seat 5: 2PHCSXghjbGk2qR6jDFe2g folded before Flop (didn't bet)
Seat 6: l9mDFuns/ycIDiFx40BMVw folded before Flop (didn't bet)
Seat 7: ettgJAblGnistIlqNz4Jww folded before Flop (didn't bet)
Seat 8: K/ETAn4GnsqZgUCBm9C9PQ (button) collected ($25)
Seat 9: 1s1h7qXmZxmowl9P1VNe2Q (small blind) folded before Flop



PokerStars Game #59962336884:  Hold'em No Limit ($5/$10) - 2009/07/01 11:32:06 ET
Table '1Dt9cpcLUVE6HYkx5dUEdQ' 6-max Seat #4 is the button
Seat 1: Xl+I49lxCJwPGRuegiaHoA ($1015 in chips)
Seat 2: zdS2zKkZYSRe8p+GVcXMgg ($1886.10 in chips)
Seat 3: Lne9leXjEzXWbU3BGFWsxQ ($1010 in chips)
Seat 4: voSAIKXtXUUbJnds83sYfQ ($2091 in chips)
Seat 5: jkH6qYMpn8JA/IyBOhQPMw ($1045.50 in chips)
Seat 6: 3mTlg4g0FJN2bo939h/0Wg ($1230 in chips)
jkH6qYMpn8JA/IyBOhQPMw: posts small blind $5
3mTlg4g0FJN2bo939h/0Wg: posts big blind $10
*** HOLE CARDS ***
Xl+I49lxCJwPGRuegiaHoA: folds
zdS2zKkZYSRe8p+GVcXMgg: raises $10 to $20
Lne9leXjEzXWbU3BGFWsxQ: folds
voSAIKXtXUUbJnds83sYfQ: folds
jkH6qYMpn8JA/IyBOhQPMw: folds
3mTlg4g0FJN2bo939h/0Wg: calls $10
*** FLOP *** [Qs Ad Ah]
3mTlg4g0FJN2bo939h/0Wg: checks
zdS2zKkZYSRe8p+GVcXMgg: checks
*** TURN *** [Qs Ad Ah] [7d]
3mTlg4g0FJN2bo939h/0Wg: bets $30
zdS2zKkZYSRe8p+GVcXMgg: folds
3mTlg4g0FJN2bo939h/0Wg collected $42.75 from pot
*** SUMMARY ***
Total pot $45 | Rake $2.25
Board [Qs Ad Ah 7d]
Seat 1: Xl+I49lxCJwPGRuegiaHoA folded before Flop (didn't bet)
Seat 2: zdS2zKkZYSRe8p+GVcXMgg folded on the Turn
Seat 3: Lne9leXjEzXWbU3BGFWsxQ folded before Flop (didn't bet)
Seat 4: voSAIKXtXUUbJnds83sYfQ (button) folded before Flop (didn't bet)
Seat 5: jkH6qYMpn8JA/IyBOhQPMw (small blind) folded before Flop
Seat 6: 3mTlg4g0FJN2bo939h/0Wg (big blind) collected ($42.75)



PokerStars Game #59962348410:  Hold'em No Limit ($5/$10) - 2009/07/01 11:32:19 ET
Table '2a86NK3xhs21kwGZmbj0QA' 6-max Seat #5 is the button
Seat 1: is0C+o+4W8624tMaRmJg7A ($1045 in chips)
Seat 2: Xl+I49lxCJwPGRuegiaHoA ($2501 in chips)
Seat 3: voSAIKXtXUUbJnds83sYfQ ($1027 in chips)
Seat 4: 1ScqYmNf7/uWx1XSBgPTBw ($217.25 in chips)
Seat 5: jkH6qYMpn8JA/IyBOhQPMw ($1654.25 in chips)
Seat 6: 0OfLwED3kKs3FwY+JlHC0g ($1275 in chips)
0OfLwED3kKs3FwY+JlHC0g: posts small blind $5
is0C+o+4W8624tMaRmJg7A: posts big blind $10
*** HOLE CARDS ***
Xl+I49lxCJwPGRuegiaHoA: raises $20 to $30
voSAIKXtXUUbJnds83sYfQ: folds
1ScqYmNf7/uWx1XSBgPTBw: folds
jkH6qYMpn8JA/IyBOhQPMw: folds
0OfLwED3kKs3FwY+JlHC0g: calls $25
is0C+o+4W8624tMaRmJg7A: calls $20
*** FLOP *** [9s 2d 6d]
0OfLwED3kKs3FwY+JlHC0g: bets $70
is0C+o+4W8624tMaRmJg7A: folds
Xl+I49lxCJwPGRuegiaHoA: folds
0OfLwED3kKs3FwY+JlHC0g collected $87 from pot
0OfLwED3kKs3FwY+JlHC0g: doesn't show hand
*** SUMMARY ***
Total pot $90 | Rake $3
Board [9s 2d 6d]
Seat 1: is0C+o+4W8624tMaRmJg7A (big blind) folded on the Flop
Seat 2: Xl+I49lxCJwPGRuegiaHoA folded on the Flop
Seat 3: voSAIKXtXUUbJnds83sYfQ folded before Flop (didn't bet)
Seat 4: 1ScqYmNf7/uWx1XSBgPTBw folded before Flop (didn't bet)
Seat 5: jkH6qYMpn8JA/IyBOhQPMw (button) folded before Flop (didn't bet)
Seat 6: 0OfLwED3kKs3FwY+JlHC0g (small blind) collected ($87)



PokerStars Game #59962371496:  Hold'em No Limit ($5/$10) - 2009/07/01 11:32:45 ET
Table 'AI1fZ7Tsbf9DI8mC4EWoQQ' 9-max Seat #9 is the button
Seat 1: ve1LEJosAmuFjNNCQuPnPg ($1062.50 in chips)
Seat 2: voSAIKXtXUUbJnds83sYfQ ($1000 in chips)
Seat 3: vM2kcH3Ff9H6Drv0NwoocA ($177.75 in chips)
Seat 4: efhcaDPhNqQ/H48kMHLa8w ($1015 in chips)
Seat 5: 2PHCSXghjbGk2qR6jDFe2g ($1142 in chips)
Seat 6: l9mDFuns/ycIDiFx40BMVw ($800 in chips)
Seat 7: ettgJAblGnistIlqNz4Jww ($1000 in chips)
Seat 8: K/ETAn4GnsqZgUCBm9C9PQ ($1020 in chips)
Seat 9: 1s1h7qXmZxmowl9P1VNe2Q ($185 in chips)
ve1LEJosAmuFjNNCQuPnPg: posts small blind $5
voSAIKXtXUUbJnds83sYfQ: posts big blind $10
*** HOLE CARDS ***
vM2kcH3Ff9H6Drv0NwoocA: folds
efhcaDPhNqQ/H48kMHLa8w: folds
2PHCSXghjbGk2qR6jDFe2g: folds
l9mDFuns/ycIDiFx40BMVw: folds
ettgJAblGnistIlqNz4Jww: raises $20 to $30
K/ETAn4GnsqZgUCBm9C9PQ: folds
1s1h7qXmZxmowl9P1VNe2Q: folds
ve1LEJosAmuFjNNCQuPnPg: folds
voSAIKXtXUUbJnds83sYfQ: folds
ettgJAblGnistIlqNz4Jww collected $25 from pot
*** SUMMARY ***
Total pot $25 | Rake $0
Seat 1: ve1LEJosAmuFjNNCQuPnPg (small blind) folded before Flop
Seat 2: voSAIKXtXUUbJnds83sYfQ (big blind) folded before Flop
Seat 3: vM2kcH3Ff9H6Drv0NwoocA folded before Flop (didn't bet)
Seat 4: efhcaDPhNqQ/H48kMHLa8w folded before Flop (didn't bet)
Seat 5: 2PHCSXghjbGk2qR6jDFe2g folded before Flop (didn't bet)
Seat 6: l9mDFuns/ycIDiFx40BMVw folded before Flop (didn't bet)
Seat 7: ettgJAblGnistIlqNz4Jww collected ($25)
Seat 8: K/ETAn4GnsqZgUCBm9C9PQ folded before Flop (didn't bet)
Seat 9: 1s1h7qXmZxmowl9P1VNe2Q (button) folded before Flop (didn't bet)



PokerStars Game #59962386112:  Hold'em No Limit ($5/$10) - 2009/07/01 11:33:01 ET
Table '1Dt9cpcLUVE6HYkx5dUEdQ' 6-max Seat #5 is the button
Seat 1: Xl+I49lxCJwPGRuegiaHoA ($1015 in chips)
Seat 2: zdS2zKkZYSRe8p+GVcXMgg ($1866.10 in chips)
Seat 3: Lne9leXjEzXWbU3BGFWsxQ ($1010 in chips)
Seat 4: voSAIKXtXUUbJnds83sYfQ ($2091 in chips)
Seat 5: jkH6qYMpn8JA/IyBOhQPMw ($1040.50 in chips)
Seat 6: 3mTlg4g0FJN2bo939h/0Wg ($1252.75 in chips)
3mTlg4g0FJN2bo939h/0Wg: posts small blind $5
Xl+I49lxCJwPGRuegiaHoA: posts big blind $10
*** HOLE CARDS ***
zdS2zKkZYSRe8p+GVcXMgg: raises $20 to $30
Lne9leXjEzXWbU3BGFWsxQ: folds
voSAIKXtXUUbJnds83sYfQ: folds
jkH6qYMpn8JA/IyBOhQPMw: calls $30
3mTlg4g0FJN2bo939h/0Wg: folds
Xl+I49lxCJwPGRuegiaHoA: folds
*** FLOP *** [4h 5d Kd]
zdS2zKkZYSRe8p+GVcXMgg: checks
jkH6qYMpn8JA/IyBOhQPMw: bets $52
zdS2zKkZYSRe8p+GVcXMgg: calls $52
*** TURN *** [4h 5d Kd] [7d]
zdS2zKkZYSRe8p+GVcXMgg: checks
jkH6qYMpn8JA/IyBOhQPMw: checks
*** RIVER *** [4h 5d Kd 7d] [2c]
zdS2zKkZYSRe8p+GVcXMgg: checks
jkH6qYMpn8JA/IyBOhQPMw: bets $162
zdS2zKkZYSRe8p+GVcXMgg: folds
jkH6qYMpn8JA/IyBOhQPMw collected $176 from pot
*** SUMMARY ***
Total pot $179 | Rake $3
Board [4h 5d Kd 7d 2c]
Seat 1: Xl+I49lxCJwPGRuegiaHoA (big blind) folded before Flop
Seat 2: zdS2zKkZYSRe8p+GVcXMgg folded on the River
Seat 3: Lne9leXjEzXWbU3BGFWsxQ folded before Flop (didn't bet)
Seat 4: voSAIKXtXUUbJnds83sYfQ folded before Flop (didn't bet)
Seat 5: jkH6qYMpn8JA/IyBOhQPMw (button) collected ($176)
Seat 6: 3mTlg4g0FJN2bo939h/0Wg (small blind) folded before Flop



PokerStars Game #59962385526:  Hold'em No Limit ($5/$10) - 2009/07/01 11:33:01 ET
Table '2a86NK3xhs21kwGZmbj0QA' 6-max Seat #6 is the button
Seat 1: is0C+o+4W8624tMaRmJg7A ($1015 in chips)
Seat 2: Xl+I49lxCJwPGRuegiaHoA ($2471 in chips)
Seat 3: voSAIKXtXUUbJnds83sYfQ ($1027 in chips)
Seat 4: 1ScqYmNf7/uWx1XSBgPTBw ($217.25 in chips)
Seat 5: jkH6qYMpn8JA/IyBOhQPMw ($1654.25 in chips)
Seat 6: 0OfLwED3kKs3FwY+JlHC0g ($1332 in chips)
is0C+o+4W8624tMaRmJg7A: posts small blind $5
Xl+I49lxCJwPGRuegiaHoA: posts big blind $10
*** HOLE CARDS ***
voSAIKXtXUUbJnds83sYfQ: folds
1ScqYmNf7/uWx1XSBgPTBw: folds
jkH6qYMpn8JA/IyBOhQPMw: folds
0OfLwED3kKs3FwY+JlHC0g: raises $15 to $25
is0C+o+4W8624tMaRmJg7A: raises $65 to $90
Xl+I49lxCJwPGRuegiaHoA: folds
0OfLwED3kKs3FwY+JlHC0g: folds
is0C+o+4W8624tMaRmJg7A collected $60 from pot
is0C+o+4W8624tMaRmJg7A: doesn't show hand
*** SUMMARY ***
Total pot $60 | Rake $0
Seat 1: is0C+o+4W8624tMaRmJg7A (small blind) collected ($60)
Seat 2: Xl+I49lxCJwPGRuegiaHoA (big blind) folded before Flop
Seat 3: voSAIKXtXUUbJnds83sYfQ folded before Flop (didn't bet)
Seat 4: 1ScqYmNf7/uWx1XSBgPTBw folded before Flop (didn't bet)
Seat 5: jkH6qYMpn8JA/IyBOhQPMw folded before Flop (didn't bet)
Seat 6: 0OfLwED3kKs3FwY+JlHC0g (button) folded before Flop



PokerStars Game #59962396706:  Hold'em No Limit ($5/$10) - 2009/07/01 11:33:13 ET
Table 'AI1fZ7Tsbf9DI8mC4EWoQQ' 9-max Seat #1 is the button
Seat 1: ve1LEJosAmuFjNNCQuPnPg ($1057.50 in chips)
Seat 2: voSAIKXtXUUbJnds83sYfQ ($1000 in chips)
Seat 3: vM2kcH3Ff9H6Drv0NwoocA ($177.75 in chips)
Seat 4: efhcaDPhNqQ/H48kMHLa8w ($1015 in chips)
Seat 5: 2PHCSXghjbGk2qR6jDFe2g ($1142 in chips)
Seat 6: l9mDFuns/ycIDiFx40BMVw ($800 in chips)
Seat 7: ettgJAblGnistIlqNz4Jww ($1015 in chips)
Seat 8: K/ETAn4GnsqZgUCBm9C9PQ ($1020 in chips)
Seat 9: 1s1h7qXmZxmowl9P1VNe2Q ($185 in chips)
voSAIKXtXUUbJnds83sYfQ: posts small blind $5
vM2kcH3Ff9H6Drv0NwoocA: posts big blind $10
*** HOLE CARDS ***
efhcaDPhNqQ/H48kMHLa8w: folds
2PHCSXghjbGk2qR6jDFe2g: folds
l9mDFuns/ycIDiFx40BMVw: folds
ettgJAblGnistIlqNz4Jww: raises $20 to $30
K/ETAn4GnsqZgUCBm9C9PQ: folds
1s1h7qXmZxmowl9P1VNe2Q: folds
ve1LEJosAmuFjNNCQuPnPg: folds
voSAIKXtXUUbJnds83sYfQ: folds
vM2kcH3Ff9H6Drv0NwoocA: raises $147.75 to $177.75 and is all-in
ettgJAblGnistIlqNz4Jww: folds
vM2kcH3Ff9H6Drv0NwoocA collected $65 from pot
*** SUMMARY ***
Total pot $65 | Rake $0
Seat 1: ve1LEJosAmuFjNNCQuPnPg (button) folded before Flop (didn't bet)
Seat 2: voSAIKXtXUUbJnds83sYfQ (small blind) folded before Flop
Seat 3: vM2kcH3Ff9H6Drv0NwoocA (big blind) collected ($65)
Seat 4: efhcaDPhNqQ/H48kMHLa8w folded before Flop (didn't bet)
Seat 5: 2PHCSXghjbGk2qR6jDFe2g folded before Flop (didn't bet)
Seat 6: l9mDFuns/ycIDiFx40BMVw folded before Flop (didn't bet)
Seat 7: ettgJAblGnistIlqNz4Jww folded before Flop
Seat 8: K/ETAn4GnsqZgUCBm9C9PQ folded before Flop (didn't bet)
Seat 9: 1s1h7qXmZxmowl9P1VNe2Q folded before Flop (didn't bet)



PokerStars Game #59962408524:  Hold'em No Limit ($5/$10) - 2009/07/01 11:33:26 ET
Table 'dwLGEw3aoH/cOAI7JsLdmw' 6-max Seat #2 is the button
Seat 1: is0C+o+4W8624tMaRmJg7A ($1000 in chips)
Seat 2: 1ScqYmNf7/uWx1XSBgPTBw ($150 in chips)
Seat 3: voSAIKXtXUUbJnds83sYfQ ($1309 in chips)
Seat 4: efhcaDPhNqQ/H48kMHLa8w ($1000 in chips)
Seat 5: jkH6qYMpn8JA/IyBOhQPMw ($2136 in chips)
Seat 6: 3mTlg4g0FJN2bo939h/0Wg ($472 in chips)
voSAIKXtXUUbJnds83sYfQ: posts small blind $5
efhcaDPhNqQ/H48kMHLa8w: posts big blind $10
*** HOLE CARDS ***
jkH6qYMpn8JA/IyBOhQPMw: folds
3mTlg4g0FJN2bo939h/0Wg said, "i had 10 3"
3mTlg4g0FJN2bo939h/0Wg said, "lol"
3mTlg4g0FJN2bo939h/0Wg: folds
is0C+o+4W8624tMaRmJg7A: raises $15 to $25
1ScqYmNf7/uWx1XSBgPTBw: folds
voSAIKXtXUUbJnds83sYfQ: folds
efhcaDPhNqQ/H48kMHLa8w: folds
is0C+o+4W8624tMaRmJg7A collected $25 from pot
*** SUMMARY ***
Total pot $25 | Rake $0
Seat 1: is0C+o+4W8624tMaRmJg7A collected ($25)
Seat 2: 1ScqYmNf7/uWx1XSBgPTBw (button) folded before Flop (didn't bet)
Seat 3: voSAIKXtXUUbJnds83sYfQ (small blind) folded before Flop
Seat 4: efhcaDPhNqQ/H48kMHLa8w (big blind) folded before Flop
Seat 5: jkH6qYMpn8JA/IyBOhQPMw folded before Flop (didn't bet)
Seat 6: 3mTlg4g0FJN2bo939h/0Wg folded before Flop (didn't bet)



PokerStars Game #59962412644:  Hold'em No Limit ($5/$10) - 2009/07/01 11:33:31 ET
Table '2a86NK3xhs21kwGZmbj0QA' 6-max Seat #1 is the button
Seat 1: is0C+o+4W8624tMaRmJg7A ($1050 in chips)
Seat 2: Xl+I49lxCJwPGRuegiaHoA ($2461 in chips)
Seat 3: voSAIKXtXUUbJnds83sYfQ ($1027 in chips)
Seat 4: 1ScqYmNf7/uWx1XSBgPTBw ($217.25 in chips)
Seat 5: jkH6qYMpn8JA/IyBOhQPMw ($1654.25 in chips)
Seat 6: 0OfLwED3kKs3FwY+JlHC0g ($1307 in chips)
Xl+I49lxCJwPGRuegiaHoA: posts small blind $5
voSAIKXtXUUbJnds83sYfQ: posts big blind $10
*** HOLE CARDS ***
1ScqYmNf7/uWx1XSBgPTBw: folds
jkH6qYMpn8JA/IyBOhQPMw: folds
0OfLwED3kKs3FwY+JlHC0g: raises $20 to $30
is0C+o+4W8624tMaRmJg7A: calls $30
Xl+I49lxCJwPGRuegiaHoA: calls $25
voSAIKXtXUUbJnds83sYfQ: folds
*** FLOP *** [4c Ts 8c]
Xl+I49lxCJwPGRuegiaHoA: checks
0OfLwED3kKs3FwY+JlHC0g: checks
is0C+o+4W8624tMaRmJg7A: bets $50
Xl+I49lxCJwPGRuegiaHoA: raises $110 to $160
0OfLwED3kKs3FwY+JlHC0g: folds
is0C+o+4W8624tMaRmJg7A: calls $110
*** TURN *** [4c Ts 8c] [7d]
Xl+I49lxCJwPGRuegiaHoA: bets $300
is0C+o+4W8624tMaRmJg7A: raises $560 to $860 and is all-in
Xl+I49lxCJwPGRuegiaHoA: calls $560
*** RIVER *** [4c Ts 8c 7d] [2h]
*** SHOW DOWN ***
Xl+I49lxCJwPGRuegiaHoA: shows [7s 8s] (two pair, Eights and Sevens)
is0C+o+4W8624tMaRmJg7A: mucks hand
Xl+I49lxCJwPGRuegiaHoA collected $2137 from pot
*** SUMMARY ***
Total pot $2140 | Rake $3
Board [4c Ts 8c 7d 2h]
Seat 1: is0C+o+4W8624tMaRmJg7A (button) mucked
Seat 2: Xl+I49lxCJwPGRuegiaHoA (small blind) showed [7s 8s] and won ($2137) with two pair, Eights and Sevens
Seat 3: voSAIKXtXUUbJnds83sYfQ (big blind) folded before Flop
Seat 4: 1ScqYmNf7/uWx1XSBgPTBw folded before Flop (didn't bet)
Seat 5: jkH6qYMpn8JA/IyBOhQPMw folded before Flop (didn't bet)
Seat 6: 0OfLwED3kKs3FwY+JlHC0g folded on the Flop



PokerStars Game #59962434032:  Hold'em No Limit ($5/$10) - 2009/07/01 11:33:54 ET
Table 'dwLGEw3aoH/cOAI7JsLdmw' 6-max Seat #3 is the button
Seat 1: is0C+o+4W8624tMaRmJg7A ($1015 in chips)
Seat 2: 1ScqYmNf7/uWx1XSBgPTBw ($150 in chips)
Seat 3: voSAIKXtXUUbJnds83sYfQ ($1304 in chips)
Seat 4: efhcaDPhNqQ/H48kMHLa8w ($1000 in chips)
Seat 5: jkH6qYMpn8JA/IyBOhQPMw ($2136 in chips)
Seat 6: 3mTlg4g0FJN2bo939h/0Wg ($472 in chips)
efhcaDPhNqQ/H48kMHLa8w: posts small blind $5
jkH6qYMpn8JA/IyBOhQPMw: posts big blind $10
*** HOLE CARDS ***
3mTlg4g0FJN2bo939h/0Wg: raises $20 to $30
is0C+o+4W8624tMaRmJg7A: folds
1ScqYmNf7/uWx1XSBgPTBw: folds
voSAIKXtXUUbJnds83sYfQ: folds
efhcaDPhNqQ/H48kMHLa8w: folds
jkH6qYMpn8JA/IyBOhQPMw: folds
3mTlg4g0FJN2bo939h/0Wg collected $25 from pot
*** SUMMARY ***
Total pot $25 | Rake $0
Seat 1: is0C+o+4W8624tMaRmJg7A folded before Flop (didn't bet)
Seat 2: 1ScqYmNf7/uWx1XSBgPTBw folded before Flop (didn't bet)
Seat 3: voSAIKXtXUUbJnds83sYfQ (button) folded before Flop (didn't bet)
Seat 4: efhcaDPhNqQ/H48kMHLa8w (small blind) folded before Flop
Seat 5: jkH6qYMpn8JA/IyBOhQPMw (big blind) folded before Flop
Seat 6: 3mTlg4g0FJN2bo939h/0Wg collected ($25)



PokerStars Game #59962439858:  Hold'em No Limit ($5/$10) - 2009/07/01 11:34:01 ET
Table 'AI1fZ7Tsbf9DI8mC4EWoQQ' 9-max Seat #2 is the button
Seat 1: ve1LEJosAmuFjNNCQuPnPg ($1057.50 in chips)
Seat 2: voSAIKXtXUUbJnds83sYfQ ($1000 in chips)
Seat 3: vM2kcH3Ff9H6Drv0NwoocA ($212.75 in chips)
Seat 4: efhcaDPhNqQ/H48kMHLa8w ($1015 in chips)
Seat 5: 2PHCSXghjbGk2qR6jDFe2g ($1142 in chips)
Seat 6: l9mDFuns/ycIDiFx40BMVw ($800 in chips)
Seat 7: ettgJAblGnistIlqNz4Jww ($1000 in chips)
Seat 8: K/ETAn4GnsqZgUCBm9C9PQ ($1020 in chips)
Seat 9: 1s1h7qXmZxmowl9P1VNe2Q ($185 in chips)
vM2kcH3Ff9H6Drv0NwoocA: posts small blind $5
efhcaDPhNqQ/H48kMHLa8w: posts big blind $10
*** HOLE CARDS ***
2PHCSXghjbGk2qR6jDFe2g: folds
l9mDFuns/ycIDiFx40BMVw: folds
ettgJAblGnistIlqNz4Jww: folds
K/ETAn4GnsqZgUCBm9C9PQ: folds
1s1h7qXmZxmowl9P1VNe2Q: raises $10 to $20
ve1LEJosAmuFjNNCQuPnPg: folds
voSAIKXtXUUbJnds83sYfQ: folds
vM2kcH3Ff9H6Drv0NwoocA: raises $27 to $47
efhcaDPhNqQ/H48kMHLa8w: folds
1s1h7qXmZxmowl9P1VNe2Q: calls $27
*** FLOP *** [7d Td Jh]
vM2kcH3Ff9H6Drv0NwoocA: bets $80
1s1h7qXmZxmowl9P1VNe2Q: folds
vM2kcH3Ff9H6Drv0NwoocA collected $101 from pot
*** SUMMARY ***
Total pot $104 | Rake $3
Board [7d Td Jh]
Seat 1: ve1LEJosAmuFjNNCQuPnPg folded before Flop (didn't bet)
Seat 2: voSAIKXtXUUbJnds83sYfQ (button) folded before Flop (didn't bet)
Seat 3: vM2kcH3Ff9H6Drv0NwoocA (small blind) collected ($101)
Seat 4: efhcaDPhNqQ/H48kMHLa8w (big blind) folded before Flop
Seat 5: 2PHCSXghjbGk2qR6jDFe2g folded before Flop (didn't bet)
Seat 6: l9mDFuns/ycIDiFx40BMVw folded before Flop (didn't bet)
Seat 7: ettgJAblGnistIlqNz4Jww folded before Flop (didn't bet)
Seat 8: K/ETAn4GnsqZgUCBm9C9PQ folded before Flop (didn't bet)
Seat 9: 1s1h7qXmZxmowl9P1VNe2Q folded on the Flop



PokerStars Game #59962439854:  Hold'em No Limit ($5/$10) - 2009/07/01 11:34:01 ET
Table 'mAacPTyMuJ4IQhEFOonFPg' 2-max Seat #1 is the button
Seat 1: XFruyoQqeueL4N+qXEkusw ($1018.50 in chips)
Seat 2: ezwKQeNDkLTr+c7tP2UjNw ($771.50 in chips)
XFruyoQqeueL4N+qXEkusw: posts small blind $5
ezwKQeNDkLTr+c7tP2UjNw: posts big blind $10
*** HOLE CARDS ***
XFruyoQqeueL4N+qXEkusw: raises $20 to $30
ezwKQeNDkLTr+c7tP2UjNw: calls $20
*** FLOP *** [5c Ah 8h]
ezwKQeNDkLTr+c7tP2UjNw: checks
XFruyoQqeueL4N+qXEkusw: checks
*** TURN *** [5c Ah 8h] [5d]
ezwKQeNDkLTr+c7tP2UjNw: bets $40
XFruyoQqeueL4N+qXEkusw: raises $140 to $180
ezwKQeNDkLTr+c7tP2UjNw: calls $140
*** RIVER *** [5c Ah 8h 5d] [Jd]
ezwKQeNDkLTr+c7tP2UjNw: checks
XFruyoQqeueL4N+qXEkusw: bets $808.50 and is all-in
ezwKQeNDkLTr+c7tP2UjNw: folds
XFruyoQqeueL4N+qXEkusw collected $419.50 from pot
XFruyoQqeueL4N+qXEkusw: doesn't show hand
*** SUMMARY ***
Total pot $420 | Rake $0.50
Board [5c Ah 8h 5d Jd]
Seat 1: XFruyoQqeueL4N+qXEkusw (button) (small blind) collected ($419.50)
Seat 2: ezwKQeNDkLTr+c7tP2UjNw (big blind) folded on the River



PokerStars Game #59962453498:  Hold'em No Limit ($5/$10) - 2009/07/01 11:34:16 ET
Table '1Dt9cpcLUVE6HYkx5dUEdQ' 6-max Seat #6 is the button
Seat 1: Xl+I49lxCJwPGRuegiaHoA ($1005 in chips)
Seat 2: zdS2zKkZYSRe8p+GVcXMgg ($1784.10 in chips)
Seat 3: Lne9leXjEzXWbU3BGFWsxQ ($1010 in chips)
Seat 4: voSAIKXtXUUbJnds83sYfQ ($2091 in chips)
Seat 5: jkH6qYMpn8JA/IyBOhQPMw ($1134.50 in chips)
Seat 6: 3mTlg4g0FJN2bo939h/0Wg ($1247.75 in chips)
Xl+I49lxCJwPGRuegiaHoA: posts small blind $5
zdS2zKkZYSRe8p+GVcXMgg: posts big blind $10
*** HOLE CARDS ***
Lne9leXjEzXWbU3BGFWsxQ: raises $20 to $30
voSAIKXtXUUbJnds83sYfQ: folds
jkH6qYMpn8JA/IyBOhQPMw: folds
3mTlg4g0FJN2bo939h/0Wg: folds
Xl+I49lxCJwPGRuegiaHoA: folds
zdS2zKkZYSRe8p+GVcXMgg: folds
Lne9leXjEzXWbU3BGFWsxQ collected $25 from pot
*** SUMMARY ***
Total pot $25 | Rake $0
Seat 1: Xl+I49lxCJwPGRuegiaHoA (small blind) folded before Flop
Seat 2: zdS2zKkZYSRe8p+GVcXMgg (big blind) folded before Flop
Seat 3: Lne9leXjEzXWbU3BGFWsxQ collected ($25)
Seat 4: voSAIKXtXUUbJnds83sYfQ folded before Flop (didn't bet)
Seat 5: jkH6qYMpn8JA/IyBOhQPMw folded before Flop (didn't bet)
Seat 6: 3mTlg4g0FJN2bo939h/0Wg (button) folded before Flop (didn't bet)



PokerStars Game #59962453262:  Hold'em No Limit ($5/$10) - 2009/07/01 11:34:16 ET
Table 'dwLGEw3aoH/cOAI7JsLdmw' 6-max Seat #4 is the button
Seat 1: is0C+o+4W8624tMaRmJg7A ($1015 in chips)
Seat 2: 1ScqYmNf7/uWx1XSBgPTBw ($150 in chips)
Seat 3: voSAIKXtXUUbJnds83sYfQ ($1304 in chips)
Seat 4: efhcaDPhNqQ/H48kMHLa8w ($1000 in chips)
Seat 5: jkH6qYMpn8JA/IyBOhQPMw ($2126 in chips)
Seat 6: 3mTlg4g0FJN2bo939h/0Wg ($487 in chips)
jkH6qYMpn8JA/IyBOhQPMw: posts small blind $5
3mTlg4g0FJN2bo939h/0Wg: posts big blind $10
*** HOLE CARDS ***
is0C+o+4W8624tMaRmJg7A: folds
jkH6qYMpn8JA/IyBOhQPMw said, "close"
1ScqYmNf7/uWx1XSBgPTBw: raises $10 to $20
voSAIKXtXUUbJnds83sYfQ: folds
efhcaDPhNqQ/H48kMHLa8w: calls $20
jkH6qYMpn8JA/IyBOhQPMw: calls $15
3mTlg4g0FJN2bo939h/0Wg: folds
*** FLOP *** [7d 6h Jh]
jkH6qYMpn8JA/IyBOhQPMw: checks
1ScqYmNf7/uWx1XSBgPTBw: checks
efhcaDPhNqQ/H48kMHLa8w: checks
*** TURN *** [7d 6h Jh] [2s]
jkH6qYMpn8JA/IyBOhQPMw: bets $52
1ScqYmNf7/uWx1XSBgPTBw: folds
efhcaDPhNqQ/H48kMHLa8w: folds
jkH6qYMpn8JA/IyBOhQPMw collected $67 from pot
*** SUMMARY ***
Total pot $70 | Rake $3
Board [7d 6h Jh 2s]
Seat 1: is0C+o+4W8624tMaRmJg7A folded before Flop (didn't bet)
Seat 2: 1ScqYmNf7/uWx1XSBgPTBw folded on the Turn
Seat 3: voSAIKXtXUUbJnds83sYfQ folded before Flop (didn't bet)
Seat 4: efhcaDPhNqQ/H48kMHLa8w (button) folded on the Turn
Seat 5: jkH6qYMpn8JA/IyBOhQPMw (small blind) collected ($67)
Seat 6: 3mTlg4g0FJN2bo939h/0Wg (big blind) folded before Flop



PokerStars Game #59962477764:  Hold'em No Limit ($5/$10) - 2009/07/01 11:34:43 ET
Table 'mAacPTyMuJ4IQhEFOonFPg' 2-max Seat #2 is the button
Seat 1: XFruyoQqeueL4N+qXEkusw ($1228 in chips)
Seat 2: ezwKQeNDkLTr+c7tP2UjNw ($561.50 in chips)
ezwKQeNDkLTr+c7tP2UjNw: posts small blind $5
XFruyoQqeueL4N+qXEkusw: posts big blind $10
*** HOLE CARDS ***
ezwKQeNDkLTr+c7tP2UjNw: raises $20 to $30
XFruyoQqeueL4N+qXEkusw: folds
ezwKQeNDkLTr+c7tP2UjNw collected $20 from pot
ezwKQeNDkLTr+c7tP2UjNw: doesn't show hand
*** SUMMARY ***
Total pot $20 | Rake $0
Seat 1: XFruyoQqeueL4N+qXEkusw (big blind) folded before Flop
Seat 2: ezwKQeNDkLTr+c7tP2UjNw (button) (small blind) collected ($20)



PokerStars Game #59962484058:  Hold'em No Limit ($5/$10) - 2009/07/01 11:34:50 ET
Table '1Dt9cpcLUVE6HYkx5dUEdQ' 6-max Seat #1 is the button
Seat 1: Xl+I49lxCJwPGRuegiaHoA ($1000 in chips)
Seat 2: zdS2zKkZYSRe8p+GVcXMgg ($1774.10 in chips)
Seat 3: Lne9leXjEzXWbU3BGFWsxQ ($1025 in chips)
Seat 4: voSAIKXtXUUbJnds83sYfQ ($2091 in chips)
Seat 5: jkH6qYMpn8JA/IyBOhQPMw ($1134.50 in chips)
Seat 6: 3mTlg4g0FJN2bo939h/0Wg ($1247.75 in chips)
zdS2zKkZYSRe8p+GVcXMgg: posts small blind $5
Lne9leXjEzXWbU3BGFWsxQ: posts big blind $10
*** HOLE CARDS ***
voSAIKXtXUUbJnds83sYfQ: raises $20 to $30
jkH6qYMpn8JA/IyBOhQPMw: folds
3mTlg4g0FJN2bo939h/0Wg: folds
Xl+I49lxCJwPGRuegiaHoA: folds
zdS2zKkZYSRe8p+GVcXMgg: calls $25
Lne9leXjEzXWbU3BGFWsxQ: folds
*** FLOP *** [3s Qc 9d]
zdS2zKkZYSRe8p+GVcXMgg: bets $30
voSAIKXtXUUbJnds83sYfQ: calls $30
*** TURN *** [3s Qc 9d] [Kd]
zdS2zKkZYSRe8p+GVcXMgg: bets $40
voSAIKXtXUUbJnds83sYfQ: calls $40
*** RIVER *** [3s Qc 9d Kd] [7c]
zdS2zKkZYSRe8p+GVcXMgg: bets $40
voSAIKXtXUUbJnds83sYfQ: folds
zdS2zKkZYSRe8p+GVcXMgg collected $207 from pot
*** SUMMARY ***
Total pot $210 | Rake $3
Board [3s Qc 9d Kd 7c]
Seat 1: Xl+I49lxCJwPGRuegiaHoA (button) folded before Flop (didn't bet)
Seat 2: zdS2zKkZYSRe8p+GVcXMgg (small blind) collected ($207)
Seat 3: Lne9leXjEzXWbU3BGFWsxQ (big blind) folded before Flop
Seat 4: voSAIKXtXUUbJnds83sYfQ folded on the River
Seat 5: jkH6qYMpn8JA/IyBOhQPMw folded before Flop (didn't bet)
Seat 6: 3mTlg4g0FJN2bo939h/0Wg folded before Flop (didn't bet)



PokerStars Game #59962487058:  Hold'em No Limit ($5/$10) - 2009/07/01 11:34:54 ET
Table 'mAacPTyMuJ4IQhEFOonFPg' 2-max Seat #1 is the button
Seat 1: XFruyoQqeueL4N+qXEkusw ($1218 in chips)
Seat 2: ezwKQeNDkLTr+c7tP2UjNw ($571.50 in chips)
XFruyoQqeueL4N+qXEkusw: posts small blind $5
ezwKQeNDkLTr+c7tP2UjNw: posts big blind $10
*** HOLE CARDS ***
XFruyoQqeueL4N+qXEkusw: raises $20 to $30
ezwKQeNDkLTr+c7tP2UjNw: raises $70 to $100
XFruyoQqeueL4N+qXEkusw: folds
ezwKQeNDkLTr+c7tP2UjNw collected $60 from pot
ezwKQeNDkLTr+c7tP2UjNw: doesn't show hand
*** SUMMARY ***
Total pot $60 | Rake $0
Seat 1: XFruyoQqeueL4N+qXEkusw (button) (small blind) folded before Flop
Seat 2: ezwKQeNDkLTr+c7tP2UjNw (big blind) collected ($60)



PokerStars Game #59962500130:  Hold'em No Limit ($5/$10) - 2009/07/01 11:35:08 ET
Table 'mAacPTyMuJ4IQhEFOonFPg' 2-max Seat #2 is the button
Seat 1: XFruyoQqeueL4N+qXEkusw ($1188 in chips)
Seat 2: ezwKQeNDkLTr+c7tP2UjNw ($601.50 in chips)
ezwKQeNDkLTr+c7tP2UjNw: posts small blind $5
XFruyoQqeueL4N+qXEkusw: posts big blind $10
*** HOLE CARDS ***
ezwKQeNDkLTr+c7tP2UjNw: folds
XFruyoQqeueL4N+qXEkusw collected $10 from pot
XFruyoQqeueL4N+qXEkusw: doesn't show hand
*** SUMMARY ***
Total pot $10 | Rake $0
Seat 1: XFruyoQqeueL4N+qXEkusw (big blind) collected ($10)
Seat 2: ezwKQeNDkLTr+c7tP2UjNw (button) (small blind) folded before Flop



PokerStars Game #59962502866:  Hold'em No Limit ($5/$10) - 2009/07/01 11:35:11 ET
Table 'AI1fZ7Tsbf9DI8mC4EWoQQ' 9-max Seat #3 is the button
Seat 1: ve1LEJosAmuFjNNCQuPnPg ($1057.50 in chips)
Seat 2: voSAIKXtXUUbJnds83sYfQ ($1000 in chips)
Seat 3: vM2kcH3Ff9H6Drv0NwoocA ($266.75 in chips)
Seat 4: efhcaDPhNqQ/H48kMHLa8w ($1005 in chips)
Seat 5: 2PHCSXghjbGk2qR6jDFe2g ($1142 in chips)
Seat 6: l9mDFuns/ycIDiFx40BMVw ($800 in chips)
Seat 7: ettgJAblGnistIlqNz4Jww ($1000 in chips)
Seat 8: K/ETAn4GnsqZgUCBm9C9PQ ($1020 in chips)
Seat 9: 1s1h7qXmZxmowl9P1VNe2Q ($138 in chips)
efhcaDPhNqQ/H48kMHLa8w: posts small blind $5
2PHCSXghjbGk2qR6jDFe2g: posts big blind $10
*** HOLE CARDS ***
l9mDFuns/ycIDiFx40BMVw: folds
ettgJAblGnistIlqNz4Jww: folds
K/ETAn4GnsqZgUCBm9C9PQ: folds
1s1h7qXmZxmowl9P1VNe2Q: raises $10 to $20
ve1LEJosAmuFjNNCQuPnPg: folds
voSAIKXtXUUbJnds83sYfQ: folds
vM2kcH3Ff9H6Drv0NwoocA: folds
efhcaDPhNqQ/H48kMHLa8w: folds
2PHCSXghjbGk2qR6jDFe2g: calls $10
*** FLOP *** [3s 4s Ac]
2PHCSXghjbGk2qR6jDFe2g: checks
K/ETAn4GnsqZgUCBm9C9PQ leaves the table
1s1h7qXmZxmowl9P1VNe2Q: bets $20
2PHCSXghjbGk2qR6jDFe2g: calls $20
*** TURN *** [3s 4s Ac] [6s]
2PHCSXghjbGk2qR6jDFe2g: checks
1s1h7qXmZxmowl9P1VNe2Q: checks
*** RIVER *** [3s 4s Ac 6s] [Qd]
2PHCSXghjbGk2qR6jDFe2g: checks
1s1h7qXmZxmowl9P1VNe2Q: checks
*** SHOW DOWN ***
2PHCSXghjbGk2qR6jDFe2g: shows [5c Kh] (high card Ace)
1s1h7qXmZxmowl9P1VNe2Q: shows [Th Tc] (a pair of Tens)
1s1h7qXmZxmowl9P1VNe2Q collected $82 from pot
*** SUMMARY ***
Total pot $85 | Rake $3
Board [3s 4s Ac 6s Qd]
Seat 1: ve1LEJosAmuFjNNCQuPnPg folded before Flop (didn't bet)
Seat 2: voSAIKXtXUUbJnds83sYfQ folded before Flop (didn't bet)
Seat 3: vM2kcH3Ff9H6Drv0NwoocA (button) folded before Flop (didn't bet)
Seat 4: efhcaDPhNqQ/H48kMHLa8w (small blind) folded before Flop
Seat 5: 2PHCSXghjbGk2qR6jDFe2g (big blind) showed [5c Kh] and lost with high card Ace
Seat 6: l9mDFuns/ycIDiFx40BMVw folded before Flop (didn't bet)
Seat 7: ettgJAblGnistIlqNz4Jww folded before Flop (didn't bet)
Seat 8: K/ETAn4GnsqZgUCBm9C9PQ folded before Flop (didn't bet)
Seat 9: 1s1h7qXmZxmowl9P1VNe2Q showed [Th Tc] and won ($82) with a pair of Tens



PokerStars Game #59962502976:  Hold'em No Limit ($5/$10) - 2009/07/01 11:35:12 ET
Table 'dwLGEw3aoH/cOAI7JsLdmw' 6-max Seat #5 is the button
Seat 1: is0C+o+4W8624tMaRmJg7A ($1015 in chips)
Seat 2: 1ScqYmNf7/uWx1XSBgPTBw ($130 in chips)
Seat 3: voSAIKXtXUUbJnds83sYfQ ($1304 in chips)
Seat 4: efhcaDPhNqQ/H48kMHLa8w ($1000 in chips)
Seat 5: jkH6qYMpn8JA/IyBOhQPMw ($2173 in chips)
Seat 6: 3mTlg4g0FJN2bo939h/0Wg ($477 in chips)
3mTlg4g0FJN2bo939h/0Wg: posts small blind $5
is0C+o+4W8624tMaRmJg7A: posts big blind $10
*** HOLE CARDS ***
1ScqYmNf7/uWx1XSBgPTBw: folds
voSAIKXtXUUbJnds83sYfQ: raises $20 to $30
efhcaDPhNqQ/H48kMHLa8w: folds
jkH6qYMpn8JA/IyBOhQPMw: folds
3mTlg4g0FJN2bo939h/0Wg: folds
is0C+o+4W8624tMaRmJg7A: folds
voSAIKXtXUUbJnds83sYfQ collected $25 from pot
*** SUMMARY ***
Total pot $25 | Rake $0
Seat 1: is0C+o+4W8624tMaRmJg7A (big blind) folded before Flop
Seat 2: 1ScqYmNf7/uWx1XSBgPTBw folded before Flop (didn't bet)
Seat 3: voSAIKXtXUUbJnds83sYfQ collected ($25)
Seat 4: efhcaDPhNqQ/H48kMHLa8w folded before Flop (didn't bet)
Seat 5: jkH6qYMpn8JA/IyBOhQPMw (button) folded before Flop (didn't bet)
Seat 6: 3mTlg4g0FJN2bo939h/0Wg (small blind) folded before Flop



PokerStars Game #59962504740:  Hold'em No Limit ($5/$10) - 2009/07/01 11:35:14 ET
Table 'mAacPTyMuJ4IQhEFOonFPg' 2-max Seat #1 is the button
Seat 1: XFruyoQqeueL4N+qXEkusw ($1193 in chips)
Seat 2: ezwKQeNDkLTr+c7tP2UjNw ($596.50 in chips)
XFruyoQqeueL4N+qXEkusw: posts small blind $5
ezwKQeNDkLTr+c7tP2UjNw: posts big blind $10
*** HOLE CARDS ***
XFruyoQqeueL4N+qXEkusw: raises $20 to $30
ezwKQeNDkLTr+c7tP2UjNw: folds
XFruyoQqeueL4N+qXEkusw collected $20 from pot
XFruyoQqeueL4N+qXEkusw: doesn't show hand
*** SUMMARY ***
Total pot $20 | Rake $0
Seat 1: XFruyoQqeueL4N+qXEkusw (button) (small blind) collected ($20)
Seat 2: ezwKQeNDkLTr+c7tP2UjNw (big blind) folded before Flop



PokerStars Game #59962510780:  Hold'em No Limit ($5/$10) - 2009/07/01 11:35:20 ET
Table 'mAacPTyMuJ4IQhEFOonFPg' 2-max Seat #2 is the button
Seat 1: XFruyoQqeueL4N+qXEkusw ($1203 in chips)
Seat 2: ezwKQeNDkLTr+c7tP2UjNw ($586.50 in chips)
ezwKQeNDkLTr+c7tP2UjNw: posts small blind $5
XFruyoQqeueL4N+qXEkusw: posts big blind $10
*** HOLE CARDS ***
ezwKQeNDkLTr+c7tP2UjNw: folds
XFruyoQqeueL4N+qXEkusw collected $10 from pot
XFruyoQqeueL4N+qXEkusw: doesn't show hand
*** SUMMARY ***
Total pot $10 | Rake $0
Seat 1: XFruyoQqeueL4N+qXEkusw (big blind) collected ($10)
Seat 2: ezwKQeNDkLTr+c7tP2UjNw (button) (small blind) folded before Flop



PokerStars Game #59962515618:  Hold'em No Limit ($5/$10) - 2009/07/01 11:35:25 ET
Table 'mAacPTyMuJ4IQhEFOonFPg' 2-max Seat #1 is the button
Seat 1: XFruyoQqeueL4N+qXEkusw ($1208 in chips)
Seat 2: ezwKQeNDkLTr+c7tP2UjNw ($581.50 in chips)
XFruyoQqeueL4N+qXEkusw: posts small blind $5
ezwKQeNDkLTr+c7tP2UjNw: posts big blind $10
*** HOLE CARDS ***
XFruyoQqeueL4N+qXEkusw: raises $20 to $30
ezwKQeNDkLTr+c7tP2UjNw: calls $20
*** FLOP *** [5c 9c 3c]
ezwKQeNDkLTr+c7tP2UjNw: checks
XFruyoQqeueL4N+qXEkusw: bets $40
ezwKQeNDkLTr+c7tP2UjNw: calls $40
*** TURN *** [5c 9c 3c] [2c]
ezwKQeNDkLTr+c7tP2UjNw: checks
XFruyoQqeueL4N+qXEkusw: checks
*** RIVER *** [5c 9c 3c 2c] [8s]
ezwKQeNDkLTr+c7tP2UjNw: bets $50
XFruyoQqeueL4N+qXEkusw: folds
ezwKQeNDkLTr+c7tP2UjNw collected $139.50 from pot
ezwKQeNDkLTr+c7tP2UjNw: doesn't show hand
*** SUMMARY ***
Total pot $140 | Rake $0.50
Board [5c 9c 3c 2c 8s]
Seat 1: XFruyoQqeueL4N+qXEkusw (button) (small blind) folded on the River
Seat 2: ezwKQeNDkLTr+c7tP2UjNw (big blind) collected ($139.50)



PokerStars Game #59962526516:  Hold'em No Limit ($5/$10) - 2009/07/01 11:35:38 ET
Table '2a86NK3xhs21kwGZmbj0QA' 6-max Seat #2 is the button
Seat 1: is0C+o+4W8624tMaRmJg7A ($1000 in chips)
Seat 2: Xl+I49lxCJwPGRuegiaHoA ($3548 in chips)
Seat 3: voSAIKXtXUUbJnds83sYfQ ($1017 in chips)
Seat 4: 1ScqYmNf7/uWx1XSBgPTBw ($217.25 in chips)
Seat 5: jkH6qYMpn8JA/IyBOhQPMw ($1654.25 in chips)
Seat 6: 0OfLwED3kKs3FwY+JlHC0g ($1277 in chips)
voSAIKXtXUUbJnds83sYfQ: posts small blind $5
1ScqYmNf7/uWx1XSBgPTBw: posts big blind $10
*** HOLE CARDS ***
jkH6qYMpn8JA/IyBOhQPMw: folds
is0C+o+4W8624tMaRmJg7A said, "lol"
0OfLwED3kKs3FwY+JlHC0g: folds
is0C+o+4W8624tMaRmJg7A: raises $15 to $25
Xl+I49lxCJwPGRuegiaHoA: folds
voSAIKXtXUUbJnds83sYfQ: raises $75 to $100
1ScqYmNf7/uWx1XSBgPTBw: folds
is0C+o+4W8624tMaRmJg7A: folds
voSAIKXtXUUbJnds83sYfQ collected $60 from pot
voSAIKXtXUUbJnds83sYfQ: doesn't show hand
*** SUMMARY ***
Total pot $60 | Rake $0
Seat 1: is0C+o+4W8624tMaRmJg7A folded before Flop
Seat 2: Xl+I49lxCJwPGRuegiaHoA (button) folded before Flop (didn't bet)
Seat 3: voSAIKXtXUUbJnds83sYfQ (small blind) collected ($60)
Seat 4: 1ScqYmNf7/uWx1XSBgPTBw (big blind) folded before Flop
Seat 5: jkH6qYMpn8JA/IyBOhQPMw folded before Flop (didn't bet)
Seat 6: 0OfLwED3kKs3FwY+JlHC0g folded before Flop (didn't bet)



PokerStars Game #59962527662:  Hold'em No Limit ($5/$10) - 2009/07/01 11:35:39 ET
Table 'dwLGEw3aoH/cOAI7JsLdmw' 6-max Seat #6 is the button
Seat 1: is0C+o+4W8624tMaRmJg7A ($1005 in chips)
Seat 2: 1ScqYmNf7/uWx1XSBgPTBw ($130 in chips)
Seat 3: voSAIKXtXUUbJnds83sYfQ ($1319 in chips)
Seat 4: efhcaDPhNqQ/H48kMHLa8w ($1000 in chips)
Seat 5: jkH6qYMpn8JA/IyBOhQPMw ($2173 in chips)
Seat 6: 3mTlg4g0FJN2bo939h/0Wg ($472 in chips)
is0C+o+4W8624tMaRmJg7A: posts small blind $5
1ScqYmNf7/uWx1XSBgPTBw: posts big blind $10
*** HOLE CARDS ***
voSAIKXtXUUbJnds83sYfQ: folds
efhcaDPhNqQ/H48kMHLa8w: folds
jkH6qYMpn8JA/IyBOhQPMw: folds
3mTlg4g0FJN2bo939h/0Wg: folds
is0C+o+4W8624tMaRmJg7A: raises $15 to $25
1ScqYmNf7/uWx1XSBgPTBw: raises $105 to $130 and is all-in
is0C+o+4W8624tMaRmJg7A: folds
1ScqYmNf7/uWx1XSBgPTBw collected $50 from pot
*** SUMMARY ***
Total pot $50 | Rake $0
Seat 1: is0C+o+4W8624tMaRmJg7A (small blind) folded before Flop
Seat 2: 1ScqYmNf7/uWx1XSBgPTBw (big blind) collected ($50)
Seat 3: voSAIKXtXUUbJnds83sYfQ folded before Flop (didn't bet)
Seat 4: efhcaDPhNqQ/H48kMHLa8w folded before Flop (didn't bet)
Seat 5: jkH6qYMpn8JA/IyBOhQPMw folded before Flop (didn't bet)
Seat 6: 3mTlg4g0FJN2bo939h/0Wg (button) folded before Flop (didn't bet)



PokerStars Game #59962536038:  Hold'em No Limit ($5/$10) - 2009/07/01 11:35:48 ET
Table 'mAacPTyMuJ4IQhEFOonFPg' 2-max Seat #2 is the button
Seat 1: XFruyoQqeueL4N+qXEkusw ($1138 in chips)
Seat 2: ezwKQeNDkLTr+c7tP2UjNw ($651 in chips)
ezwKQeNDkLTr+c7tP2UjNw: posts small blind $5
XFruyoQqeueL4N+qXEkusw: posts big blind $10
*** HOLE CARDS ***
ezwKQeNDkLTr+c7tP2UjNw: folds
XFruyoQqeueL4N+qXEkusw collected $10 from pot
XFruyoQqeueL4N+qXEkusw: doesn't show hand
*** SUMMARY ***
Total pot $10 | Rake $0
Seat 1: XFruyoQqeueL4N+qXEkusw (big blind) collected ($10)
Seat 2: ezwKQeNDkLTr+c7tP2UjNw (button) (small blind) folded before Flop



PokerStars Game #59962540884:  Hold'em No Limit ($5/$10) - 2009/07/01 11:35:54 ET
Table 'mAacPTyMuJ4IQhEFOonFPg' 2-max Seat #1 is the button
Seat 1: XFruyoQqeueL4N+qXEkusw ($1143 in chips)
Seat 2: ezwKQeNDkLTr+c7tP2UjNw ($646 in chips)
XFruyoQqeueL4N+qXEkusw: posts small blind $5
ezwKQeNDkLTr+c7tP2UjNw: posts big blind $10
*** HOLE CARDS ***
XFruyoQqeueL4N+qXEkusw: raises $20 to $30
ezwKQeNDkLTr+c7tP2UjNw: calls $20
*** FLOP *** [2s 4d Ks]
ezwKQeNDkLTr+c7tP2UjNw: checks
XFruyoQqeueL4N+qXEkusw: bets $40
ezwKQeNDkLTr+c7tP2UjNw: folds
XFruyoQqeueL4N+qXEkusw collected $59.50 from pot
XFruyoQqeueL4N+qXEkusw: doesn't show hand
*** SUMMARY ***
Total pot $60 | Rake $0.50
Board [2s 4d Ks]
Seat 1: XFruyoQqeueL4N+qXEkusw (button) (small blind) collected ($59.50)
Seat 2: ezwKQeNDkLTr+c7tP2UjNw (big blind) folded on the Flop



PokerStars Game #59962541072:  Hold'em No Limit ($5/$10) - 2009/07/01 11:35:54 ET
Table '1Dt9cpcLUVE6HYkx5dUEdQ' 6-max Seat #2 is the button
Seat 1: Xl+I49lxCJwPGRuegiaHoA ($1000 in chips)
Seat 2: zdS2zKkZYSRe8p+GVcXMgg ($1881.10 in chips)
Seat 3: Lne9leXjEzXWbU3BGFWsxQ ($1015 in chips)
Seat 4: voSAIKXtXUUbJnds83sYfQ ($1991 in chips)
Seat 5: jkH6qYMpn8JA/IyBOhQPMw ($1134.50 in chips)
Seat 6: 3mTlg4g0FJN2bo939h/0Wg ($1247.75 in chips)
Lne9leXjEzXWbU3BGFWsxQ: posts small blind $5
voSAIKXtXUUbJnds83sYfQ: posts big blind $10
*** HOLE CARDS ***
jkH6qYMpn8JA/IyBOhQPMw: folds
3mTlg4g0FJN2bo939h/0Wg: raises $20 to $30
Xl+I49lxCJwPGRuegiaHoA: folds
zdS2zKkZYSRe8p+GVcXMgg: calls $30
Lne9leXjEzXWbU3BGFWsxQ: folds
voSAIKXtXUUbJnds83sYfQ: folds
*** FLOP *** [Qc 5d 8h]
3mTlg4g0FJN2bo939h/0Wg: bets $30
zdS2zKkZYSRe8p+GVcXMgg: calls $30
*** TURN *** [Qc 5d 8h] [Jh]
3mTlg4g0FJN2bo939h/0Wg: checks
zdS2zKkZYSRe8p+GVcXMgg: bets $50
3mTlg4g0FJN2bo939h/0Wg: raises $70 to $120
zdS2zKkZYSRe8p+GVcXMgg: folds
3mTlg4g0FJN2bo939h/0Wg collected $232 from pot
*** SUMMARY ***
Total pot $235 | Rake $3
Board [Qc 5d 8h Jh]
Seat 1: Xl+I49lxCJwPGRuegiaHoA folded before Flop (didn't bet)
Seat 2: zdS2zKkZYSRe8p+GVcXMgg (button) folded on the Turn
Seat 3: Lne9leXjEzXWbU3BGFWsxQ (small blind) folded before Flop
Seat 4: voSAIKXtXUUbJnds83sYfQ (big blind) folded before Flop
Seat 5: jkH6qYMpn8JA/IyBOhQPMw folded before Flop (didn't bet)
Seat 6: 3mTlg4g0FJN2bo939h/0Wg collected ($232)



PokerStars Game #59962547020:  Hold'em No Limit ($5/$10) - 2009/07/01 11:36:01 ET
Table '2a86NK3xhs21kwGZmbj0QA' 6-max Seat #3 is the button
Seat 1: is0C+o+4W8624tMaRmJg7A ($1000 in chips)
Seat 2: Xl+I49lxCJwPGRuegiaHoA ($3548 in chips)
Seat 3: voSAIKXtXUUbJnds83sYfQ ($1052 in chips)
Seat 4: 1ScqYmNf7/uWx1XSBgPTBw ($207.25 in chips)
Seat 5: jkH6qYMpn8JA/IyBOhQPMw ($1654.25 in chips)
Seat 6: 0OfLwED3kKs3FwY+JlHC0g ($1277 in chips)
1ScqYmNf7/uWx1XSBgPTBw: posts small blind $5
jkH6qYMpn8JA/IyBOhQPMw: posts big blind $10
*** HOLE CARDS ***
0OfLwED3kKs3FwY+JlHC0g: folds
is0C+o+4W8624tMaRmJg7A: folds
Xl+I49lxCJwPGRuegiaHoA: folds
voSAIKXtXUUbJnds83sYfQ: folds
1ScqYmNf7/uWx1XSBgPTBw: raises $10 to $20
jkH6qYMpn8JA/IyBOhQPMw: calls $10
*** FLOP *** [2s Kd 5s]
1ScqYmNf7/uWx1XSBgPTBw: bets $20
jkH6qYMpn8JA/IyBOhQPMw: folds
1ScqYmNf7/uWx1XSBgPTBw collected $38 from pot
1ScqYmNf7/uWx1XSBgPTBw: doesn't show hand
*** SUMMARY ***
Total pot $40 | Rake $2
Board [2s Kd 5s]
Seat 1: is0C+o+4W8624tMaRmJg7A folded before Flop (didn't bet)
Seat 2: Xl+I49lxCJwPGRuegiaHoA folded before Flop (didn't bet)
Seat 3: voSAIKXtXUUbJnds83sYfQ (button) folded before Flop (didn't bet)
Seat 4: 1ScqYmNf7/uWx1XSBgPTBw (small blind) collected ($38)
Seat 5: jkH6qYMpn8JA/IyBOhQPMw (big blind) folded on the Flop
Seat 6: 0OfLwED3kKs3FwY+JlHC0g folded before Flop (didn't bet)



PokerStars Game #59962548600:  Hold'em No Limit ($5/$10) - 2009/07/01 11:36:02 ET
Table 'dwLGEw3aoH/cOAI7JsLdmw' 6-max Seat #1 is the button
Seat 1: is0C+o+4W8624tMaRmJg7A ($1000 in chips)
Seat 2: 1ScqYmNf7/uWx1XSBgPTBw ($155 in chips)
Seat 3: voSAIKXtXUUbJnds83sYfQ ($1319 in chips)
Seat 4: efhcaDPhNqQ/H48kMHLa8w ($1000 in chips)
Seat 5: jkH6qYMpn8JA/IyBOhQPMw ($2173 in chips)
Seat 6: 3mTlg4g0FJN2bo939h/0Wg ($472 in chips)
1ScqYmNf7/uWx1XSBgPTBw: posts small blind $5
voSAIKXtXUUbJnds83sYfQ: posts big blind $10
*** HOLE CARDS ***
efhcaDPhNqQ/H48kMHLa8w: folds
jkH6qYMpn8JA/IyBOhQPMw: folds
3mTlg4g0FJN2bo939h/0Wg: raises $20 to $30
is0C+o+4W8624tMaRmJg7A: folds
1ScqYmNf7/uWx1XSBgPTBw: folds
voSAIKXtXUUbJnds83sYfQ: folds
3mTlg4g0FJN2bo939h/0Wg collected $25 from pot
*** SUMMARY ***
Total pot $25 | Rake $0
Seat 1: is0C+o+4W8624tMaRmJg7A (button) folded before Flop (didn't bet)
Seat 2: 1ScqYmNf7/uWx1XSBgPTBw (small blind) folded before Flop
Seat 3: voSAIKXtXUUbJnds83sYfQ (big blind) folded before Flop
Seat 4: efhcaDPhNqQ/H48kMHLa8w folded before Flop (didn't bet)
Seat 5: jkH6qYMpn8JA/IyBOhQPMw folded before Flop (didn't bet)
Seat 6: 3mTlg4g0FJN2bo939h/0Wg collected ($25)



PokerStars Game #59962554724:  Hold'em No Limit ($5/$10) - 2009/07/01 11:36:09 ET
Table 'AI1fZ7Tsbf9DI8mC4EWoQQ' 9-max Seat #4 is the button
Seat 1: ve1LEJosAmuFjNNCQuPnPg ($1057.50 in chips)
Seat 2: voSAIKXtXUUbJnds83sYfQ ($1000 in chips)
Seat 3: vM2kcH3Ff9H6Drv0NwoocA ($266.75 in chips)
Seat 4: efhcaDPhNqQ/H48kMHLa8w ($1000 in chips)
Seat 5: 2PHCSXghjbGk2qR6jDFe2g ($1102 in chips)
Seat 6: l9mDFuns/ycIDiFx40BMVw ($800 in chips)
Seat 7: ettgJAblGnistIlqNz4Jww ($1000 in chips)
Seat 9: 1s1h7qXmZxmowl9P1VNe2Q ($180 in chips)
2PHCSXghjbGk2qR6jDFe2g: posts small blind $5
l9mDFuns/ycIDiFx40BMVw: posts big blind $10
*** HOLE CARDS ***
UgBUE0pOJDwUdQ53XJt8MQ joins the table at seat #8
ettgJAblGnistIlqNz4Jww: folds
1s1h7qXmZxmowl9P1VNe2Q: folds
ve1LEJosAmuFjNNCQuPnPg: folds
voSAIKXtXUUbJnds83sYfQ: folds
vM2kcH3Ff9H6Drv0NwoocA: folds
efhcaDPhNqQ/H48kMHLa8w: raises $10 to $20
2PHCSXghjbGk2qR6jDFe2g: folds
l9mDFuns/ycIDiFx40BMVw: raises $60 to $80
efhcaDPhNqQ/H48kMHLa8w: folds
l9mDFuns/ycIDiFx40BMVw collected $45 from pot
*** SUMMARY ***
Total pot $45 | Rake $0
Seat 1: ve1LEJosAmuFjNNCQuPnPg folded before Flop (didn't bet)
Seat 2: voSAIKXtXUUbJnds83sYfQ folded before Flop (didn't bet)
Seat 3: vM2kcH3Ff9H6Drv0NwoocA folded before Flop (didn't bet)
Seat 4: efhcaDPhNqQ/H48kMHLa8w (button) folded before Flop
Seat 5: 2PHCSXghjbGk2qR6jDFe2g (small blind) folded before Flop
Seat 6: l9mDFuns/ycIDiFx40BMVw (big blind) collected ($45)
Seat 7: ettgJAblGnistIlqNz4Jww folded before Flop (didn't bet)
Seat 9: 1s1h7qXmZxmowl9P1VNe2Q folded before Flop (didn't bet)



PokerStars Game #59962558698:  Hold'em No Limit ($5/$10) - 2009/07/01 11:36:13 ET
Table 'mAacPTyMuJ4IQhEFOonFPg' 2-max Seat #2 is the button
Seat 1: XFruyoQqeueL4N+qXEkusw ($1172.50 in chips)
Seat 2: ezwKQeNDkLTr+c7tP2UjNw ($616 in chips)
ezwKQeNDkLTr+c7tP2UjNw: posts small blind $5
XFruyoQqeueL4N+qXEkusw: posts big blind $10
*** HOLE CARDS ***
ezwKQeNDkLTr+c7tP2UjNw: raises $20 to $30
XFruyoQqeueL4N+qXEkusw: calls $20
*** FLOP *** [6c As 2s]
XFruyoQqeueL4N+qXEkusw: bets $40
ezwKQeNDkLTr+c7tP2UjNw: calls $40
*** TURN *** [6c As 2s] [4s]
XFruyoQqeueL4N+qXEkusw: bets $100
ezwKQeNDkLTr+c7tP2UjNw: folds
XFruyoQqeueL4N+qXEkusw collected $139.50 from pot
XFruyoQqeueL4N+qXEkusw: doesn't show hand
*** SUMMARY ***
Total pot $140 | Rake $0.50
Board [6c As 2s 4s]
Seat 1: XFruyoQqeueL4N+qXEkusw (big blind) collected ($139.50)
Seat 2: ezwKQeNDkLTr+c7tP2UjNw (button) (small blind) folded on the Turn



PokerStars Game #59962575610:  Hold'em No Limit ($5/$10) - 2009/07/01 11:36:33 ET
Table 'dwLGEw3aoH/cOAI7JsLdmw' 6-max Seat #2 is the button
Seat 1: is0C+o+4W8624tMaRmJg7A ($1000 in chips)
Seat 2: 1ScqYmNf7/uWx1XSBgPTBw ($150 in chips)
Seat 3: voSAIKXtXUUbJnds83sYfQ ($1309 in chips)
Seat 4: efhcaDPhNqQ/H48kMHLa8w ($1000 in chips)
Seat 5: jkH6qYMpn8JA/IyBOhQPMw ($2173 in chips)
Seat 6: 3mTlg4g0FJN2bo939h/0Wg ($487 in chips)
voSAIKXtXUUbJnds83sYfQ: posts small blind $5
efhcaDPhNqQ/H48kMHLa8w: posts big blind $10
*** HOLE CARDS ***
jkH6qYMpn8JA/IyBOhQPMw: folds
3mTlg4g0FJN2bo939h/0Wg: folds
is0C+o+4W8624tMaRmJg7A: folds
1ScqYmNf7/uWx1XSBgPTBw: folds
voSAIKXtXUUbJnds83sYfQ: raises $20 to $30
efhcaDPhNqQ/H48kMHLa8w: calls $20
*** FLOP *** [7h As Jh]
voSAIKXtXUUbJnds83sYfQ: bets $50
efhcaDPhNqQ/H48kMHLa8w: folds
voSAIKXtXUUbJnds83sYfQ collected $57 from pot
*** SUMMARY ***
Total pot $60 | Rake $3
Board [7h As Jh]
Seat 1: is0C+o+4W8624tMaRmJg7A folded before Flop (didn't bet)
Seat 2: 1ScqYmNf7/uWx1XSBgPTBw (button) folded before Flop (didn't bet)
Seat 3: voSAIKXtXUUbJnds83sYfQ (small blind) collected ($57)
Seat 4: efhcaDPhNqQ/H48kMHLa8w (big blind) folded on the Flop
Seat 5: jkH6qYMpn8JA/IyBOhQPMw folded before Flop (didn't bet)
Seat 6: 3mTlg4g0FJN2bo939h/0Wg folded before Flop (didn't bet)



PokerStars Game #59962575598:  Hold'em No Limit ($5/$10) - 2009/07/01 11:36:33 ET
Table '2a86NK3xhs21kwGZmbj0QA' 6-max Seat #4 is the button
Seat 1: is0C+o+4W8624tMaRmJg7A ($1000 in chips)
Seat 2: Xl+I49lxCJwPGRuegiaHoA ($3548 in chips)
Seat 3: voSAIKXtXUUbJnds83sYfQ ($1052 in chips)
Seat 4: 1ScqYmNf7/uWx1XSBgPTBw ($225.25 in chips)
Seat 5: jkH6qYMpn8JA/IyBOhQPMw ($1634.25 in chips)
Seat 6: 0OfLwED3kKs3FwY+JlHC0g ($1277 in chips)
jkH6qYMpn8JA/IyBOhQPMw: posts small blind $5
0OfLwED3kKs3FwY+JlHC0g: posts big blind $10
*** HOLE CARDS ***
is0C+o+4W8624tMaRmJg7A: folds
Xl+I49lxCJwPGRuegiaHoA: folds
voSAIKXtXUUbJnds83sYfQ: folds
1ScqYmNf7/uWx1XSBgPTBw: raises $10 to $20
jkH6qYMpn8JA/IyBOhQPMw: raises $60 to $80
0OfLwED3kKs3FwY+JlHC0g: raises $120 to $200
1ScqYmNf7/uWx1XSBgPTBw: folds
jkH6qYMpn8JA/IyBOhQPMw: raises $1434.25 to $1634.25 and is all-in
0OfLwED3kKs3FwY+JlHC0g: calls $1077 and is all-in
*** FLOP *** [Js Tc 3h]
*** TURN *** [Js Tc 3h] [Ks]
*** RIVER *** [Js Tc 3h Ks] [3d]
*** SHOW DOWN ***
jkH6qYMpn8JA/IyBOhQPMw: shows [Kc As] (two pair, Kings and Threes)
0OfLwED3kKs3FwY+JlHC0g: mucks hand
jkH6qYMpn8JA/IyBOhQPMw collected $2571 from pot
*** SUMMARY ***
Total pot $2574 | Rake $3
Board [Js Tc 3h Ks 3d]
Seat 1: is0C+o+4W8624tMaRmJg7A folded before Flop (didn't bet)
Seat 2: Xl+I49lxCJwPGRuegiaHoA folded before Flop (didn't bet)
Seat 3: voSAIKXtXUUbJnds83sYfQ folded before Flop (didn't bet)
Seat 4: 1ScqYmNf7/uWx1XSBgPTBw (button) folded before Flop
Seat 5: jkH6qYMpn8JA/IyBOhQPMw (small blind) showed [Kc As] and won ($2571) with two pair, Kings and Threes
Seat 6: 0OfLwED3kKs3FwY+JlHC0g (big blind) mucked



PokerStars Game #59962591652:  Hold'em No Limit ($5/$10) - 2009/07/01 11:36:50 ET
Table 'mAacPTyMuJ4IQhEFOonFPg' 2-max Seat #1 is the button
Seat 1: XFruyoQqeueL4N+qXEkusw ($1242 in chips)
Seat 2: ezwKQeNDkLTr+c7tP2UjNw ($546 in chips)
XFruyoQqeueL4N+qXEkusw: posts small blind $5
ezwKQeNDkLTr+c7tP2UjNw: posts big blind $10
*** HOLE CARDS ***
XFruyoQqeueL4N+qXEkusw: raises $20 to $30
ezwKQeNDkLTr+c7tP2UjNw: calls $20
*** FLOP *** [5s 8h Tc]
ezwKQeNDkLTr+c7tP2UjNw: checks
XFruyoQqeueL4N+qXEkusw: checks
*** TURN *** [5s 8h Tc] [7s]
ezwKQeNDkLTr+c7tP2UjNw: checks
XFruyoQqeueL4N+qXEkusw: checks
*** RIVER *** [5s 8h Tc 7s] [Ts]
ezwKQeNDkLTr+c7tP2UjNw: bets $10
XFruyoQqeueL4N+qXEkusw: calls $10
*** SHOW DOWN ***
ezwKQeNDkLTr+c7tP2UjNw: shows [Jd 7d] (two pair, Tens and Sevens)
XFruyoQqeueL4N+qXEkusw: mucks hand
ezwKQeNDkLTr+c7tP2UjNw collected $79.50 from pot
*** SUMMARY ***
Total pot $80 | Rake $0.50
Board [5s 8h Tc 7s Ts]
Seat 1: XFruyoQqeueL4N+qXEkusw (button) (small blind) mucked
Seat 2: ezwKQeNDkLTr+c7tP2UjNw (big blind) showed [Jd 7d] and won ($79.50) with two pair, Tens and Sevens



PokerStars Game #59962600578:  Hold'em No Limit ($5/$10) - 2009/07/01 11:37:00 ET
Table 'AI1fZ7Tsbf9DI8mC4EWoQQ' 9-max Seat #5 is the button
Seat 1: ve1LEJosAmuFjNNCQuPnPg ($1057.50 in chips)
Seat 2: voSAIKXtXUUbJnds83sYfQ ($1000 in chips)
Seat 3: vM2kcH3Ff9H6Drv0NwoocA ($266.75 in chips)
Seat 4: efhcaDPhNqQ/H48kMHLa8w ($1000 in chips)
Seat 5: 2PHCSXghjbGk2qR6jDFe2g ($1097 in chips)
Seat 6: l9mDFuns/ycIDiFx40BMVw ($825 in chips)
Seat 7: ettgJAblGnistIlqNz4Jww ($1000 in chips)
Seat 9: 1s1h7qXmZxmowl9P1VNe2Q ($180 in chips)
l9mDFuns/ycIDiFx40BMVw: posts small blind $5
ettgJAblGnistIlqNz4Jww: posts big blind $10
UgBUE0pOJDwUdQ53XJt8MQ: sits out
*** HOLE CARDS ***
1s1h7qXmZxmowl9P1VNe2Q: folds
ve1LEJosAmuFjNNCQuPnPg: folds
voSAIKXtXUUbJnds83sYfQ: folds
vM2kcH3Ff9H6Drv0NwoocA: folds
efhcaDPhNqQ/H48kMHLa8w: folds
2PHCSXghjbGk2qR6jDFe2g: folds
l9mDFuns/ycIDiFx40BMVw: calls $5
ettgJAblGnistIlqNz4Jww: raises $30 to $40
l9mDFuns/ycIDiFx40BMVw: folds
ettgJAblGnistIlqNz4Jww collected $20 from pot
ettgJAblGnistIlqNz4Jww: doesn't show hand
*** SUMMARY ***
Total pot $20 | Rake $0
Seat 1: ve1LEJosAmuFjNNCQuPnPg folded before Flop (didn't bet)
Seat 2: voSAIKXtXUUbJnds83sYfQ folded before Flop (didn't bet)
Seat 3: vM2kcH3Ff9H6Drv0NwoocA folded before Flop (didn't bet)
Seat 4: efhcaDPhNqQ/H48kMHLa8w folded before Flop (didn't bet)
Seat 5: 2PHCSXghjbGk2qR6jDFe2g (button) folded before Flop (didn't bet)
Seat 6: l9mDFuns/ycIDiFx40BMVw (small blind) folded before Flop
Seat 7: ettgJAblGnistIlqNz4Jww (big blind) collected ($20)
Seat 9: 1s1h7qXmZxmowl9P1VNe2Q folded before Flop (didn't bet)



PokerStars Game #59962610350:  Hold'em No Limit ($5/$10) - 2009/07/01 11:37:11 ET
Table 'dwLGEw3aoH/cOAI7JsLdmw' 6-max Seat #3 is the button
Seat 1: is0C+o+4W8624tMaRmJg7A ($1000 in chips)
Seat 2: 1ScqYmNf7/uWx1XSBgPTBw ($150 in chips)
Seat 3: voSAIKXtXUUbJnds83sYfQ ($1336 in chips)
Seat 4: efhcaDPhNqQ/H48kMHLa8w ($1000 in chips)
Seat 5: jkH6qYMpn8JA/IyBOhQPMw ($2173 in chips)
Seat 6: 3mTlg4g0FJN2bo939h/0Wg ($487 in chips)
efhcaDPhNqQ/H48kMHLa8w: posts small blind $5
jkH6qYMpn8JA/IyBOhQPMw: posts big blind $10
*** HOLE CARDS ***
3mTlg4g0FJN2bo939h/0Wg: raises $10 to $20
is0C+o+4W8624tMaRmJg7A: folds
1ScqYmNf7/uWx1XSBgPTBw: folds
voSAIKXtXUUbJnds83sYfQ: folds
efhcaDPhNqQ/H48kMHLa8w: folds
jkH6qYMpn8JA/IyBOhQPMw: calls $10
*** FLOP *** [Qc 3h 5h]
jkH6qYMpn8JA/IyBOhQPMw: checks
3mTlg4g0FJN2bo939h/0Wg: bets $30
jkH6qYMpn8JA/IyBOhQPMw: folds
3mTlg4g0FJN2bo939h/0Wg collected $42.75 from pot
*** SUMMARY ***
Total pot $45 | Rake $2.25
Board [Qc 3h 5h]
Seat 1: is0C+o+4W8624tMaRmJg7A folded before Flop (didn't bet)
Seat 2: 1ScqYmNf7/uWx1XSBgPTBw folded before Flop (didn't bet)
Seat 3: voSAIKXtXUUbJnds83sYfQ (button) folded before Flop (didn't bet)
Seat 4: efhcaDPhNqQ/H48kMHLa8w (small blind) folded before Flop
Seat 5: jkH6qYMpn8JA/IyBOhQPMw (big blind) folded on the Flop
Seat 6: 3mTlg4g0FJN2bo939h/0Wg collected ($42.75)



PokerStars Game #59962611258:  Hold'em No Limit ($5/$10) - 2009/07/01 11:37:12 ET
Table '1Dt9cpcLUVE6HYkx5dUEdQ' 6-max Seat #3 is the button
Seat 1: Xl+I49lxCJwPGRuegiaHoA ($1000 in chips)
Seat 2: zdS2zKkZYSRe8p+GVcXMgg ($1771.10 in chips)
Seat 3: Lne9leXjEzXWbU3BGFWsxQ ($1010 in chips)
Seat 4: voSAIKXtXUUbJnds83sYfQ ($1981 in chips)
Seat 5: jkH6qYMpn8JA/IyBOhQPMw ($1134.50 in chips)
Seat 6: 3mTlg4g0FJN2bo939h/0Wg ($1369.75 in chips)
voSAIKXtXUUbJnds83sYfQ: posts small blind $5
jkH6qYMpn8JA/IyBOhQPMw: posts big blind $10
*** HOLE CARDS ***
3mTlg4g0FJN2bo939h/0Wg: raises $20 to $30
Xl+I49lxCJwPGRuegiaHoA: folds
zdS2zKkZYSRe8p+GVcXMgg: calls $30
Lne9leXjEzXWbU3BGFWsxQ: folds
voSAIKXtXUUbJnds83sYfQ: folds
jkH6qYMpn8JA/IyBOhQPMw: folds
*** FLOP *** [Td 8d 8c]
3mTlg4g0FJN2bo939h/0Wg: bets $30
zdS2zKkZYSRe8p+GVcXMgg: calls $30
*** TURN *** [Td 8d 8c] [7h]
3mTlg4g0FJN2bo939h/0Wg: bets $40
zdS2zKkZYSRe8p+GVcXMgg: calls $40
*** RIVER *** [Td 8d 8c 7h] [4s]
3mTlg4g0FJN2bo939h/0Wg: checks
zdS2zKkZYSRe8p+GVcXMgg: checks
*** SHOW DOWN ***
3mTlg4g0FJN2bo939h/0Wg: shows [9c 9h] (two pair, Nines and Eights)
zdS2zKkZYSRe8p+GVcXMgg: shows [Qs Th] (two pair, Tens and Eights)
zdS2zKkZYSRe8p+GVcXMgg collected $212 from pot
*** SUMMARY ***
Total pot $215 | Rake $3
Board [Td 8d 8c 7h 4s]
Seat 1: Xl+I49lxCJwPGRuegiaHoA folded before Flop (didn't bet)
Seat 2: zdS2zKkZYSRe8p+GVcXMgg showed [Qs Th] and won ($212) with two pair, Tens and Eights
Seat 3: Lne9leXjEzXWbU3BGFWsxQ (button) folded before Flop (didn't bet)
Seat 4: voSAIKXtXUUbJnds83sYfQ (small blind) folded before Flop
Seat 5: jkH6qYMpn8JA/IyBOhQPMw (big blind) folded before Flop
Seat 6: 3mTlg4g0FJN2bo939h/0Wg showed [9c 9h] and lost with two pair, Nines and Eights



PokerStars Game #59962611912:  Hold'em No Limit ($5/$10) - 2009/07/01 11:37:13 ET
Table 'mAacPTyMuJ4IQhEFOonFPg' 2-max Seat #2 is the button
Seat 1: XFruyoQqeueL4N+qXEkusw ($1202 in chips)
Seat 2: ezwKQeNDkLTr+c7tP2UjNw ($585.50 in chips)
ezwKQeNDkLTr+c7tP2UjNw: posts small blind $5
XFruyoQqeueL4N+qXEkusw: posts big blind $10
*** HOLE CARDS ***
ezwKQeNDkLTr+c7tP2UjNw: folds
XFruyoQqeueL4N+qXEkusw collected $10 from pot
XFruyoQqeueL4N+qXEkusw: doesn't show hand
*** SUMMARY ***
Total pot $10 | Rake $0
Seat 1: XFruyoQqeueL4N+qXEkusw (big blind) collected ($10)
Seat 2: ezwKQeNDkLTr+c7tP2UjNw (button) (small blind) folded before Flop



PokerStars Game #59962616442:  Hold'em No Limit ($5/$10) - 2009/07/01 11:37:18 ET
Table 'mAacPTyMuJ4IQhEFOonFPg' 2-max Seat #1 is the button
Seat 1: XFruyoQqeueL4N+qXEkusw ($1207 in chips)
Seat 2: ezwKQeNDkLTr+c7tP2UjNw ($580.50 in chips)
XFruyoQqeueL4N+qXEkusw: posts small blind $5
ezwKQeNDkLTr+c7tP2UjNw: posts big blind $10
*** HOLE CARDS ***
XFruyoQqeueL4N+qXEkusw: raises $20 to $30
ezwKQeNDkLTr+c7tP2UjNw: folds
XFruyoQqeueL4N+qXEkusw collected $20 from pot
XFruyoQqeueL4N+qXEkusw: doesn't show hand
*** SUMMARY ***
Total pot $20 | Rake $0
Seat 1: XFruyoQqeueL4N+qXEkusw (button) (small blind) collected ($20)
Seat 2: ezwKQeNDkLTr+c7tP2UjNw (big blind) folded before Flop



PokerStars Game #59962623808:  Hold'em No Limit ($5/$10) - 2009/07/01 11:37:26 ET
Table 'mAacPTyMuJ4IQhEFOonFPg' 2-max Seat #2 is the button
Seat 1: XFruyoQqeueL4N+qXEkusw ($1217 in chips)
Seat 2: ezwKQeNDkLTr+c7tP2UjNw ($570.50 in chips)
ezwKQeNDkLTr+c7tP2UjNw: posts small blind $5
XFruyoQqeueL4N+qXEkusw: posts big blind $10
*** HOLE CARDS ***
ezwKQeNDkLTr+c7tP2UjNw: folds
XFruyoQqeueL4N+qXEkusw collected $10 from pot
XFruyoQqeueL4N+qXEkusw: doesn't show hand
*** SUMMARY ***
Total pot $10 | Rake $0
Seat 1: XFruyoQqeueL4N+qXEkusw (big blind) collected ($10)
Seat 2: ezwKQeNDkLTr+c7tP2UjNw (button) (small blind) folded before Flop



PokerStars Game #59962628692:  Hold'em No Limit ($5/$10) - 2009/07/01 11:37:32 ET
Table 'mAacPTyMuJ4IQhEFOonFPg' 2-max Seat #1 is the button
Seat 1: XFruyoQqeueL4N+qXEkusw ($1222 in chips)
Seat 2: ezwKQeNDkLTr+c7tP2UjNw ($565.50 in chips)
XFruyoQqeueL4N+qXEkusw: posts small blind $5
ezwKQeNDkLTr+c7tP2UjNw: posts big blind $10
*** HOLE CARDS ***
XFruyoQqeueL4N+qXEkusw: raises $20 to $30
ezwKQeNDkLTr+c7tP2UjNw: folds
XFruyoQqeueL4N+qXEkusw collected $20 from pot
XFruyoQqeueL4N+qXEkusw: doesn't show hand
*** SUMMARY ***
Total pot $20 | Rake $0
Seat 1: XFruyoQqeueL4N+qXEkusw (button) (small blind) collected ($20)
Seat 2: ezwKQeNDkLTr+c7tP2UjNw (big blind) folded before Flop



PokerStars Game #59962631572:  Hold'em No Limit ($5/$10) - 2009/07/01 11:37:35 ET
Table '2a86NK3xhs21kwGZmbj0QA' 6-max Seat #5 is the button
Seat 1: is0C+o+4W8624tMaRmJg7A ($1000 in chips)
Seat 2: Xl+I49lxCJwPGRuegiaHoA ($3548 in chips)
Seat 3: voSAIKXtXUUbJnds83sYfQ ($1052 in chips)
Seat 4: 1ScqYmNf7/uWx1XSBgPTBw ($205.25 in chips)
Seat 5: jkH6qYMpn8JA/IyBOhQPMw ($2928.25 in chips)
Seat 6: 0OfLwED3kKs3FwY+JlHC0g ($1000 in chips)
0OfLwED3kKs3FwY+JlHC0g: posts small blind $5
is0C+o+4W8624tMaRmJg7A: posts big blind $10
*** HOLE CARDS ***
Xl+I49lxCJwPGRuegiaHoA: folds
voSAIKXtXUUbJnds83sYfQ: folds
1ScqYmNf7/uWx1XSBgPTBw: folds
jkH6qYMpn8JA/IyBOhQPMw: raises $20 to $30
0OfLwED3kKs3FwY+JlHC0g: folds
is0C+o+4W8624tMaRmJg7A: folds
jkH6qYMpn8JA/IyBOhQPMw collected $25 from pot
jkH6qYMpn8JA/IyBOhQPMw: doesn't show hand
*** SUMMARY ***
Total pot $25 | Rake $0
Seat 1: is0C+o+4W8624tMaRmJg7A (big blind) folded before Flop
Seat 2: Xl+I49lxCJwPGRuegiaHoA folded before Flop (didn't bet)
Seat 3: voSAIKXtXUUbJnds83sYfQ folded before Flop (didn't bet)
Seat 4: 1ScqYmNf7/uWx1XSBgPTBw folded before Flop (didn't bet)
Seat 5: jkH6qYMpn8JA/IyBOhQPMw (button) collected ($25)
Seat 6: 0OfLwED3kKs3FwY+JlHC0g (small blind) folded before Flop



PokerStars Game #59962642868:  Hold'em No Limit ($5/$10) - 2009/07/01 11:37:48 ET
Table 'mAacPTyMuJ4IQhEFOonFPg' 2-max Seat #2 is the button
Seat 1: XFruyoQqeueL4N+qXEkusw ($1232 in chips)
Seat 2: ezwKQeNDkLTr+c7tP2UjNw ($555.50 in chips)
ezwKQeNDkLTr+c7tP2UjNw: posts small blind $5
XFruyoQqeueL4N+qXEkusw: posts big blind $10
*** HOLE CARDS ***
ezwKQeNDkLTr+c7tP2UjNw: folds
XFruyoQqeueL4N+qXEkusw collected $10 from pot
XFruyoQqeueL4N+qXEkusw: doesn't show hand
*** SUMMARY ***
Total pot $10 | Rake $0
Seat 1: XFruyoQqeueL4N+qXEkusw (big blind) collected ($10)
Seat 2: ezwKQeNDkLTr+c7tP2UjNw (button) (small blind) folded before Flop



PokerStars Game #59962644446:  Hold'em No Limit ($5/$10) - 2009/07/01 11:37:49 ET
Table 'dwLGEw3aoH/cOAI7JsLdmw' 6-max Seat #4 is the button
Seat 1: is0C+o+4W8624tMaRmJg7A ($1000 in chips)
Seat 2: 1ScqYmNf7/uWx1XSBgPTBw ($150 in chips)
Seat 3: voSAIKXtXUUbJnds83sYfQ ($1336 in chips)
Seat 4: efhcaDPhNqQ/H48kMHLa8w ($1000 in chips)
Seat 5: jkH6qYMpn8JA/IyBOhQPMw ($2153 in chips)
Seat 6: 3mTlg4g0FJN2bo939h/0Wg ($509.75 in chips)
jkH6qYMpn8JA/IyBOhQPMw: posts small blind $5
3mTlg4g0FJN2bo939h/0Wg: posts big blind $10
*** HOLE CARDS ***
is0C+o+4W8624tMaRmJg7A: folds
1ScqYmNf7/uWx1XSBgPTBw: folds
voSAIKXtXUUbJnds83sYfQ: raises $20 to $30
efhcaDPhNqQ/H48kMHLa8w: folds
jkH6qYMpn8JA/IyBOhQPMw: raises $70 to $100
3mTlg4g0FJN2bo939h/0Wg: folds
voSAIKXtXUUbJnds83sYfQ: calls $70
*** FLOP *** [6d Qh Jh]
jkH6qYMpn8JA/IyBOhQPMw: bets $142
voSAIKXtXUUbJnds83sYfQ: folds
jkH6qYMpn8JA/IyBOhQPMw collected $207 from pot
*** SUMMARY ***
Total pot $210 | Rake $3
Board [6d Qh Jh]
Seat 1: is0C+o+4W8624tMaRmJg7A folded before Flop (didn't bet)
Seat 2: 1ScqYmNf7/uWx1XSBgPTBw folded before Flop (didn't bet)
Seat 3: voSAIKXtXUUbJnds83sYfQ folded on the Flop
Seat 4: efhcaDPhNqQ/H48kMHLa8w (button) folded before Flop (didn't bet)
Seat 5: jkH6qYMpn8JA/IyBOhQPMw (small blind) collected ($207)
Seat 6: 3mTlg4g0FJN2bo939h/0Wg (big blind) folded before Flop



PokerStars Game #59962647986:  Hold'em No Limit ($5/$10) - 2009/07/01 11:37:54 ET
Table 'mAacPTyMuJ4IQhEFOonFPg' 2-max Seat #1 is the button
Seat 1: XFruyoQqeueL4N+qXEkusw ($1237 in chips)
Seat 2: ezwKQeNDkLTr+c7tP2UjNw ($550.50 in chips)
XFruyoQqeueL4N+qXEkusw: posts small blind $5
ezwKQeNDkLTr+c7tP2UjNw: posts big blind $10
*** HOLE CARDS ***
XFruyoQqeueL4N+qXEkusw: raises $20 to $30
ezwKQeNDkLTr+c7tP2UjNw: calls $20
*** FLOP *** [Js 3d 5s]
ezwKQeNDkLTr+c7tP2UjNw: checks
XFruyoQqeueL4N+qXEkusw: bets $40
ezwKQeNDkLTr+c7tP2UjNw: raises $60 to $100
XFruyoQqeueL4N+qXEkusw: folds
ezwKQeNDkLTr+c7tP2UjNw collected $139.50 from pot
ezwKQeNDkLTr+c7tP2UjNw: doesn't show hand
*** SUMMARY ***
Total pot $140 | Rake $0.50
Board [Js 3d 5s]
Seat 1: XFruyoQqeueL4N+qXEkusw (button) (small blind) folded on the Flop
Seat 2: ezwKQeNDkLTr+c7tP2UjNw (big blind) collected ($139.50)



PokerStars Game #59962649854:  Hold'em No Limit ($5/$10) - 2009/07/01 11:37:55 ET
Table '2a86NK3xhs21kwGZmbj0QA' 6-max Seat #6 is the button
Seat 1: is0C+o+4W8624tMaRmJg7A ($1000 in chips)
Seat 2: Xl+I49lxCJwPGRuegiaHoA ($3548 in chips)
Seat 3: voSAIKXtXUUbJnds83sYfQ ($1052 in chips)
Seat 4: 1ScqYmNf7/uWx1XSBgPTBw ($205.25 in chips)
Seat 5: jkH6qYMpn8JA/IyBOhQPMw ($2943.25 in chips)
Seat 6: 0OfLwED3kKs3FwY+JlHC0g ($1000 in chips)
is0C+o+4W8624tMaRmJg7A: posts small blind $5
Xl+I49lxCJwPGRuegiaHoA: posts big blind $10
*** HOLE CARDS ***
voSAIKXtXUUbJnds83sYfQ: folds
1ScqYmNf7/uWx1XSBgPTBw: folds
jkH6qYMpn8JA/IyBOhQPMw: raises $20 to $30
0OfLwED3kKs3FwY+JlHC0g: calls $30
is0C+o+4W8624tMaRmJg7A: folds
Xl+I49lxCJwPGRuegiaHoA: calls $20
*** FLOP *** [Td Qd 3c]
Xl+I49lxCJwPGRuegiaHoA: checks
jkH6qYMpn8JA/IyBOhQPMw: checks
0OfLwED3kKs3FwY+JlHC0g: bets $70
Xl+I49lxCJwPGRuegiaHoA: folds
jkH6qYMpn8JA/IyBOhQPMw: folds
0OfLwED3kKs3FwY+JlHC0g collected $92 from pot
0OfLwED3kKs3FwY+JlHC0g: doesn't show hand
*** SUMMARY ***
Total pot $95 | Rake $3
Board [Td Qd 3c]
Seat 1: is0C+o+4W8624tMaRmJg7A (small blind) folded before Flop
Seat 2: Xl+I49lxCJwPGRuegiaHoA (big blind) folded on the Flop
Seat 3: voSAIKXtXUUbJnds83sYfQ folded before Flop (didn't bet)
Seat 4: 1ScqYmNf7/uWx1XSBgPTBw folded before Flop (didn't bet)
Seat 5: jkH6qYMpn8JA/IyBOhQPMw folded on the Flop
Seat 6: 0OfLwED3kKs3FwY+JlHC0g (button) collected ($92)



PokerStars Game #59962652804:  Hold'em No Limit ($5/$10) - 2009/07/01 11:37:59 ET
Table '1Dt9cpcLUVE6HYkx5dUEdQ' 6-max Seat #4 is the button
Seat 1: Xl+I49lxCJwPGRuegiaHoA ($1000 in chips)
Seat 2: zdS2zKkZYSRe8p+GVcXMgg ($1883.10 in chips)
Seat 3: Lne9leXjEzXWbU3BGFWsxQ ($1010 in chips)
Seat 4: voSAIKXtXUUbJnds83sYfQ ($1976 in chips)
Seat 5: jkH6qYMpn8JA/IyBOhQPMw ($1124.50 in chips)
Seat 6: 3mTlg4g0FJN2bo939h/0Wg ($1269.75 in chips)
jkH6qYMpn8JA/IyBOhQPMw: posts small blind $5
3mTlg4g0FJN2bo939h/0Wg: posts big blind $10
*** HOLE CARDS ***
Xl+I49lxCJwPGRuegiaHoA: folds
zdS2zKkZYSRe8p+GVcXMgg: folds
Lne9leXjEzXWbU3BGFWsxQ: folds
voSAIKXtXUUbJnds83sYfQ: raises $20 to $30
jkH6qYMpn8JA/IyBOhQPMw: folds
3mTlg4g0FJN2bo939h/0Wg: calls $20
*** FLOP *** [4c Td 7h]
3mTlg4g0FJN2bo939h/0Wg: bets $30
voSAIKXtXUUbJnds83sYfQ: folds
3mTlg4g0FJN2bo939h/0Wg collected $62 from pot
*** SUMMARY ***
Total pot $65 | Rake $3
Board [4c Td 7h]
Seat 1: Xl+I49lxCJwPGRuegiaHoA folded before Flop (didn't bet)
Seat 2: zdS2zKkZYSRe8p+GVcXMgg folded before Flop (didn't bet)
Seat 3: Lne9leXjEzXWbU3BGFWsxQ folded before Flop (didn't bet)
Seat 4: voSAIKXtXUUbJnds83sYfQ (button) folded on the Flop
Seat 5: jkH6qYMpn8JA/IyBOhQPMw (small blind) folded before Flop
Seat 6: 3mTlg4g0FJN2bo939h/0Wg (big blind) collected ($62)



PokerStars Game #59962660310:  Hold'em No Limit ($5/$10) - 2009/07/01 11:38:07 ET
Table 'AI1fZ7Tsbf9DI8mC4EWoQQ' 9-max Seat #6 is the button
Seat 1: ve1LEJosAmuFjNNCQuPnPg ($1057.50 in chips)
Seat 2: voSAIKXtXUUbJnds83sYfQ ($1000 in chips)
Seat 3: vM2kcH3Ff9H6Drv0NwoocA ($266.75 in chips)
Seat 4: efhcaDPhNqQ/H48kMHLa8w ($1000 in chips)
Seat 5: 2PHCSXghjbGk2qR6jDFe2g ($1097 in chips)
Seat 6: l9mDFuns/ycIDiFx40BMVw ($815 in chips)
Seat 7: ettgJAblGnistIlqNz4Jww ($1010 in chips)
Seat 8: UgBUE0pOJDwUdQ53XJt8MQ ($200 in chips)
Seat 9: 1s1h7qXmZxmowl9P1VNe2Q ($180 in chips)
ettgJAblGnistIlqNz4Jww: posts small blind $5
UgBUE0pOJDwUdQ53XJt8MQ: posts big blind $10
*** HOLE CARDS ***
1s1h7qXmZxmowl9P1VNe2Q: calls $10
ve1LEJosAmuFjNNCQuPnPg: calls $10
voSAIKXtXUUbJnds83sYfQ: folds
vM2kcH3Ff9H6Drv0NwoocA: folds
efhcaDPhNqQ/H48kMHLa8w: folds
2PHCSXghjbGk2qR6jDFe2g: calls $10
l9mDFuns/ycIDiFx40BMVw: folds
ettgJAblGnistIlqNz4Jww: calls $5
UgBUE0pOJDwUdQ53XJt8MQ: checks
*** FLOP *** [2d Jc 7c]
ettgJAblGnistIlqNz4Jww: checks
UgBUE0pOJDwUdQ53XJt8MQ: checks
1s1h7qXmZxmowl9P1VNe2Q: checks
ve1LEJosAmuFjNNCQuPnPg: checks
2PHCSXghjbGk2qR6jDFe2g: bets $20
ettgJAblGnistIlqNz4Jww: folds
UgBUE0pOJDwUdQ53XJt8MQ: folds
1s1h7qXmZxmowl9P1VNe2Q: raises $150 to $170 and is all-in
ve1LEJosAmuFjNNCQuPnPg: folds
2PHCSXghjbGk2qR6jDFe2g: folds
1s1h7qXmZxmowl9P1VNe2Q collected $87 from pot
*** SUMMARY ***
Total pot $90 | Rake $3
Board [2d Jc 7c]
Seat 1: ve1LEJosAmuFjNNCQuPnPg folded on the Flop
Seat 2: voSAIKXtXUUbJnds83sYfQ folded before Flop (didn't bet)
Seat 3: vM2kcH3Ff9H6Drv0NwoocA folded before Flop (didn't bet)
Seat 4: efhcaDPhNqQ/H48kMHLa8w folded before Flop (didn't bet)
Seat 5: 2PHCSXghjbGk2qR6jDFe2g folded on the Flop
Seat 6: l9mDFuns/ycIDiFx40BMVw (button) folded before Flop (didn't bet)
Seat 7: ettgJAblGnistIlqNz4Jww (small blind) folded on the Flop
Seat 8: UgBUE0pOJDwUdQ53XJt8MQ (big blind) folded on the Flop
Seat 9: 1s1h7qXmZxmowl9P1VNe2Q collected ($87)



PokerStars Game #59962664882:  Hold'em No Limit ($5/$10) - 2009/07/01 11:38:12 ET
Table 'mAacPTyMuJ4IQhEFOonFPg' 2-max Seat #2 is the button
Seat 1: XFruyoQqeueL4N+qXEkusw ($1167 in chips)
Seat 2: ezwKQeNDkLTr+c7tP2UjNw ($620 in chips)
ezwKQeNDkLTr+c7tP2UjNw: posts small blind $5
XFruyoQqeueL4N+qXEkusw: posts big blind $10
*** HOLE CARDS ***
ezwKQeNDkLTr+c7tP2UjNw: raises $20 to $30
XFruyoQqeueL4N+qXEkusw: folds
ezwKQeNDkLTr+c7tP2UjNw collected $20 from pot
ezwKQeNDkLTr+c7tP2UjNw: doesn't show hand
*** SUMMARY ***
Total pot $20 | Rake $0
Seat 1: XFruyoQqeueL4N+qXEkusw (big blind) folded before Flop
Seat 2: ezwKQeNDkLTr+c7tP2UjNw (button) (small blind) collected ($20)



PokerStars Game #59962671488:  Hold'em No Limit ($5/$10) - 2009/07/01 11:38:20 ET
Table 'mAacPTyMuJ4IQhEFOonFPg' 2-max Seat #1 is the button
Seat 1: XFruyoQqeueL4N+qXEkusw ($1157 in chips)
Seat 2: ezwKQeNDkLTr+c7tP2UjNw ($630 in chips)
XFruyoQqeueL4N+qXEkusw: posts small blind $5
ezwKQeNDkLTr+c7tP2UjNw: posts big blind $10
*** HOLE CARDS ***
XFruyoQqeueL4N+qXEkusw: raises $20 to $30
ezwKQeNDkLTr+c7tP2UjNw: raises $70 to $100
XFruyoQqeueL4N+qXEkusw: folds
ezwKQeNDkLTr+c7tP2UjNw collected $60 from pot
ezwKQeNDkLTr+c7tP2UjNw: doesn't show hand
*** SUMMARY ***
Total pot $60 | Rake $0
Seat 1: XFruyoQqeueL4N+qXEkusw (button) (small blind) folded before Flop
Seat 2: ezwKQeNDkLTr+c7tP2UjNw (big blind) collected ($60)



PokerStars Game #59962684504:  Hold'em No Limit ($5/$10) - 2009/07/01 11:38:34 ET
Table 'mAacPTyMuJ4IQhEFOonFPg' 2-max Seat #2 is the button
Seat 1: XFruyoQqeueL4N+qXEkusw ($1127 in chips)
Seat 2: ezwKQeNDkLTr+c7tP2UjNw ($660 in chips)
ezwKQeNDkLTr+c7tP2UjNw: posts small blind $5
XFruyoQqeueL4N+qXEkusw: posts big blind $10
*** HOLE CARDS ***
ezwKQeNDkLTr+c7tP2UjNw: raises $20 to $30
XFruyoQqeueL4N+qXEkusw: folds
ezwKQeNDkLTr+c7tP2UjNw collected $20 from pot
ezwKQeNDkLTr+c7tP2UjNw: doesn't show hand
*** SUMMARY ***
Total pot $20 | Rake $0
Seat 1: XFruyoQqeueL4N+qXEkusw (big blind) folded before Flop
Seat 2: ezwKQeNDkLTr+c7tP2UjNw (button) (small blind) collected ($20)



PokerStars Game #59962692676:  Hold'em No Limit ($5/$10) - 2009/07/01 11:38:43 ET
Table 'dwLGEw3aoH/cOAI7JsLdmw' 6-max Seat #5 is the button
Seat 1: is0C+o+4W8624tMaRmJg7A ($1000 in chips)
Seat 2: 1ScqYmNf7/uWx1XSBgPTBw ($150 in chips)
Seat 3: voSAIKXtXUUbJnds83sYfQ ($1236 in chips)
Seat 4: efhcaDPhNqQ/H48kMHLa8w ($1000 in chips)
Seat 5: jkH6qYMpn8JA/IyBOhQPMw ($2260 in chips)
Seat 6: 3mTlg4g0FJN2bo939h/0Wg ($499.75 in chips)
3mTlg4g0FJN2bo939h/0Wg: posts small blind $5
is0C+o+4W8624tMaRmJg7A: posts big blind $10
*** HOLE CARDS ***
1ScqYmNf7/uWx1XSBgPTBw: folds
voSAIKXtXUUbJnds83sYfQ: folds
efhcaDPhNqQ/H48kMHLa8w: folds
jkH6qYMpn8JA/IyBOhQPMw: raises $20 to $30
3mTlg4g0FJN2bo939h/0Wg: folds
is0C+o+4W8624tMaRmJg7A: folds
jkH6qYMpn8JA/IyBOhQPMw collected $25 from pot
*** SUMMARY ***
Total pot $25 | Rake $0
Seat 1: is0C+o+4W8624tMaRmJg7A (big blind) folded before Flop
Seat 2: 1ScqYmNf7/uWx1XSBgPTBw folded before Flop (didn't bet)
Seat 3: voSAIKXtXUUbJnds83sYfQ folded before Flop (didn't bet)
Seat 4: efhcaDPhNqQ/H48kMHLa8w folded before Flop (didn't bet)
Seat 5: jkH6qYMpn8JA/IyBOhQPMw (button) collected ($25)
Seat 6: 3mTlg4g0FJN2bo939h/0Wg (small blind) folded before Flop



PokerStars Game #59962694462:  Hold'em No Limit ($5/$10) - 2009/07/01 11:38:45 ET
Table 'mAacPTyMuJ4IQhEFOonFPg' 2-max Seat #1 is the button
Seat 1: XFruyoQqeueL4N+qXEkusw ($1117 in chips)
Seat 2: ezwKQeNDkLTr+c7tP2UjNw ($670 in chips)
XFruyoQqeueL4N+qXEkusw: posts small blind $5
ezwKQeNDkLTr+c7tP2UjNw: posts big blind $10
*** HOLE CARDS ***
XFruyoQqeueL4N+qXEkusw: raises $20 to $30
ezwKQeNDkLTr+c7tP2UjNw: folds
XFruyoQqeueL4N+qXEkusw collected $20 from pot
XFruyoQqeueL4N+qXEkusw: doesn't show hand
*** SUMMARY ***
Total pot $20 | Rake $0
Seat 1: XFruyoQqeueL4N+qXEkusw (button) (small blind) collected ($20)
Seat 2: ezwKQeNDkLTr+c7tP2UjNw (big blind) folded before Flop



PokerStars Game #59962699620:  Hold'em No Limit ($5/$10) - 2009/07/01 11:38:51 ET
Table '1Dt9cpcLUVE6HYkx5dUEdQ' 6-max Seat #5 is the button
Seat 1: Xl+I49lxCJwPGRuegiaHoA ($1000 in chips)
Seat 2: zdS2zKkZYSRe8p+GVcXMgg ($1883.10 in chips)
Seat 3: Lne9leXjEzXWbU3BGFWsxQ ($1010 in chips)
Seat 4: voSAIKXtXUUbJnds83sYfQ ($1946 in chips)
Seat 5: jkH6qYMpn8JA/IyBOhQPMw ($1119.50 in chips)
Seat 6: 3mTlg4g0FJN2bo939h/0Wg ($1301.75 in chips)
3mTlg4g0FJN2bo939h/0Wg: posts small blind $5
Xl+I49lxCJwPGRuegiaHoA: posts big blind $10
*** HOLE CARDS ***
zdS2zKkZYSRe8p+GVcXMgg: calls $10
Lne9leXjEzXWbU3BGFWsxQ: folds
voSAIKXtXUUbJnds83sYfQ: folds
jkH6qYMpn8JA/IyBOhQPMw: folds
3mTlg4g0FJN2bo939h/0Wg: calls $5
Xl+I49lxCJwPGRuegiaHoA: checks
*** FLOP *** [4d 6d 2h]
3mTlg4g0FJN2bo939h/0Wg: bets $20
Xl+I49lxCJwPGRuegiaHoA: folds
zdS2zKkZYSRe8p+GVcXMgg: raises $50 to $70
3mTlg4g0FJN2bo939h/0Wg: calls $50
*** TURN *** [4d 6d 2h] [Jd]
3mTlg4g0FJN2bo939h/0Wg: checks
zdS2zKkZYSRe8p+GVcXMgg: bets $60
3mTlg4g0FJN2bo939h/0Wg: folds
zdS2zKkZYSRe8p+GVcXMgg collected $167 from pot
*** SUMMARY ***
Total pot $170 | Rake $3
Board [4d 6d 2h Jd]
Seat 1: Xl+I49lxCJwPGRuegiaHoA (big blind) folded on the Flop
Seat 2: zdS2zKkZYSRe8p+GVcXMgg collected ($167)
Seat 3: Lne9leXjEzXWbU3BGFWsxQ folded before Flop (didn't bet)
Seat 4: voSAIKXtXUUbJnds83sYfQ folded before Flop (didn't bet)
Seat 5: jkH6qYMpn8JA/IyBOhQPMw (button) folded before Flop (didn't bet)
Seat 6: 3mTlg4g0FJN2bo939h/0Wg (small blind) folded on the Turn



PokerStars Game #59962700358:  Hold'em No Limit ($5/$10) - 2009/07/01 11:38:52 ET
Table 'mAacPTyMuJ4IQhEFOonFPg' 2-max Seat #2 is the button
Seat 1: XFruyoQqeueL4N+qXEkusw ($1127 in chips)
Seat 2: ezwKQeNDkLTr+c7tP2UjNw ($660 in chips)
ezwKQeNDkLTr+c7tP2UjNw: posts small blind $5
XFruyoQqeueL4N+qXEkusw: posts big blind $10
*** HOLE CARDS ***
ezwKQeNDkLTr+c7tP2UjNw: folds
XFruyoQqeueL4N+qXEkusw collected $10 from pot
XFruyoQqeueL4N+qXEkusw: doesn't show hand
*** SUMMARY ***
Total pot $10 | Rake $0
Seat 1: XFruyoQqeueL4N+qXEkusw (big blind) collected ($10)
Seat 2: ezwKQeNDkLTr+c7tP2UjNw (button) (small blind) folded before Flop



PokerStars Game #59962705196:  Hold'em No Limit ($5/$10) - 2009/07/01 11:38:57 ET
Table 'mAacPTyMuJ4IQhEFOonFPg' 2-max Seat #1 is the button
Seat 1: XFruyoQqeueL4N+qXEkusw ($1132 in chips)
Seat 2: ezwKQeNDkLTr+c7tP2UjNw ($655 in chips)
XFruyoQqeueL4N+qXEkusw: posts small blind $5
ezwKQeNDkLTr+c7tP2UjNw: posts big blind $10
*** HOLE CARDS ***
XFruyoQqeueL4N+qXEkusw: folds
ezwKQeNDkLTr+c7tP2UjNw collected $10 from pot
ezwKQeNDkLTr+c7tP2UjNw: doesn't show hand
*** SUMMARY ***
Total pot $10 | Rake $0
Seat 1: XFruyoQqeueL4N+qXEkusw (button) (small blind) folded before Flop
Seat 2: ezwKQeNDkLTr+c7tP2UjNw (big blind) collected ($10)



PokerStars Game #59962715012:  Hold'em No Limit ($5/$10) - 2009/07/01 11:39:08 ET
Table 'mAacPTyMuJ4IQhEFOonFPg' 2-max Seat #2 is the button
Seat 1: XFruyoQqeueL4N+qXEkusw ($1127 in chips)
Seat 2: ezwKQeNDkLTr+c7tP2UjNw ($660 in chips)
ezwKQeNDkLTr+c7tP2UjNw: posts small blind $5
XFruyoQqeueL4N+qXEkusw: posts big blind $10
*** HOLE CARDS ***
ezwKQeNDkLTr+c7tP2UjNw: raises $20 to $30
XFruyoQqeueL4N+qXEkusw: calls $20
*** FLOP *** [5d 2d 4d]
XFruyoQqeueL4N+qXEkusw: bets $50
ezwKQeNDkLTr+c7tP2UjNw: folds
XFruyoQqeueL4N+qXEkusw collected $59.50 from pot
XFruyoQqeueL4N+qXEkusw: doesn't show hand
*** SUMMARY ***
Total pot $60 | Rake $0.50
Board [5d 2d 4d]
Seat 1: XFruyoQqeueL4N+qXEkusw (big blind) collected ($59.50)
Seat 2: ezwKQeNDkLTr+c7tP2UjNw (button) (small blind) folded on the Flop



PokerStars Game #59962716350:  Hold'em No Limit ($5/$10) - 2009/07/01 11:39:10 ET
Table '2a86NK3xhs21kwGZmbj0QA' 6-max Seat #1 is the button
Seat 1: is0C+o+4W8624tMaRmJg7A ($1000 in chips)
Seat 2: Xl+I49lxCJwPGRuegiaHoA ($3518 in chips)
Seat 3: voSAIKXtXUUbJnds83sYfQ ($1052 in chips)
Seat 4: 1ScqYmNf7/uWx1XSBgPTBw ($205.25 in chips)
Seat 5: jkH6qYMpn8JA/IyBOhQPMw ($2913.25 in chips)
Seat 6: 0OfLwED3kKs3FwY+JlHC0g ($1062 in chips)
Xl+I49lxCJwPGRuegiaHoA: posts small blind $5
voSAIKXtXUUbJnds83sYfQ: posts big blind $10
*** HOLE CARDS ***
1ScqYmNf7/uWx1XSBgPTBw: folds
jkH6qYMpn8JA/IyBOhQPMw: folds
0OfLwED3kKs3FwY+JlHC0g: folds
is0C+o+4W8624tMaRmJg7A: folds
Xl+I49lxCJwPGRuegiaHoA: folds
voSAIKXtXUUbJnds83sYfQ collected $10 from pot
voSAIKXtXUUbJnds83sYfQ: doesn't show hand
*** SUMMARY ***
Total pot $10 | Rake $0
Seat 1: is0C+o+4W8624tMaRmJg7A (button) folded before Flop (didn't bet)
Seat 2: Xl+I49lxCJwPGRuegiaHoA (small blind) folded before Flop
Seat 3: voSAIKXtXUUbJnds83sYfQ (big blind) collected ($10)
Seat 4: 1ScqYmNf7/uWx1XSBgPTBw folded before Flop (didn't bet)
Seat 5: jkH6qYMpn8JA/IyBOhQPMw folded before Flop (didn't bet)
Seat 6: 0OfLwED3kKs3FwY+JlHC0g folded before Flop (didn't bet)



PokerStars Game #59962721186:  Hold'em No Limit ($5/$10) - 2009/07/01 11:39:15 ET
Table 'dwLGEw3aoH/cOAI7JsLdmw' 6-max Seat #6 is the button
Seat 1: is0C+o+4W8624tMaRmJg7A ($1000 in chips)
Seat 2: 1ScqYmNf7/uWx1XSBgPTBw ($150 in chips)
Seat 3: voSAIKXtXUUbJnds83sYfQ ($1236 in chips)
Seat 4: efhcaDPhNqQ/H48kMHLa8w ($1000 in chips)
Seat 5: jkH6qYMpn8JA/IyBOhQPMw ($2275 in chips)
Seat 6: 3mTlg4g0FJN2bo939h/0Wg ($494.75 in chips)
is0C+o+4W8624tMaRmJg7A: posts small blind $5
1ScqYmNf7/uWx1XSBgPTBw: posts big blind $10
*** HOLE CARDS ***
voSAIKXtXUUbJnds83sYfQ: folds
efhcaDPhNqQ/H48kMHLa8w: raises $20 to $30
jkH6qYMpn8JA/IyBOhQPMw: folds
3mTlg4g0FJN2bo939h/0Wg: folds
is0C+o+4W8624tMaRmJg7A: folds
1ScqYmNf7/uWx1XSBgPTBw: folds
efhcaDPhNqQ/H48kMHLa8w collected $25 from pot
*** SUMMARY ***
Total pot $25 | Rake $0
Seat 1: is0C+o+4W8624tMaRmJg7A (small blind) folded before Flop
Seat 2: 1ScqYmNf7/uWx1XSBgPTBw (big blind) folded before Flop
Seat 3: voSAIKXtXUUbJnds83sYfQ folded before Flop (didn't bet)
Seat 4: efhcaDPhNqQ/H48kMHLa8w collected ($25)
Seat 5: jkH6qYMpn8JA/IyBOhQPMw folded before Flop (didn't bet)
Seat 6: 3mTlg4g0FJN2bo939h/0Wg (button) folded before Flop (didn't bet)



PokerStars Game #59962726202:  Hold'em No Limit ($5/$10) - 2009/07/01 11:39:21 ET
Table 'mAacPTyMuJ4IQhEFOonFPg' 2-max Seat #1 is the button
Seat 1: XFruyoQqeueL4N+qXEkusw ($1156.50 in chips)
Seat 2: ezwKQeNDkLTr+c7tP2UjNw ($630 in chips)
XFruyoQqeueL4N+qXEkusw: posts small blind $5
ezwKQeNDkLTr+c7tP2UjNw: posts big blind $10
*** HOLE CARDS ***
XFruyoQqeueL4N+qXEkusw: folds
ezwKQeNDkLTr+c7tP2UjNw collected $10 from pot
ezwKQeNDkLTr+c7tP2UjNw: doesn't show hand
*** SUMMARY ***
Total pot $10 | Rake $0
Seat 1: XFruyoQqeueL4N+qXEkusw (button) (small blind) folded before Flop
Seat 2: ezwKQeNDkLTr+c7tP2UjNw (big blind) collected ($10)



PokerStars Game #59962729454:  Hold'em No Limit ($5/$10) - 2009/07/01 11:39:25 ET
Table '2a86NK3xhs21kwGZmbj0QA' 6-max Seat #2 is the button
Seat 1: is0C+o+4W8624tMaRmJg7A ($1000 in chips)
Seat 2: Xl+I49lxCJwPGRuegiaHoA ($3513 in chips)
Seat 3: voSAIKXtXUUbJnds83sYfQ ($1057 in chips)
Seat 4: 1ScqYmNf7/uWx1XSBgPTBw ($205.25 in chips)
Seat 5: jkH6qYMpn8JA/IyBOhQPMw ($2913.25 in chips)
Seat 6: 0OfLwED3kKs3FwY+JlHC0g ($1062 in chips)
voSAIKXtXUUbJnds83sYfQ: posts small blind $5
1ScqYmNf7/uWx1XSBgPTBw: posts big blind $10
*** HOLE CARDS ***
jkH6qYMpn8JA/IyBOhQPMw: raises $20 to $30
0OfLwED3kKs3FwY+JlHC0g: calls $30
is0C+o+4W8624tMaRmJg7A: folds
jkH6qYMpn8JA/IyBOhQPMw said, "it seems you will make back those 40k in no time"
Xl+I49lxCJwPGRuegiaHoA: folds
voSAIKXtXUUbJnds83sYfQ: folds
1ScqYmNf7/uWx1XSBgPTBw: folds
*** FLOP *** [8c 8s Td]
jkH6qYMpn8JA/IyBOhQPMw: bets $52
0OfLwED3kKs3FwY+JlHC0g: folds
jkH6qYMpn8JA/IyBOhQPMw collected $72 from pot
jkH6qYMpn8JA/IyBOhQPMw: doesn't show hand
*** SUMMARY ***
Total pot $75 | Rake $3
Board [8c 8s Td]
Seat 1: is0C+o+4W8624tMaRmJg7A folded before Flop (didn't bet)
Seat 2: Xl+I49lxCJwPGRuegiaHoA (button) folded before Flop (didn't bet)
Seat 3: voSAIKXtXUUbJnds83sYfQ (small blind) folded before Flop
Seat 4: 1ScqYmNf7/uWx1XSBgPTBw (big blind) folded before Flop
Seat 5: jkH6qYMpn8JA/IyBOhQPMw collected ($72)
Seat 6: 0OfLwED3kKs3FwY+JlHC0g folded on the Flop



PokerStars Game #59962732720:  Hold'em No Limit ($5/$10) - 2009/07/01 11:39:28 ET
Table 'mAacPTyMuJ4IQhEFOonFPg' 2-max Seat #2 is the button
Seat 1: XFruyoQqeueL4N+qXEkusw ($1151.50 in chips)
Seat 2: ezwKQeNDkLTr+c7tP2UjNw ($635 in chips)
ezwKQeNDkLTr+c7tP2UjNw: posts small blind $5
XFruyoQqeueL4N+qXEkusw: posts big blind $10
*** HOLE CARDS ***
ezwKQeNDkLTr+c7tP2UjNw: raises $20 to $30
XFruyoQqeueL4N+qXEkusw: raises $60 to $90
ezwKQeNDkLTr+c7tP2UjNw: raises $545 to $635 and is all-in
XFruyoQqeueL4N+qXEkusw: folds
ezwKQeNDkLTr+c7tP2UjNw collected $180 from pot
ezwKQeNDkLTr+c7tP2UjNw: doesn't show hand
*** SUMMARY ***
Total pot $180 | Rake $0
Seat 1: XFruyoQqeueL4N+qXEkusw (big blind) folded before Flop
Seat 2: ezwKQeNDkLTr+c7tP2UjNw (button) (small blind) collected ($180)



PokerStars Game #59962738730:  Hold'em No Limit ($5/$10) - 2009/07/01 11:39:35 ET
Table 'dwLGEw3aoH/cOAI7JsLdmw' 6-max Seat #1 is the button
Seat 1: is0C+o+4W8624tMaRmJg7A ($1000 in chips)
Seat 2: 1ScqYmNf7/uWx1XSBgPTBw ($140 in chips)
Seat 3: voSAIKXtXUUbJnds83sYfQ ($1236 in chips)
Seat 4: efhcaDPhNqQ/H48kMHLa8w ($1015 in chips)
Seat 5: jkH6qYMpn8JA/IyBOhQPMw ($2275 in chips)
Seat 6: 3mTlg4g0FJN2bo939h/0Wg ($494.75 in chips)
1ScqYmNf7/uWx1XSBgPTBw: posts small blind $5
voSAIKXtXUUbJnds83sYfQ: posts big blind $10
*** HOLE CARDS ***
efhcaDPhNqQ/H48kMHLa8w: folds
jkH6qYMpn8JA/IyBOhQPMw: folds
3mTlg4g0FJN2bo939h/0Wg: raises $20 to $30
is0C+o+4W8624tMaRmJg7A: folds
1ScqYmNf7/uWx1XSBgPTBw: folds
voSAIKXtXUUbJnds83sYfQ: folds
3mTlg4g0FJN2bo939h/0Wg collected $25 from pot
*** SUMMARY ***
Total pot $25 | Rake $0
Seat 1: is0C+o+4W8624tMaRmJg7A (button) folded before Flop (didn't bet)
Seat 2: 1ScqYmNf7/uWx1XSBgPTBw (small blind) folded before Flop
Seat 3: voSAIKXtXUUbJnds83sYfQ (big blind) folded before Flop
Seat 4: efhcaDPhNqQ/H48kMHLa8w folded before Flop (didn't bet)
Seat 5: jkH6qYMpn8JA/IyBOhQPMw folded before Flop (didn't bet)
Seat 6: 3mTlg4g0FJN2bo939h/0Wg collected ($25)



PokerStars Game #59962743306:  Hold'em No Limit ($5/$10) - 2009/07/01 11:39:40 ET
Table 'mAacPTyMuJ4IQhEFOonFPg' 2-max Seat #1 is the button
Seat 1: XFruyoQqeueL4N+qXEkusw ($1061.50 in chips)
Seat 2: ezwKQeNDkLTr+c7tP2UjNw ($725 in chips)
XFruyoQqeueL4N+qXEkusw: posts small blind $5
ezwKQeNDkLTr+c7tP2UjNw: posts big blind $10
*** HOLE CARDS ***
XFruyoQqeueL4N+qXEkusw: raises $20 to $30
ezwKQeNDkLTr+c7tP2UjNw: folds
XFruyoQqeueL4N+qXEkusw collected $20 from pot
XFruyoQqeueL4N+qXEkusw: doesn't show hand
*** SUMMARY ***
Total pot $20 | Rake $0
Seat 1: XFruyoQqeueL4N+qXEkusw (button) (small blind) collected ($20)
Seat 2: ezwKQeNDkLTr+c7tP2UjNw (big blind) folded before Flop



PokerStars Game #59962748520:  Hold'em No Limit ($5/$10) - 2009/07/01 11:39:46 ET
Table 'AI1fZ7Tsbf9DI8mC4EWoQQ' 9-max Seat #7 is the button
Seat 1: ve1LEJosAmuFjNNCQuPnPg ($1047.50 in chips)
Seat 2: voSAIKXtXUUbJnds83sYfQ ($1000 in chips)
Seat 3: vM2kcH3Ff9H6Drv0NwoocA ($266.75 in chips)
Seat 4: efhcaDPhNqQ/H48kMHLa8w ($1000 in chips)
Seat 5: 2PHCSXghjbGk2qR6jDFe2g ($1067 in chips)
Seat 6: l9mDFuns/ycIDiFx40BMVw ($815 in chips)
Seat 7: ettgJAblGnistIlqNz4Jww ($1000 in chips)
Seat 8: UgBUE0pOJDwUdQ53XJt8MQ ($190 in chips)
Seat 9: 1s1h7qXmZxmowl9P1VNe2Q ($237 in chips)
UgBUE0pOJDwUdQ53XJt8MQ: posts small blind $5
1s1h7qXmZxmowl9P1VNe2Q: posts big blind $10
*** HOLE CARDS ***
ve1LEJosAmuFjNNCQuPnPg: folds
voSAIKXtXUUbJnds83sYfQ: folds
vM2kcH3Ff9H6Drv0NwoocA: folds
efhcaDPhNqQ/H48kMHLa8w: folds
2PHCSXghjbGk2qR6jDFe2g: folds
l9mDFuns/ycIDiFx40BMVw: folds
ettgJAblGnistIlqNz4Jww: raises $10 to $20
UgBUE0pOJDwUdQ53XJt8MQ: folds
1s1h7qXmZxmowl9P1VNe2Q: folds
ettgJAblGnistIlqNz4Jww collected $25 from pot
*** SUMMARY ***
Total pot $25 | Rake $0
Seat 1: ve1LEJosAmuFjNNCQuPnPg folded before Flop (didn't bet)
Seat 2: voSAIKXtXUUbJnds83sYfQ folded before Flop (didn't bet)
Seat 3: vM2kcH3Ff9H6Drv0NwoocA folded before Flop (didn't bet)
Seat 4: efhcaDPhNqQ/H48kMHLa8w folded before Flop (didn't bet)
Seat 5: 2PHCSXghjbGk2qR6jDFe2g folded before Flop (didn't bet)
Seat 6: l9mDFuns/ycIDiFx40BMVw folded before Flop (didn't bet)
Seat 7: ettgJAblGnistIlqNz4Jww (button) collected ($25)
Seat 8: UgBUE0pOJDwUdQ53XJt8MQ (small blind) folded before Flop
Seat 9: 1s1h7qXmZxmowl9P1VNe2Q (big blind) folded before Flop



PokerStars Game #59962749038:  Hold'em No Limit ($5/$10) - 2009/07/01 11:39:47 ET
Table 'mAacPTyMuJ4IQhEFOonFPg' 2-max Seat #2 is the button
Seat 1: XFruyoQqeueL4N+qXEkusw ($1071.50 in chips)
Seat 2: ezwKQeNDkLTr+c7tP2UjNw ($715 in chips)
ezwKQeNDkLTr+c7tP2UjNw: posts small blind $5
XFruyoQqeueL4N+qXEkusw: posts big blind $10
*** HOLE CARDS ***
ezwKQeNDkLTr+c7tP2UjNw: raises $20 to $30
XFruyoQqeueL4N+qXEkusw: folds
ezwKQeNDkLTr+c7tP2UjNw collected $20 from pot
ezwKQeNDkLTr+c7tP2UjNw: doesn't show hand
*** SUMMARY ***
Total pot $20 | Rake $0
Seat 1: XFruyoQqeueL4N+qXEkusw (big blind) folded before Flop
Seat 2: ezwKQeNDkLTr+c7tP2UjNw (button) (small blind) collected ($20)



PokerStars Game #59962755040:  Hold'em No Limit ($5/$10) - 2009/07/01 11:39:53 ET
Table 'mAacPTyMuJ4IQhEFOonFPg' 2-max Seat #1 is the button
Seat 1: XFruyoQqeueL4N+qXEkusw ($1061.50 in chips)
Seat 2: ezwKQeNDkLTr+c7tP2UjNw ($725 in chips)
XFruyoQqeueL4N+qXEkusw: posts small blind $5
ezwKQeNDkLTr+c7tP2UjNw: posts big blind $10
*** HOLE CARDS ***
XFruyoQqeueL4N+qXEkusw: raises $20 to $30
ezwKQeNDkLTr+c7tP2UjNw: folds
XFruyoQqeueL4N+qXEkusw collected $20 from pot
XFruyoQqeueL4N+qXEkusw: doesn't show hand
*** SUMMARY ***
Total pot $20 | Rake $0
Seat 1: XFruyoQqeueL4N+qXEkusw (button) (small blind) collected ($20)
Seat 2: ezwKQeNDkLTr+c7tP2UjNw (big blind) folded before Flop



PokerStars Game #59962756164:  Hold'em No Limit ($5/$10) - 2009/07/01 11:39:55 ET
Table '1Dt9cpcLUVE6HYkx5dUEdQ' 6-max Seat #6 is the button
Seat 1: Xl+I49lxCJwPGRuegiaHoA ($1000 in chips)
Seat 2: zdS2zKkZYSRe8p+GVcXMgg ($1970.10 in chips)
Seat 3: Lne9leXjEzXWbU3BGFWsxQ ($1010 in chips)
Seat 4: voSAIKXtXUUbJnds83sYfQ ($1946 in chips)
Seat 5: jkH6qYMpn8JA/IyBOhQPMw ($1119.50 in chips)
Seat 6: 3mTlg4g0FJN2bo939h/0Wg ($1221.75 in chips)
Xl+I49lxCJwPGRuegiaHoA: posts small blind $5
zdS2zKkZYSRe8p+GVcXMgg: posts big blind $10
*** HOLE CARDS ***
Lne9leXjEzXWbU3BGFWsxQ: folds
voSAIKXtXUUbJnds83sYfQ: folds
jkH6qYMpn8JA/IyBOhQPMw: folds
3mTlg4g0FJN2bo939h/0Wg: raises $20 to $30
Xl+I49lxCJwPGRuegiaHoA: folds
zdS2zKkZYSRe8p+GVcXMgg: folds
3mTlg4g0FJN2bo939h/0Wg collected $25 from pot
*** SUMMARY ***
Total pot $25 | Rake $0
Seat 1: Xl+I49lxCJwPGRuegiaHoA (small blind) folded before Flop
Seat 2: zdS2zKkZYSRe8p+GVcXMgg (big blind) folded before Flop
Seat 3: Lne9leXjEzXWbU3BGFWsxQ folded before Flop (didn't bet)
Seat 4: voSAIKXtXUUbJnds83sYfQ folded before Flop (didn't bet)
Seat 5: jkH6qYMpn8JA/IyBOhQPMw folded before Flop (didn't bet)
Seat 6: 3mTlg4g0FJN2bo939h/0Wg (button) collected ($25)



PokerStars Game #59962758314:  Hold'em No Limit ($5/$10) - 2009/07/01 11:39:57 ET
Table 'dwLGEw3aoH/cOAI7JsLdmw' 6-max Seat #2 is the button
Seat 1: is0C+o+4W8624tMaRmJg7A ($1000 in chips)
Seat 2: 1ScqYmNf7/uWx1XSBgPTBw ($135 in chips)
Seat 3: voSAIKXtXUUbJnds83sYfQ ($1226 in chips)
Seat 4: efhcaDPhNqQ/H48kMHLa8w ($1015 in chips)
Seat 5: jkH6qYMpn8JA/IyBOhQPMw ($2275 in chips)
Seat 6: 3mTlg4g0FJN2bo939h/0Wg ($509.75 in chips)
voSAIKXtXUUbJnds83sYfQ: posts small blind $5
efhcaDPhNqQ/H48kMHLa8w: posts big blind $10
*** HOLE CARDS ***
jkH6qYMpn8JA/IyBOhQPMw: folds
3mTlg4g0FJN2bo939h/0Wg: raises $20 to $30
is0C+o+4W8624tMaRmJg7A: folds
1ScqYmNf7/uWx1XSBgPTBw: folds
voSAIKXtXUUbJnds83sYfQ: folds
efhcaDPhNqQ/H48kMHLa8w: folds
3mTlg4g0FJN2bo939h/0Wg collected $25 from pot
*** SUMMARY ***
Total pot $25 | Rake $0
Seat 1: is0C+o+4W8624tMaRmJg7A folded before Flop (didn't bet)
Seat 2: 1ScqYmNf7/uWx1XSBgPTBw (button) folded before Flop (didn't bet)
Seat 3: voSAIKXtXUUbJnds83sYfQ (small blind) folded before Flop
Seat 4: efhcaDPhNqQ/H48kMHLa8w (big blind) folded before Flop
Seat 5: jkH6qYMpn8JA/IyBOhQPMw folded before Flop (didn't bet)
Seat 6: 3mTlg4g0FJN2bo939h/0Wg collected ($25)



PokerStars Game #59962768024:  Hold'em No Limit ($5/$10) - 2009/07/01 11:40:08 ET
Table 'mAacPTyMuJ4IQhEFOonFPg' 2-max Seat #2 is the button
Seat 1: XFruyoQqeueL4N+qXEkusw ($1071.50 in chips)
Seat 2: ezwKQeNDkLTr+c7tP2UjNw ($715 in chips)
ezwKQeNDkLTr+c7tP2UjNw: posts small blind $5
XFruyoQqeueL4N+qXEkusw: posts big blind $10
*** HOLE CARDS ***
ezwKQeNDkLTr+c7tP2UjNw: folds
XFruyoQqeueL4N+qXEkusw collected $10 from pot
XFruyoQqeueL4N+qXEkusw: doesn't show hand
*** SUMMARY ***
Total pot $10 | Rake $0
Seat 1: XFruyoQqeueL4N+qXEkusw (big blind) collected ($10)
Seat 2: ezwKQeNDkLTr+c7tP2UjNw (button) (small blind) folded before Flop



PokerStars Game #59962770132:  Hold'em No Limit ($5/$10) - 2009/07/01 11:40:10 ET
Table '2a86NK3xhs21kwGZmbj0QA' 6-max Seat #3 is the button
Seat 1: is0C+o+4W8624tMaRmJg7A ($1000 in chips)
Seat 2: Xl+I49lxCJwPGRuegiaHoA ($3513 in chips)
Seat 3: voSAIKXtXUUbJnds83sYfQ ($1052 in chips)
Seat 4: 1ScqYmNf7/uWx1XSBgPTBw ($195.25 in chips)
Seat 6: 0OfLwED3kKs3FwY+JlHC0g ($1032 in chips)
1ScqYmNf7/uWx1XSBgPTBw: posts small blind $5
jkH6qYMpn8JA/IyBOhQPMw: is sitting out
0OfLwED3kKs3FwY+JlHC0g: posts big blind $10
*** HOLE CARDS ***
is0C+o+4W8624tMaRmJg7A: folds
Xl+I49lxCJwPGRuegiaHoA: raises $20 to $30
voSAIKXtXUUbJnds83sYfQ: folds
1ScqYmNf7/uWx1XSBgPTBw: folds
0OfLwED3kKs3FwY+JlHC0g: folds
Xl+I49lxCJwPGRuegiaHoA collected $25 from pot
Xl+I49lxCJwPGRuegiaHoA: doesn't show hand
*** SUMMARY ***
Total pot $25 | Rake $0
Seat 1: is0C+o+4W8624tMaRmJg7A folded before Flop (didn't bet)
Seat 2: Xl+I49lxCJwPGRuegiaHoA collected ($25)
Seat 3: voSAIKXtXUUbJnds83sYfQ (button) folded before Flop (didn't bet)
Seat 4: 1ScqYmNf7/uWx1XSBgPTBw (small blind) folded before Flop
Seat 6: 0OfLwED3kKs3FwY+JlHC0g (big blind) folded before Flop



PokerStars Game #59962772620:  Hold'em No Limit ($5/$10) - 2009/07/01 11:40:13 ET
Table 'mAacPTyMuJ4IQhEFOonFPg' 2-max Seat #1 is the button
Seat 1: XFruyoQqeueL4N+qXEkusw ($1076.50 in chips)
Seat 2: ezwKQeNDkLTr+c7tP2UjNw ($710 in chips)
XFruyoQqeueL4N+qXEkusw: posts small blind $5
ezwKQeNDkLTr+c7tP2UjNw: posts big blind $10
*** HOLE CARDS ***
XFruyoQqeueL4N+qXEkusw: folds
ezwKQeNDkLTr+c7tP2UjNw collected $10 from pot
ezwKQeNDkLTr+c7tP2UjNw: doesn't show hand
*** SUMMARY ***
Total pot $10 | Rake $0
Seat 1: XFruyoQqeueL4N+qXEkusw (button) (small blind) folded before Flop
Seat 2: ezwKQeNDkLTr+c7tP2UjNw (big blind) collected ($10)



PokerStars Game #59962778098:  Hold'em No Limit ($5/$10) - 2009/07/01 11:40:19 ET
Table 'dwLGEw3aoH/cOAI7JsLdmw' 6-max Seat #3 is the button
Seat 1: is0C+o+4W8624tMaRmJg7A ($1000 in chips)
Seat 2: 1ScqYmNf7/uWx1XSBgPTBw ($135 in chips)
Seat 3: voSAIKXtXUUbJnds83sYfQ ($1221 in chips)
Seat 4: efhcaDPhNqQ/H48kMHLa8w ($1005 in chips)
Seat 6: 3mTlg4g0FJN2bo939h/0Wg ($524.75 in chips)
efhcaDPhNqQ/H48kMHLa8w: posts small blind $5
jkH6qYMpn8JA/IyBOhQPMw: is sitting out
3mTlg4g0FJN2bo939h/0Wg: posts big blind $10
*** HOLE CARDS ***
is0C+o+4W8624tMaRmJg7A: folds
1ScqYmNf7/uWx1XSBgPTBw: raises $10 to $20
voSAIKXtXUUbJnds83sYfQ: folds
efhcaDPhNqQ/H48kMHLa8w: calls $15
3mTlg4g0FJN2bo939h/0Wg: calls $10
*** FLOP *** [Qh 7d Ah]
efhcaDPhNqQ/H48kMHLa8w: checks
3mTlg4g0FJN2bo939h/0Wg: checks
1ScqYmNf7/uWx1XSBgPTBw: checks
*** TURN *** [Qh 7d Ah] [Ac]
efhcaDPhNqQ/H48kMHLa8w: checks
3mTlg4g0FJN2bo939h/0Wg: bets $30
1ScqYmNf7/uWx1XSBgPTBw: raises $85 to $115 and is all-in
efhcaDPhNqQ/H48kMHLa8w: folds
3mTlg4g0FJN2bo939h/0Wg: folds
1ScqYmNf7/uWx1XSBgPTBw collected $118 from pot
1ScqYmNf7/uWx1XSBgPTBw: doesn't show hand
*** SUMMARY ***
Total pot $120 | Rake $2
Board [Qh 7d Ah Ac]
Seat 1: is0C+o+4W8624tMaRmJg7A folded before Flop (didn't bet)
Seat 2: 1ScqYmNf7/uWx1XSBgPTBw collected ($118)
Seat 3: voSAIKXtXUUbJnds83sYfQ (button) folded before Flop (didn't bet)
Seat 4: efhcaDPhNqQ/H48kMHLa8w (small blind) folded on the Turn
Seat 6: 3mTlg4g0FJN2bo939h/0Wg (big blind) folded on the Turn



PokerStars Game #59962780556:  Hold'em No Limit ($5/$10) - 2009/07/01 11:40:22 ET
Table '2a86NK3xhs21kwGZmbj0QA' 6-max Seat #4 is the button
Seat 1: is0C+o+4W8624tMaRmJg7A ($1000 in chips)
Seat 2: Xl+I49lxCJwPGRuegiaHoA ($3528 in chips)
Seat 3: voSAIKXtXUUbJnds83sYfQ ($1052 in chips)
Seat 4: 1ScqYmNf7/uWx1XSBgPTBw ($190.25 in chips)
Seat 6: 0OfLwED3kKs3FwY+JlHC0g ($1022 in chips)
0OfLwED3kKs3FwY+JlHC0g: posts small blind $5
is0C+o+4W8624tMaRmJg7A: posts big blind $10
*** HOLE CARDS ***
Xl+I49lxCJwPGRuegiaHoA: raises $20 to $30
voSAIKXtXUUbJnds83sYfQ: folds
1ScqYmNf7/uWx1XSBgPTBw: folds
0OfLwED3kKs3FwY+JlHC0g: folds
is0C+o+4W8624tMaRmJg7A: calls $20
*** FLOP *** [9h 3h 3d]
is0C+o+4W8624tMaRmJg7A: checks
Xl+I49lxCJwPGRuegiaHoA: bets $50
is0C+o+4W8624tMaRmJg7A: folds
Xl+I49lxCJwPGRuegiaHoA collected $63 from pot
Xl+I49lxCJwPGRuegiaHoA: doesn't show hand
*** SUMMARY ***
Total pot $65 | Rake $2
Board [9h 3h 3d]
Seat 1: is0C+o+4W8624tMaRmJg7A (big blind) folded on the Flop
Seat 2: Xl+I49lxCJwPGRuegiaHoA collected ($63)
Seat 3: voSAIKXtXUUbJnds83sYfQ folded before Flop (didn't bet)
Seat 4: 1ScqYmNf7/uWx1XSBgPTBw (button) folded before Flop (didn't bet)
Seat 6: 0OfLwED3kKs3FwY+JlHC0g (small blind) folded before Flop



PokerStars Game #59962783076:  Hold'em No Limit ($5/$10) - 2009/07/01 11:40:25 ET
Table 'mAacPTyMuJ4IQhEFOonFPg' 2-max Seat #2 is the button
Seat 1: XFruyoQqeueL4N+qXEkusw ($1071.50 in chips)
Seat 2: ezwKQeNDkLTr+c7tP2UjNw ($715 in chips)
ezwKQeNDkLTr+c7tP2UjNw: posts small blind $5
XFruyoQqeueL4N+qXEkusw: posts big blind $10
*** HOLE CARDS ***
ezwKQeNDkLTr+c7tP2UjNw: raises $20 to $30
XFruyoQqeueL4N+qXEkusw: calls $20
*** FLOP *** [4h Td Kc]
XFruyoQqeueL4N+qXEkusw: checks
ezwKQeNDkLTr+c7tP2UjNw: bets $30
XFruyoQqeueL4N+qXEkusw: folds
ezwKQeNDkLTr+c7tP2UjNw collected $59.50 from pot
ezwKQeNDkLTr+c7tP2UjNw: doesn't show hand
*** SUMMARY ***
Total pot $60 | Rake $0.50
Board [4h Td Kc]
Seat 1: XFruyoQqeueL4N+qXEkusw (big blind) folded on the Flop
Seat 2: ezwKQeNDkLTr+c7tP2UjNw (button) (small blind) collected ($59.50)



PokerStars Game #59962796802:  Hold'em No Limit ($5/$10) - 2009/07/01 11:40:40 ET
Table '1Dt9cpcLUVE6HYkx5dUEdQ' 6-max Seat #1 is the button
Seat 1: Xl+I49lxCJwPGRuegiaHoA ($1000 in chips)
Seat 2: zdS2zKkZYSRe8p+GVcXMgg ($1960.10 in chips)
Seat 3: Lne9leXjEzXWbU3BGFWsxQ ($1010 in chips)
Seat 4: voSAIKXtXUUbJnds83sYfQ ($1946 in chips)
Seat 5: jkH6qYMpn8JA/IyBOhQPMw ($1119.50 in chips)
Seat 6: 3mTlg4g0FJN2bo939h/0Wg ($1236.75 in chips)
zdS2zKkZYSRe8p+GVcXMgg: posts small blind $5
Lne9leXjEzXWbU3BGFWsxQ: posts big blind $10
*** HOLE CARDS ***
voSAIKXtXUUbJnds83sYfQ: folds
jkH6qYMpn8JA/IyBOhQPMw: folds
3mTlg4g0FJN2bo939h/0Wg: folds
Xl+I49lxCJwPGRuegiaHoA: raises $20 to $30
zdS2zKkZYSRe8p+GVcXMgg: folds
Lne9leXjEzXWbU3BGFWsxQ: raises $80 to $110
Xl+I49lxCJwPGRuegiaHoA: folds
Lne9leXjEzXWbU3BGFWsxQ collected $65 from pot
*** SUMMARY ***
Total pot $65 | Rake $0
Seat 1: Xl+I49lxCJwPGRuegiaHoA (button) folded before Flop
Seat 2: zdS2zKkZYSRe8p+GVcXMgg (small blind) folded before Flop
Seat 3: Lne9leXjEzXWbU3BGFWsxQ (big blind) collected ($65)
Seat 4: voSAIKXtXUUbJnds83sYfQ folded before Flop (didn't bet)
Seat 5: jkH6qYMpn8JA/IyBOhQPMw folded before Flop (didn't bet)
Seat 6: 3mTlg4g0FJN2bo939h/0Wg folded before Flop (didn't bet)



PokerStars Game #59962799402:  Hold'em No Limit ($5/$10) - 2009/07/01 11:40:43 ET
Table 'mAacPTyMuJ4IQhEFOonFPg' 2-max Seat #1 is the button
Seat 1: XFruyoQqeueL4N+qXEkusw ($1041.50 in chips)
Seat 2: ezwKQeNDkLTr+c7tP2UjNw ($744.50 in chips)
XFruyoQqeueL4N+qXEkusw: posts small blind $5
ezwKQeNDkLTr+c7tP2UjNw: posts big blind $10
*** HOLE CARDS ***
XFruyoQqeueL4N+qXEkusw: folds
ezwKQeNDkLTr+c7tP2UjNw collected $10 from pot
ezwKQeNDkLTr+c7tP2UjNw: doesn't show hand
*** SUMMARY ***
Total pot $10 | Rake $0
Seat 1: XFruyoQqeueL4N+qXEkusw (button) (small blind) folded before Flop
Seat 2: ezwKQeNDkLTr+c7tP2UjNw (big blind) collected ($10)



PokerStars Game #59962800364:  Hold'em No Limit ($5/$10) - 2009/07/01 11:40:44 ET
Table '2a86NK3xhs21kwGZmbj0QA' 6-max Seat #6 is the button
Seat 1: is0C+o+4W8624tMaRmJg7A ($1000 in chips)
Seat 2: Xl+I49lxCJwPGRuegiaHoA ($3561 in chips)
Seat 3: voSAIKXtXUUbJnds83sYfQ ($1052 in chips)
Seat 4: 1ScqYmNf7/uWx1XSBgPTBw ($190.25 in chips)
Seat 6: 0OfLwED3kKs3FwY+JlHC0g ($1017 in chips)
is0C+o+4W8624tMaRmJg7A: posts small blind $5
Xl+I49lxCJwPGRuegiaHoA: posts big blind $10
*** HOLE CARDS ***
voSAIKXtXUUbJnds83sYfQ: folds
1ScqYmNf7/uWx1XSBgPTBw: folds
0OfLwED3kKs3FwY+JlHC0g: folds
is0C+o+4W8624tMaRmJg7A: folds
Xl+I49lxCJwPGRuegiaHoA collected $10 from pot
Xl+I49lxCJwPGRuegiaHoA: doesn't show hand
*** SUMMARY ***
Total pot $10 | Rake $0
Seat 1: is0C+o+4W8624tMaRmJg7A (small blind) folded before Flop
Seat 2: Xl+I49lxCJwPGRuegiaHoA (big blind) collected ($10)
Seat 3: voSAIKXtXUUbJnds83sYfQ folded before Flop (didn't bet)
Seat 4: 1ScqYmNf7/uWx1XSBgPTBw folded before Flop (didn't bet)
Seat 6: 0OfLwED3kKs3FwY+JlHC0g (button) folded before Flop (didn't bet)



PokerStars Game #59962800462:  Hold'em No Limit ($5/$10) - 2009/07/01 11:40:45 ET
Table 'AI1fZ7Tsbf9DI8mC4EWoQQ' 9-max Seat #8 is the button
Seat 1: ve1LEJosAmuFjNNCQuPnPg ($1047.50 in chips)
Seat 2: voSAIKXtXUUbJnds83sYfQ ($1000 in chips)
Seat 3: vM2kcH3Ff9H6Drv0NwoocA ($266.75 in chips)
Seat 4: efhcaDPhNqQ/H48kMHLa8w ($1000 in chips)
Seat 5: 2PHCSXghjbGk2qR6jDFe2g ($1067 in chips)
Seat 6: l9mDFuns/ycIDiFx40BMVw ($815 in chips)
Seat 7: ettgJAblGnistIlqNz4Jww ($1015 in chips)
Seat 8: UgBUE0pOJDwUdQ53XJt8MQ ($185 in chips)
Seat 9: 1s1h7qXmZxmowl9P1VNe2Q ($227 in chips)
1s1h7qXmZxmowl9P1VNe2Q: posts small blind $5
ve1LEJosAmuFjNNCQuPnPg: posts big blind $10
*** HOLE CARDS ***
voSAIKXtXUUbJnds83sYfQ: folds
vM2kcH3Ff9H6Drv0NwoocA: folds
efhcaDPhNqQ/H48kMHLa8w: raises $20 to $30
2PHCSXghjbGk2qR6jDFe2g: folds
l9mDFuns/ycIDiFx40BMVw: folds
ettgJAblGnistIlqNz4Jww: folds
UgBUE0pOJDwUdQ53XJt8MQ: folds
1s1h7qXmZxmowl9P1VNe2Q: folds
ve1LEJosAmuFjNNCQuPnPg: folds
efhcaDPhNqQ/H48kMHLa8w collected $25 from pot
*** SUMMARY ***
Total pot $25 | Rake $0
Seat 1: ve1LEJosAmuFjNNCQuPnPg (big blind) folded before Flop
Seat 2: voSAIKXtXUUbJnds83sYfQ folded before Flop (didn't bet)
Seat 3: vM2kcH3Ff9H6Drv0NwoocA folded before Flop (didn't bet)
Seat 4: efhcaDPhNqQ/H48kMHLa8w collected ($25)
Seat 5: 2PHCSXghjbGk2qR6jDFe2g folded before Flop (didn't bet)
Seat 6: l9mDFuns/ycIDiFx40BMVw folded before Flop (didn't bet)
Seat 7: ettgJAblGnistIlqNz4Jww folded before Flop (didn't bet)
Seat 8: UgBUE0pOJDwUdQ53XJt8MQ (button) folded before Flop (didn't bet)
Seat 9: 1s1h7qXmZxmowl9P1VNe2Q (small blind) folded before Flop



PokerStars Game #59962810692:  Hold'em No Limit ($5/$10) - 2009/07/01 11:40:56 ET
Table 'mAacPTyMuJ4IQhEFOonFPg' 2-max Seat #2 is the button
Seat 1: XFruyoQqeueL4N+qXEkusw ($1036.50 in chips)
Seat 2: ezwKQeNDkLTr+c7tP2UjNw ($749.50 in chips)
ezwKQeNDkLTr+c7tP2UjNw: posts small blind $5
XFruyoQqeueL4N+qXEkusw: posts big blind $10
*** HOLE CARDS ***
ezwKQeNDkLTr+c7tP2UjNw: folds
XFruyoQqeueL4N+qXEkusw collected $10 from pot
XFruyoQqeueL4N+qXEkusw: doesn't show hand
*** SUMMARY ***
Total pot $10 | Rake $0
Seat 1: XFruyoQqeueL4N+qXEkusw (big blind) collected ($10)
Seat 2: ezwKQeNDkLTr+c7tP2UjNw (button) (small blind) folded before Flop



PokerStars Game #59962810380:  Hold'em No Limit ($5/$10) - 2009/07/01 11:40:56 ET
Table '2a86NK3xhs21kwGZmbj0QA' 6-max Seat #1 is the button
Seat 1: is0C+o+4W8624tMaRmJg7A ($1000 in chips)
Seat 2: Xl+I49lxCJwPGRuegiaHoA ($3566 in chips)
Seat 3: voSAIKXtXUUbJnds83sYfQ ($1052 in chips)
Seat 4: 1ScqYmNf7/uWx1XSBgPTBw ($190.25 in chips)
Seat 6: 0OfLwED3kKs3FwY+JlHC0g ($1017 in chips)
Xl+I49lxCJwPGRuegiaHoA: posts small blind $5
voSAIKXtXUUbJnds83sYfQ: posts big blind $10
*** HOLE CARDS ***
1ScqYmNf7/uWx1XSBgPTBw: folds
0OfLwED3kKs3FwY+JlHC0g: raises $20 to $30
is0C+o+4W8624tMaRmJg7A: calls $30
Xl+I49lxCJwPGRuegiaHoA: folds
voSAIKXtXUUbJnds83sYfQ: raises $100 to $130
0OfLwED3kKs3FwY+JlHC0g: calls $100
is0C+o+4W8624tMaRmJg7A: folds
*** FLOP *** [6c 3h 5c]
voSAIKXtXUUbJnds83sYfQ: bets $160
0OfLwED3kKs3FwY+JlHC0g: folds
voSAIKXtXUUbJnds83sYfQ collected $293 from pot
voSAIKXtXUUbJnds83sYfQ: doesn't show hand
*** SUMMARY ***
Total pot $295 | Rake $2
Board [6c 3h 5c]
Seat 1: is0C+o+4W8624tMaRmJg7A (button) folded before Flop
Seat 2: Xl+I49lxCJwPGRuegiaHoA (small blind) folded before Flop
Seat 3: voSAIKXtXUUbJnds83sYfQ (big blind) collected ($293)
Seat 4: 1ScqYmNf7/uWx1XSBgPTBw folded before Flop (didn't bet)
Seat 6: 0OfLwED3kKs3FwY+JlHC0g folded on the Flop



PokerStars Game #59962815414:  Hold'em No Limit ($5/$10) - 2009/07/01 11:41:02 ET
Table 'mAacPTyMuJ4IQhEFOonFPg' 2-max Seat #1 is the button
Seat 1: XFruyoQqeueL4N+qXEkusw ($1041.50 in chips)
Seat 2: ezwKQeNDkLTr+c7tP2UjNw ($744.50 in chips)
XFruyoQqeueL4N+qXEkusw: posts small blind $5
ezwKQeNDkLTr+c7tP2UjNw: posts big blind $10
*** HOLE CARDS ***
XFruyoQqeueL4N+qXEkusw: raises $20 to $30
ezwKQeNDkLTr+c7tP2UjNw: calls $20
*** FLOP *** [6h Kc As]
ezwKQeNDkLTr+c7tP2UjNw: checks
XFruyoQqeueL4N+qXEkusw: bets $40
ezwKQeNDkLTr+c7tP2UjNw: raises $60 to $100
XFruyoQqeueL4N+qXEkusw: calls $60
*** TURN *** [6h Kc As] [6s]
ezwKQeNDkLTr+c7tP2UjNw: bets $110
XFruyoQqeueL4N+qXEkusw: folds
ezwKQeNDkLTr+c7tP2UjNw collected $259.50 from pot
ezwKQeNDkLTr+c7tP2UjNw: doesn't show hand
*** SUMMARY ***
Total pot $260 | Rake $0.50
Board [6h Kc As 6s]
Seat 1: XFruyoQqeueL4N+qXEkusw (button) (small blind) folded on the Turn
Seat 2: ezwKQeNDkLTr+c7tP2UjNw (big blind) collected ($259.50)



PokerStars Game #59962817316:  Hold'em No Limit ($5/$10) - 2009/07/01 11:41:04 ET
Table '1Dt9cpcLUVE6HYkx5dUEdQ' 6-max Seat #2 is the button
Seat 1: Xl+I49lxCJwPGRuegiaHoA ($1000 in chips)
Seat 2: zdS2zKkZYSRe8p+GVcXMgg ($1955.10 in chips)
Seat 3: Lne9leXjEzXWbU3BGFWsxQ ($1045 in chips)
Seat 4: voSAIKXtXUUbJnds83sYfQ ($1946 in chips)
Seat 5: jkH6qYMpn8JA/IyBOhQPMw ($1119.50 in chips)
Seat 6: 3mTlg4g0FJN2bo939h/0Wg ($1236.75 in chips)
Lne9leXjEzXWbU3BGFWsxQ: posts small blind $5
voSAIKXtXUUbJnds83sYfQ: posts big blind $10
*** HOLE CARDS ***
jkH6qYMpn8JA/IyBOhQPMw: folds
3mTlg4g0FJN2bo939h/0Wg: raises $10 to $20
Xl+I49lxCJwPGRuegiaHoA: folds
zdS2zKkZYSRe8p+GVcXMgg: folds
Lne9leXjEzXWbU3BGFWsxQ: folds
voSAIKXtXUUbJnds83sYfQ: calls $10
*** FLOP *** [9d As 2d]
voSAIKXtXUUbJnds83sYfQ: checks
3mTlg4g0FJN2bo939h/0Wg: checks
*** TURN *** [9d As 2d] [Qc]
voSAIKXtXUUbJnds83sYfQ: bets $40
3mTlg4g0FJN2bo939h/0Wg: folds
voSAIKXtXUUbJnds83sYfQ collected $42.75 from pot
*** SUMMARY ***
Total pot $45 | Rake $2.25
Board [9d As 2d Qc]
Seat 1: Xl+I49lxCJwPGRuegiaHoA folded before Flop (didn't bet)
Seat 2: zdS2zKkZYSRe8p+GVcXMgg (button) folded before Flop (didn't bet)
Seat 3: Lne9leXjEzXWbU3BGFWsxQ (small blind) folded before Flop
Seat 4: voSAIKXtXUUbJnds83sYfQ (big blind) collected ($42.75)
Seat 5: jkH6qYMpn8JA/IyBOhQPMw folded before Flop (didn't bet)
Seat 6: 3mTlg4g0FJN2bo939h/0Wg folded on the Turn



PokerStars Game #59962832012:  Hold'em No Limit ($5/$10) - 2009/07/01 11:41:20 ET
Table 'dwLGEw3aoH/cOAI7JsLdmw' 6-max Seat #4 is the button
Seat 1: is0C+o+4W8624tMaRmJg7A ($1000 in chips)
Seat 2: 1ScqYmNf7/uWx1XSBgPTBw ($203 in chips)
Seat 3: voSAIKXtXUUbJnds83sYfQ ($1221 in chips)
Seat 4: efhcaDPhNqQ/H48kMHLa8w ($1000 in chips)
Seat 6: 3mTlg4g0FJN2bo939h/0Wg ($474.75 in chips)
3mTlg4g0FJN2bo939h/0Wg: posts small blind $5
is0C+o+4W8624tMaRmJg7A: posts big blind $10
*** HOLE CARDS ***
1ScqYmNf7/uWx1XSBgPTBw: folds
voSAIKXtXUUbJnds83sYfQ: folds
efhcaDPhNqQ/H48kMHLa8w: raises $10 to $20
3mTlg4g0FJN2bo939h/0Wg: folds
is0C+o+4W8624tMaRmJg7A: raises $45 to $65
efhcaDPhNqQ/H48kMHLa8w: calls $45
*** FLOP *** [2h Qc Kd]
is0C+o+4W8624tMaRmJg7A: checks
efhcaDPhNqQ/H48kMHLa8w: bets $70
is0C+o+4W8624tMaRmJg7A: raises $230 to $300
efhcaDPhNqQ/H48kMHLa8w: folds
is0C+o+4W8624tMaRmJg7A collected $273 from pot
is0C+o+4W8624tMaRmJg7A: doesn't show hand
*** SUMMARY ***
Total pot $275 | Rake $2
Board [2h Qc Kd]
Seat 1: is0C+o+4W8624tMaRmJg7A (big blind) collected ($273)
Seat 2: 1ScqYmNf7/uWx1XSBgPTBw folded before Flop (didn't bet)
Seat 3: voSAIKXtXUUbJnds83sYfQ folded before Flop (didn't bet)
Seat 4: efhcaDPhNqQ/H48kMHLa8w (button) folded on the Flop
Seat 6: 3mTlg4g0FJN2bo939h/0Wg (small blind) folded before Flop



PokerStars Game #59962842290:  Hold'em No Limit ($5/$10) - 2009/07/01 11:41:32 ET
Table 'AI1fZ7Tsbf9DI8mC4EWoQQ' 9-max Seat #9 is the button
Seat 1: ve1LEJosAmuFjNNCQuPnPg ($1037.50 in chips)
Seat 2: voSAIKXtXUUbJnds83sYfQ ($1000 in chips)
Seat 3: vM2kcH3Ff9H6Drv0NwoocA ($266.75 in chips)
Seat 4: efhcaDPhNqQ/H48kMHLa8w ($1015 in chips)
Seat 5: 2PHCSXghjbGk2qR6jDFe2g ($1067 in chips)
Seat 6: l9mDFuns/ycIDiFx40BMVw ($815 in chips)
Seat 7: ettgJAblGnistIlqNz4Jww ($1015 in chips)
Seat 8: UgBUE0pOJDwUdQ53XJt8MQ ($185 in chips)
Seat 9: 1s1h7qXmZxmowl9P1VNe2Q ($222 in chips)
ve1LEJosAmuFjNNCQuPnPg: posts small blind $5
voSAIKXtXUUbJnds83sYfQ: posts big blind $10
*** HOLE CARDS ***
vM2kcH3Ff9H6Drv0NwoocA: folds
efhcaDPhNqQ/H48kMHLa8w: raises $20 to $30
2PHCSXghjbGk2qR6jDFe2g: calls $30
l9mDFuns/ycIDiFx40BMVw: folds
ettgJAblGnistIlqNz4Jww: folds
UgBUE0pOJDwUdQ53XJt8MQ: folds
1s1h7qXmZxmowl9P1VNe2Q: folds
ve1LEJosAmuFjNNCQuPnPg: folds
voSAIKXtXUUbJnds83sYfQ: raises $100 to $130
efhcaDPhNqQ/H48kMHLa8w: folds
2PHCSXghjbGk2qR6jDFe2g: calls $100
*** FLOP *** [2d 2s Tc]
voSAIKXtXUUbJnds83sYfQ: bets $170
2PHCSXghjbGk2qR6jDFe2g: folds
voSAIKXtXUUbJnds83sYfQ collected $292 from pot
*** SUMMARY ***
Total pot $295 | Rake $3
Board [2d 2s Tc]
Seat 1: ve1LEJosAmuFjNNCQuPnPg (small blind) folded before Flop
Seat 2: voSAIKXtXUUbJnds83sYfQ (big blind) collected ($292)
Seat 3: vM2kcH3Ff9H6Drv0NwoocA folded before Flop (didn't bet)
Seat 4: efhcaDPhNqQ/H48kMHLa8w folded before Flop
Seat 5: 2PHCSXghjbGk2qR6jDFe2g folded on the Flop
Seat 6: l9mDFuns/ycIDiFx40BMVw folded before Flop (didn't bet)
Seat 7: ettgJAblGnistIlqNz4Jww folded before Flop (didn't bet)
Seat 8: UgBUE0pOJDwUdQ53XJt8MQ folded before Flop (didn't bet)
Seat 9: 1s1h7qXmZxmowl9P1VNe2Q (button) folded before Flop (didn't bet)



PokerStars Game #59962845204:  Hold'em No Limit ($5/$10) - 2009/07/01 11:41:35 ET
Table 'mAacPTyMuJ4IQhEFOonFPg' 2-max Seat #2 is the button
Seat 1: XFruyoQqeueL4N+qXEkusw ($1000 in chips)
Seat 2: ezwKQeNDkLTr+c7tP2UjNw ($874 in chips)
ezwKQeNDkLTr+c7tP2UjNw: posts small blind $5
XFruyoQqeueL4N+qXEkusw: posts big blind $10
*** HOLE CARDS ***
ezwKQeNDkLTr+c7tP2UjNw: raises $20 to $30
XFruyoQqeueL4N+qXEkusw: calls $20
*** FLOP *** [8c 3s Th]
XFruyoQqeueL4N+qXEkusw: checks
ezwKQeNDkLTr+c7tP2UjNw: bets $30
XFruyoQqeueL4N+qXEkusw: folds
ezwKQeNDkLTr+c7tP2UjNw collected $59.50 from pot
ezwKQeNDkLTr+c7tP2UjNw: doesn't show hand
*** SUMMARY ***
Total pot $60 | Rake $0.50
Board [8c 3s Th]
Seat 1: XFruyoQqeueL4N+qXEkusw (big blind) folded on the Flop
Seat 2: ezwKQeNDkLTr+c7tP2UjNw (button) (small blind) collected ($59.50)



PokerStars Game #59962851862:  Hold'em No Limit ($5/$10) - 2009/07/01 11:41:42 ET
Table 'AiNa6yyp/njJVRYl/Lz1KQ' 6-max Seat #5 is the button
Seat 2: 1s1h7qXmZxmowl9P1VNe2Q ($269 in chips)
Seat 3: fs6KvO7rGEyw4MYb4z5cQQ ($143 in chips)
Seat 4: /F5e5TKT/1B9kgJVuQttsg ($528.05 in chips)
Seat 5: 2PHCSXghjbGk2qR6jDFe2g ($321 in chips)
Xl/zzIZf2hmO234sDWM1HQ will be allowed to play after the button
KVUX8NzxJOWN94yxutATnw will be allowed to play after the button
1s1h7qXmZxmowl9P1VNe2Q: posts small blind $5
fs6KvO7rGEyw4MYb4z5cQQ: posts big blind $10
*** HOLE CARDS ***
/F5e5TKT/1B9kgJVuQttsg: folds
2PHCSXghjbGk2qR6jDFe2g: folds
1s1h7qXmZxmowl9P1VNe2Q: raises $10 to $20
fs6KvO7rGEyw4MYb4z5cQQ: calls $10
*** FLOP *** [5h 5c Qd]
1s1h7qXmZxmowl9P1VNe2Q: checks
fs6KvO7rGEyw4MYb4z5cQQ: checks
*** TURN *** [5h 5c Qd] [9d]
1s1h7qXmZxmowl9P1VNe2Q: bets $10
fs6KvO7rGEyw4MYb4z5cQQ: calls $10
*** RIVER *** [5h 5c Qd 9d] [6h]
1s1h7qXmZxmowl9P1VNe2Q: bets $50
fs6KvO7rGEyw4MYb4z5cQQ: folds
1s1h7qXmZxmowl9P1VNe2Q collected $58 from pot
1s1h7qXmZxmowl9P1VNe2Q: doesn't show hand
*** SUMMARY ***
Total pot $60 | Rake $2
Board [5h 5c Qd 9d 6h]
Seat 2: 1s1h7qXmZxmowl9P1VNe2Q (small blind) collected ($58)
Seat 3: fs6KvO7rGEyw4MYb4z5cQQ (big blind) folded on the River
Seat 4: /F5e5TKT/1B9kgJVuQttsg folded before Flop (didn't bet)
Seat 5: 2PHCSXghjbGk2qR6jDFe2g (button) folded before Flop (didn't bet)



PokerStars Game #59962864322:  Hold'em No Limit ($5/$10) - 2009/07/01 11:41:56 ET
Table 'mAacPTyMuJ4IQhEFOonFPg' 2-max Seat #1 is the button
Seat 1: XFruyoQqeueL4N+qXEkusw ($1000 in chips)
Seat 2: ezwKQeNDkLTr+c7tP2UjNw ($903.50 in chips)
XFruyoQqeueL4N+qXEkusw: posts small blind $5
ezwKQeNDkLTr+c7tP2UjNw: posts big blind $10
*** HOLE CARDS ***
XFruyoQqeueL4N+qXEkusw: raises $20 to $30
ezwKQeNDkLTr+c7tP2UjNw: folds
XFruyoQqeueL4N+qXEkusw collected $20 from pot
XFruyoQqeueL4N+qXEkusw: doesn't show hand
*** SUMMARY ***
Total pot $20 | Rake $0
Seat 1: XFruyoQqeueL4N+qXEkusw (button) (small blind) collected ($20)
Seat 2: ezwKQeNDkLTr+c7tP2UjNw (big blind) folded before Flop



PokerStars Game #59962870488:  Hold'em No Limit ($5/$10) - 2009/07/01 11:42:03 ET
Table '2a86NK3xhs21kwGZmbj0QA' 6-max Seat #2 is the button
Seat 1: is0C+o+4W8624tMaRmJg7A ($1000 in chips)
Seat 2: Xl+I49lxCJwPGRuegiaHoA ($3561 in chips)
Seat 3: voSAIKXtXUUbJnds83sYfQ ($1215 in chips)
Seat 4: 1ScqYmNf7/uWx1XSBgPTBw ($190.25 in chips)
Seat 6: 0OfLwED3kKs3FwY+JlHC0g ($1000 in chips)
voSAIKXtXUUbJnds83sYfQ: posts small blind $5
1ScqYmNf7/uWx1XSBgPTBw: posts big blind $10
*** HOLE CARDS ***
0OfLwED3kKs3FwY+JlHC0g: folds
is0C+o+4W8624tMaRmJg7A: folds
Xl+I49lxCJwPGRuegiaHoA: raises $10 to $20
voSAIKXtXUUbJnds83sYfQ: folds
1ScqYmNf7/uWx1XSBgPTBw: folds
Xl+I49lxCJwPGRuegiaHoA collected $25 from pot
Xl+I49lxCJwPGRuegiaHoA: doesn't show hand
*** SUMMARY ***
Total pot $25 | Rake $0
Seat 1: is0C+o+4W8624tMaRmJg7A folded before Flop (didn't bet)
Seat 2: Xl+I49lxCJwPGRuegiaHoA (button) collected ($25)
Seat 3: voSAIKXtXUUbJnds83sYfQ (small blind) folded before Flop
Seat 4: 1ScqYmNf7/uWx1XSBgPTBw (big blind) folded before Flop
Seat 6: 0OfLwED3kKs3FwY+JlHC0g folded before Flop (didn't bet)



PokerStars Game #59962872392:  Hold'em No Limit ($5/$10) - 2009/07/01 11:42:06 ET
Table 'mAacPTyMuJ4IQhEFOonFPg' 2-max Seat #2 is the button
Seat 1: XFruyoQqeueL4N+qXEkusw ($1010 in chips)
Seat 2: ezwKQeNDkLTr+c7tP2UjNw ($893.50 in chips)
ezwKQeNDkLTr+c7tP2UjNw: posts small blind $5
XFruyoQqeueL4N+qXEkusw: posts big blind $10
*** HOLE CARDS ***
ezwKQeNDkLTr+c7tP2UjNw: raises $20 to $30
XFruyoQqeueL4N+qXEkusw: folds
ezwKQeNDkLTr+c7tP2UjNw collected $20 from pot
ezwKQeNDkLTr+c7tP2UjNw: doesn't show hand
*** SUMMARY ***
Total pot $20 | Rake $0
Seat 1: XFruyoQqeueL4N+qXEkusw (big blind) folded before Flop
Seat 2: ezwKQeNDkLTr+c7tP2UjNw (button) (small blind) collected ($20)



PokerStars Game #59962876830:  Hold'em No Limit ($5/$10) - 2009/07/01 11:42:11 ET
Table 'AiNa6yyp/njJVRYl/Lz1KQ' 6-max Seat #2 is the button
Seat 2: 1s1h7qXmZxmowl9P1VNe2Q ($297 in chips)
Seat 3: fs6KvO7rGEyw4MYb4z5cQQ ($113 in chips)
Seat 4: /F5e5TKT/1B9kgJVuQttsg ($528.05 in chips)
Seat 5: 2PHCSXghjbGk2qR6jDFe2g ($321 in chips)
Seat 6: Xl/zzIZf2hmO234sDWM1HQ ($470.50 in chips)
fs6KvO7rGEyw4MYb4z5cQQ: posts small blind $5
/F5e5TKT/1B9kgJVuQttsg: posts big blind $10
Xl/zzIZf2hmO234sDWM1HQ: posts big blind $10
KVUX8NzxJOWN94yxutATnw: sits out
*** HOLE CARDS ***
2PHCSXghjbGk2qR6jDFe2g: calls $10
Xl/zzIZf2hmO234sDWM1HQ: checks
1s1h7qXmZxmowl9P1VNe2Q: folds
fs6KvO7rGEyw4MYb4z5cQQ: raises $30 to $40
/F5e5TKT/1B9kgJVuQttsg: folds
2PHCSXghjbGk2qR6jDFe2g: raises $281 to $321 and is all-in
Xl/zzIZf2hmO234sDWM1HQ: folds
fs6KvO7rGEyw4MYb4z5cQQ: calls $73 and is all-in
*** FLOP *** [7h 8c 4s]
*** TURN *** [7h 8c 4s] [4h]
*** RIVER *** [7h 8c 4s 4h] [Ad]
*** SHOW DOWN ***
fs6KvO7rGEyw4MYb4z5cQQ: shows [Jc As] (two pair, Aces and Fours)
2PHCSXghjbGk2qR6jDFe2g: shows [Ks Ah] (two pair, Aces and Fours - King kicker)
2PHCSXghjbGk2qR6jDFe2g collected $244 from pot
*** SUMMARY ***
Total pot $246 | Rake $2
Board [7h 8c 4s 4h Ad]
Seat 2: 1s1h7qXmZxmowl9P1VNe2Q (button) folded before Flop (didn't bet)
Seat 3: fs6KvO7rGEyw4MYb4z5cQQ (small blind) showed [Jc As] and lost with two pair, Aces and Fours
Seat 4: /F5e5TKT/1B9kgJVuQttsg (big blind) folded before Flop
Seat 5: 2PHCSXghjbGk2qR6jDFe2g showed [Ks Ah] and won ($244) with two pair, Aces and Fours
Seat 6: Xl/zzIZf2hmO234sDWM1HQ folded before Flop



PokerStars Game #59962880026:  Hold'em No Limit ($5/$10) - 2009/07/01 11:42:14 ET
Table '1Dt9cpcLUVE6HYkx5dUEdQ' 6-max Seat #3 is the button
Seat 1: Xl+I49lxCJwPGRuegiaHoA ($1000 in chips)
Seat 2: zdS2zKkZYSRe8p+GVcXMgg ($1955.10 in chips)
Seat 3: Lne9leXjEzXWbU3BGFWsxQ ($1040 in chips)
Seat 4: voSAIKXtXUUbJnds83sYfQ ($1968.75 in chips)
Seat 6: 3mTlg4g0FJN2bo939h/0Wg ($1216.75 in chips)
voSAIKXtXUUbJnds83sYfQ: posts small blind $5
jkH6qYMpn8JA/IyBOhQPMw: is sitting out
3mTlg4g0FJN2bo939h/0Wg: posts big blind $10
*** HOLE CARDS ***
Xl+I49lxCJwPGRuegiaHoA: folds
zdS2zKkZYSRe8p+GVcXMgg: calls $10
Lne9leXjEzXWbU3BGFWsxQ: folds
voSAIKXtXUUbJnds83sYfQ: folds
3mTlg4g0FJN2bo939h/0Wg: checks
*** FLOP *** [Ks 7c 5s]
3mTlg4g0FJN2bo939h/0Wg: checks
zdS2zKkZYSRe8p+GVcXMgg: bets $20
3mTlg4g0FJN2bo939h/0Wg: calls $20
*** TURN *** [Ks 7c 5s] [9c]
3mTlg4g0FJN2bo939h/0Wg: checks
zdS2zKkZYSRe8p+GVcXMgg: checks
*** RIVER *** [Ks 7c 5s 9c] [2c]
3mTlg4g0FJN2bo939h/0Wg: bets $50
zdS2zKkZYSRe8p+GVcXMgg: calls $50
*** SHOW DOWN ***
3mTlg4g0FJN2bo939h/0Wg: shows [3s 4s] (high card King)
zdS2zKkZYSRe8p+GVcXMgg: shows [9d 8d] (a pair of Nines)
zdS2zKkZYSRe8p+GVcXMgg collected $163 from pot
*** SUMMARY ***
Total pot $165 | Rake $2
Board [Ks 7c 5s 9c 2c]
Seat 1: Xl+I49lxCJwPGRuegiaHoA folded before Flop (didn't bet)
Seat 2: zdS2zKkZYSRe8p+GVcXMgg showed [9d 8d] and won ($163) with a pair of Nines
Seat 3: Lne9leXjEzXWbU3BGFWsxQ (button) folded before Flop (didn't bet)
Seat 4: voSAIKXtXUUbJnds83sYfQ (small blind) folded before Flop
Seat 6: 3mTlg4g0FJN2bo939h/0Wg (big blind) showed [3s 4s] and lost with high card King



PokerStars Game #59962880446:  Hold'em No Limit ($5/$10) - 2009/07/01 11:42:15 ET
Table 'mAacPTyMuJ4IQhEFOonFPg' 2-max Seat #1 is the button
Seat 1: XFruyoQqeueL4N+qXEkusw ($1000 in chips)
Seat 2: ezwKQeNDkLTr+c7tP2UjNw ($903.50 in chips)
XFruyoQqeueL4N+qXEkusw: posts small blind $5
ezwKQeNDkLTr+c7tP2UjNw: posts big blind $10
*** HOLE CARDS ***
XFruyoQqeueL4N+qXEkusw: raises $20 to $30
ezwKQeNDkLTr+c7tP2UjNw: folds
XFruyoQqeueL4N+qXEkusw collected $20 from pot
XFruyoQqeueL4N+qXEkusw: doesn't show hand
*** SUMMARY ***
Total pot $20 | Rake $0
Seat 1: XFruyoQqeueL4N+qXEkusw (button) (small blind) collected ($20)
Seat 2: ezwKQeNDkLTr+c7tP2UjNw (big blind) folded before Flop



PokerStars Game #59962884576:  Hold'em No Limit ($5/$10) - 2009/07/01 11:42:20 ET
Table '2a86NK3xhs21kwGZmbj0QA' 6-max Seat #3 is the button
Seat 1: is0C+o+4W8624tMaRmJg7A ($1000 in chips)
Seat 2: Xl+I49lxCJwPGRuegiaHoA ($3576 in chips)
Seat 3: voSAIKXtXUUbJnds83sYfQ ($1210 in chips)
Seat 4: 1ScqYmNf7/uWx1XSBgPTBw ($180.25 in chips)
Seat 6: 0OfLwED3kKs3FwY+JlHC0g ($1000 in chips)
1ScqYmNf7/uWx1XSBgPTBw: posts small blind $5
0OfLwED3kKs3FwY+JlHC0g: posts big blind $10
*** HOLE CARDS ***
is0C+o+4W8624tMaRmJg7A: folds
Xl+I49lxCJwPGRuegiaHoA: folds
voSAIKXtXUUbJnds83sYfQ has timed out
voSAIKXtXUUbJnds83sYfQ: folds
voSAIKXtXUUbJnds83sYfQ is sitting out
1ScqYmNf7/uWx1XSBgPTBw: folds
voSAIKXtXUUbJnds83sYfQ has returned
0OfLwED3kKs3FwY+JlHC0g collected $10 from pot
0OfLwED3kKs3FwY+JlHC0g: doesn't show hand
*** SUMMARY ***
Total pot $10 | Rake $0
Seat 1: is0C+o+4W8624tMaRmJg7A folded before Flop (didn't bet)
Seat 2: Xl+I49lxCJwPGRuegiaHoA folded before Flop (didn't bet)
Seat 3: voSAIKXtXUUbJnds83sYfQ (button) folded before Flop (didn't bet)
Seat 4: 1ScqYmNf7/uWx1XSBgPTBw (small blind) folded before Flop
Seat 6: 0OfLwED3kKs3FwY+JlHC0g (big blind) collected ($10)



PokerStars Game #59962889026:  Hold'em No Limit ($5/$10) - 2009/07/01 11:42:24 ET
Table 'mAacPTyMuJ4IQhEFOonFPg' 2-max Seat #2 is the button
Seat 1: XFruyoQqeueL4N+qXEkusw ($1010 in chips)
Seat 2: ezwKQeNDkLTr+c7tP2UjNw ($893.50 in chips)
ezwKQeNDkLTr+c7tP2UjNw: posts small blind $5
XFruyoQqeueL4N+qXEkusw: posts big blind $10
*** HOLE CARDS ***
ezwKQeNDkLTr+c7tP2UjNw: raises $20 to $30
XFruyoQqeueL4N+qXEkusw: folds
ezwKQeNDkLTr+c7tP2UjNw collected $20 from pot
ezwKQeNDkLTr+c7tP2UjNw: doesn't show hand
*** SUMMARY ***
Total pot $20 | Rake $0
Seat 1: XFruyoQqeueL4N+qXEkusw (big blind) folded before Flop
Seat 2: ezwKQeNDkLTr+c7tP2UjNw (button) (small blind) collected ($20)



PokerStars Game #59962893918:  Hold'em No Limit ($5/$10) - 2009/07/01 11:42:30 ET
Table 'dwLGEw3aoH/cOAI7JsLdmw' 6-max Seat #6 is the button
Seat 1: is0C+o+4W8624tMaRmJg7A ($1138 in chips)
Seat 2: 1ScqYmNf7/uWx1XSBgPTBw ($203 in chips)
Seat 3: voSAIKXtXUUbJnds83sYfQ ($1221 in chips)
Seat 4: efhcaDPhNqQ/H48kMHLa8w ($1000 in chips)
Seat 6: 3mTlg4g0FJN2bo939h/0Wg ($469.75 in chips)
is0C+o+4W8624tMaRmJg7A: posts small blind $5
1ScqYmNf7/uWx1XSBgPTBw: posts big blind $10
*** HOLE CARDS ***
voSAIKXtXUUbJnds83sYfQ: raises $20 to $30
efhcaDPhNqQ/H48kMHLa8w: folds
3mTlg4g0FJN2bo939h/0Wg: folds
is0C+o+4W8624tMaRmJg7A: folds
1ScqYmNf7/uWx1XSBgPTBw: raises $173 to $203 and is all-in
voSAIKXtXUUbJnds83sYfQ: folds
1ScqYmNf7/uWx1XSBgPTBw collected $65 from pot
*** SUMMARY ***
Total pot $65 | Rake $0
Seat 1: is0C+o+4W8624tMaRmJg7A (small blind) folded before Flop
Seat 2: 1ScqYmNf7/uWx1XSBgPTBw (big blind) collected ($65)
Seat 3: voSAIKXtXUUbJnds83sYfQ folded before Flop
Seat 4: efhcaDPhNqQ/H48kMHLa8w folded before Flop (didn't bet)
Seat 6: 3mTlg4g0FJN2bo939h/0Wg (button) folded before Flop (didn't bet)



PokerStars Game #59962897934:  Hold'em No Limit ($5/$10) - 2009/07/01 11:42:35 ET
Table 'mAacPTyMuJ4IQhEFOonFPg' 2-max Seat #1 is the button
Seat 1: XFruyoQqeueL4N+qXEkusw ($1000 in chips)
Seat 2: ezwKQeNDkLTr+c7tP2UjNw ($903.50 in chips)
XFruyoQqeueL4N+qXEkusw: posts small blind $5
ezwKQeNDkLTr+c7tP2UjNw: posts big blind $10
*** HOLE CARDS ***
XFruyoQqeueL4N+qXEkusw: raises $20 to $30
ezwKQeNDkLTr+c7tP2UjNw: folds
XFruyoQqeueL4N+qXEkusw collected $20 from pot
XFruyoQqeueL4N+qXEkusw: doesn't show hand
*** SUMMARY ***
Total pot $20 | Rake $0
Seat 1: XFruyoQqeueL4N+qXEkusw (button) (small blind) collected ($20)
Seat 2: ezwKQeNDkLTr+c7tP2UjNw (big blind) folded before Flop



PokerStars Game #59962907436:  Hold'em No Limit ($5/$10) - 2009/07/01 11:42:45 ET
Table 'mAacPTyMuJ4IQhEFOonFPg' 2-max Seat #2 is the button
Seat 1: XFruyoQqeueL4N+qXEkusw ($1010 in chips)
Seat 2: ezwKQeNDkLTr+c7tP2UjNw ($893.50 in chips)
ezwKQeNDkLTr+c7tP2UjNw: posts small blind $5
XFruyoQqeueL4N+qXEkusw: posts big blind $10
*** HOLE CARDS ***
ezwKQeNDkLTr+c7tP2UjNw: raises $20 to $30
XFruyoQqeueL4N+qXEkusw: folds
ezwKQeNDkLTr+c7tP2UjNw collected $20 from pot
ezwKQeNDkLTr+c7tP2UjNw: doesn't show hand
*** SUMMARY ***
Total pot $20 | Rake $0
Seat 1: XFruyoQqeueL4N+qXEkusw (big blind) folded before Flop
Seat 2: ezwKQeNDkLTr+c7tP2UjNw (button) (small blind) collected ($20)



PokerStars Game #59962909166:  Hold'em No Limit ($5/$10) - 2009/07/01 11:42:47 ET
Table 'AiNa6yyp/njJVRYl/Lz1KQ' 6-max Seat #4 is the button
Seat 2: 1s1h7qXmZxmowl9P1VNe2Q ($297 in chips)
Seat 4: /F5e5TKT/1B9kgJVuQttsg ($518.05 in chips)
Seat 5: 2PHCSXghjbGk2qR6jDFe2g ($452 in chips)
Seat 6: Xl/zzIZf2hmO234sDWM1HQ ($460.50 in chips)
2PHCSXghjbGk2qR6jDFe2g: posts small blind $5
Xl/zzIZf2hmO234sDWM1HQ: posts big blind $10
KVUX8NzxJOWN94yxutATnw: sits out
*** HOLE CARDS ***
fs6KvO7rGEyw4MYb4z5cQQ leaves the table
1s1h7qXmZxmowl9P1VNe2Q: folds
/F5e5TKT/1B9kgJVuQttsg: raises $10 to $20
2PHCSXghjbGk2qR6jDFe2g: folds
Xl/zzIZf2hmO234sDWM1HQ: calls $10
*** FLOP *** [Ad Qs 4s]
Xl/zzIZf2hmO234sDWM1HQ: checks
/F5e5TKT/1B9kgJVuQttsg: bets $20
Xl/zzIZf2hmO234sDWM1HQ: folds
/F5e5TKT/1B9kgJVuQttsg collected $43 from pot
/F5e5TKT/1B9kgJVuQttsg: doesn't show hand
*** SUMMARY ***
Total pot $45 | Rake $2
Board [Ad Qs 4s]
Seat 2: 1s1h7qXmZxmowl9P1VNe2Q folded before Flop (didn't bet)
Seat 4: /F5e5TKT/1B9kgJVuQttsg (button) collected ($43)
Seat 5: 2PHCSXghjbGk2qR6jDFe2g (small blind) folded before Flop
Seat 6: Xl/zzIZf2hmO234sDWM1HQ (big blind) folded on the Flop



PokerStars Game #59962910268:  Hold'em No Limit ($5/$10) - 2009/07/01 11:42:49 ET
Table '2a86NK3xhs21kwGZmbj0QA' 6-max Seat #4 is the button
Seat 1: is0C+o+4W8624tMaRmJg7A ($1000 in chips)
Seat 2: Xl+I49lxCJwPGRuegiaHoA ($3576 in chips)
Seat 3: voSAIKXtXUUbJnds83sYfQ ($1210 in chips)
Seat 4: 1ScqYmNf7/uWx1XSBgPTBw ($175.25 in chips)
Seat 6: 0OfLwED3kKs3FwY+JlHC0g ($1005 in chips)
0OfLwED3kKs3FwY+JlHC0g: posts small blind $5
is0C+o+4W8624tMaRmJg7A: posts big blind $10
*** HOLE CARDS ***
Xl+I49lxCJwPGRuegiaHoA: folds
voSAIKXtXUUbJnds83sYfQ: folds
1ScqYmNf7/uWx1XSBgPTBw: folds
0OfLwED3kKs3FwY+JlHC0g: folds
is0C+o+4W8624tMaRmJg7A collected $10 from pot
is0C+o+4W8624tMaRmJg7A: doesn't show hand
*** SUMMARY ***
Total pot $10 | Rake $0
Seat 1: is0C+o+4W8624tMaRmJg7A (big blind) collected ($10)
Seat 2: Xl+I49lxCJwPGRuegiaHoA folded before Flop (didn't bet)
Seat 3: voSAIKXtXUUbJnds83sYfQ folded before Flop (didn't bet)
Seat 4: 1ScqYmNf7/uWx1XSBgPTBw (button) folded before Flop (didn't bet)
Seat 6: 0OfLwED3kKs3FwY+JlHC0g (small blind) folded before Flop



PokerStars Game #59962915396:  Hold'em No Limit ($5/$10) - 2009/07/01 11:42:55 ET
Table 'mAacPTyMuJ4IQhEFOonFPg' 2-max Seat #1 is the button
Seat 1: XFruyoQqeueL4N+qXEkusw ($1000 in chips)
Seat 2: ezwKQeNDkLTr+c7tP2UjNw ($903.50 in chips)
XFruyoQqeueL4N+qXEkusw: posts small blind $5
ezwKQeNDkLTr+c7tP2UjNw: posts big blind $10
*** HOLE CARDS ***
XFruyoQqeueL4N+qXEkusw: raises $20 to $30
ezwKQeNDkLTr+c7tP2UjNw: calls $20
*** FLOP *** [Kc As Qc]
ezwKQeNDkLTr+c7tP2UjNw: checks
XFruyoQqeueL4N+qXEkusw: bets $40
ezwKQeNDkLTr+c7tP2UjNw: calls $40
*** TURN *** [Kc As Qc] [9h]
ezwKQeNDkLTr+c7tP2UjNw: checks
XFruyoQqeueL4N+qXEkusw: checks
*** RIVER *** [Kc As Qc 9h] [Qd]
ezwKQeNDkLTr+c7tP2UjNw: checks
XFruyoQqeueL4N+qXEkusw: checks
*** SHOW DOWN ***
ezwKQeNDkLTr+c7tP2UjNw: shows [6d Ac] (two pair, Aces and Queens)
XFruyoQqeueL4N+qXEkusw: mucks hand
ezwKQeNDkLTr+c7tP2UjNw collected $139.50 from pot
*** SUMMARY ***
Total pot $140 | Rake $0.50
Board [Kc As Qc 9h Qd]
Seat 1: XFruyoQqeueL4N+qXEkusw (button) (small blind) mucked
Seat 2: ezwKQeNDkLTr+c7tP2UjNw (big blind) showed [6d Ac] and won ($139.50) with two pair, Aces and Queens



PokerStars Game #59962920684:  Hold'em No Limit ($5/$10) - 2009/07/01 11:43:01 ET
Table '2a86NK3xhs21kwGZmbj0QA' 6-max Seat #6 is the button
Seat 1: is0C+o+4W8624tMaRmJg7A ($1005 in chips)
Seat 2: Xl+I49lxCJwPGRuegiaHoA ($3576 in chips)
Seat 3: voSAIKXtXUUbJnds83sYfQ ($1210 in chips)
Seat 4: 1ScqYmNf7/uWx1XSBgPTBw ($175.25 in chips)
Seat 6: 0OfLwED3kKs3FwY+JlHC0g ($1000 in chips)
is0C+o+4W8624tMaRmJg7A: posts small blind $5
Xl+I49lxCJwPGRuegiaHoA: posts big blind $10
*** HOLE CARDS ***
voSAIKXtXUUbJnds83sYfQ: folds
1ScqYmNf7/uWx1XSBgPTBw: folds
0OfLwED3kKs3FwY+JlHC0g: folds
is0C+o+4W8624tMaRmJg7A: folds
Xl+I49lxCJwPGRuegiaHoA collected $10 from pot
Xl+I49lxCJwPGRuegiaHoA: doesn't show hand
*** SUMMARY ***
Total pot $10 | Rake $0
Seat 1: is0C+o+4W8624tMaRmJg7A (small blind) folded before Flop
Seat 2: Xl+I49lxCJwPGRuegiaHoA (big blind) collected ($10)
Seat 3: voSAIKXtXUUbJnds83sYfQ folded before Flop (didn't bet)
Seat 4: 1ScqYmNf7/uWx1XSBgPTBw folded before Flop (didn't bet)
Seat 6: 0OfLwED3kKs3FwY+JlHC0g (button) folded before Flop (didn't bet)



PokerStars Game #59962929182:  Hold'em No Limit ($5/$10) - 2009/07/01 11:43:11 ET
Table '2a86NK3xhs21kwGZmbj0QA' 6-max Seat #1 is the button
Seat 1: is0C+o+4W8624tMaRmJg7A ($1000 in chips)
Seat 2: Xl+I49lxCJwPGRuegiaHoA ($3581 in chips)
Seat 3: voSAIKXtXUUbJnds83sYfQ ($1210 in chips)
Seat 4: 1ScqYmNf7/uWx1XSBgPTBw ($175.25 in chips)
Seat 6: 0OfLwED3kKs3FwY+JlHC0g ($1000 in chips)
Xl+I49lxCJwPGRuegiaHoA: posts small blind $5
voSAIKXtXUUbJnds83sYfQ: posts big blind $10
*** HOLE CARDS ***
1ScqYmNf7/uWx1XSBgPTBw: folds
0OfLwED3kKs3FwY+JlHC0g: folds
is0C+o+4W8624tMaRmJg7A: folds
Xl+I49lxCJwPGRuegiaHoA: raises $20 to $30
voSAIKXtXUUbJnds83sYfQ: calls $20
*** FLOP *** [As 3d Th]
Xl+I49lxCJwPGRuegiaHoA: checks
voSAIKXtXUUbJnds83sYfQ: checks
*** TURN *** [As 3d Th] [Ts]
Xl+I49lxCJwPGRuegiaHoA: bets $50
jkH6qYMpn8JA/IyBOhQPMw leaves the table
voSAIKXtXUUbJnds83sYfQ: calls $50
*** RIVER *** [As 3d Th Ts] [7h]
Xl+I49lxCJwPGRuegiaHoA: checks
voSAIKXtXUUbJnds83sYfQ: checks
*** SHOW DOWN ***
Xl+I49lxCJwPGRuegiaHoA: shows [8h 9c] (a pair of Tens)
voSAIKXtXUUbJnds83sYfQ: shows [7c Ac] (two pair, Aces and Tens)
voSAIKXtXUUbJnds83sYfQ collected $158 from pot
*** SUMMARY ***
Total pot $160 | Rake $2
Board [As 3d Th Ts 7h]
Seat 1: is0C+o+4W8624tMaRmJg7A (button) folded before Flop (didn't bet)
Seat 2: Xl+I49lxCJwPGRuegiaHoA (small blind) showed [8h 9c] and lost with a pair of Tens
Seat 3: voSAIKXtXUUbJnds83sYfQ (big blind) showed [7c Ac] and won ($158) with two pair, Aces and Tens
Seat 4: 1ScqYmNf7/uWx1XSBgPTBw folded before Flop (didn't bet)
Seat 6: 0OfLwED3kKs3FwY+JlHC0g folded before Flop (didn't bet)



PokerStars Game #59962931660:  Hold'em No Limit ($5/$10) - 2009/07/01 11:43:13 ET
Table 'dwLGEw3aoH/cOAI7JsLdmw' 6-max Seat #1 is the button
Seat 1: is0C+o+4W8624tMaRmJg7A ($1133 in chips)
Seat 2: 1ScqYmNf7/uWx1XSBgPTBw ($238 in chips)
Seat 3: voSAIKXtXUUbJnds83sYfQ ($1191 in chips)
Seat 4: efhcaDPhNqQ/H48kMHLa8w ($1000 in chips)
Seat 6: 3mTlg4g0FJN2bo939h/0Wg ($469.75 in chips)
1ScqYmNf7/uWx1XSBgPTBw: posts small blind $5
voSAIKXtXUUbJnds83sYfQ: posts big blind $10
*** HOLE CARDS ***
efhcaDPhNqQ/H48kMHLa8w: folds
3mTlg4g0FJN2bo939h/0Wg: folds
is0C+o+4W8624tMaRmJg7A: raises $15 to $25
1ScqYmNf7/uWx1XSBgPTBw: folds
voSAIKXtXUUbJnds83sYfQ: folds
is0C+o+4W8624tMaRmJg7A collected $25 from pot
*** SUMMARY ***
Total pot $25 | Rake $0
Seat 1: is0C+o+4W8624tMaRmJg7A (button) collected ($25)
Seat 2: 1ScqYmNf7/uWx1XSBgPTBw (small blind) folded before Flop
Seat 3: voSAIKXtXUUbJnds83sYfQ (big blind) folded before Flop
Seat 4: efhcaDPhNqQ/H48kMHLa8w folded before Flop (didn't bet)
Seat 6: 3mTlg4g0FJN2bo939h/0Wg folded before Flop (didn't bet)



PokerStars Game #59962934892:  Hold'em No Limit ($5/$10) - 2009/07/01 11:43:17 ET
Table 'AiNa6yyp/njJVRYl/Lz1KQ' 6-max Seat #5 is the button
Seat 1: KVUX8NzxJOWN94yxutATnw ($200 in chips)
Seat 2: 1s1h7qXmZxmowl9P1VNe2Q ($297 in chips)
Seat 4: /F5e5TKT/1B9kgJVuQttsg ($541.05 in chips)
Seat 5: 2PHCSXghjbGk2qR6jDFe2g ($447 in chips)
Seat 6: Xl/zzIZf2hmO234sDWM1HQ ($440.50 in chips)
Xl/zzIZf2hmO234sDWM1HQ: posts small blind $5
KVUX8NzxJOWN94yxutATnw: posts big blind $10
*** HOLE CARDS ***
1s1h7qXmZxmowl9P1VNe2Q: folds
1s1h7qXmZxmowl9P1VNe2Q leaves the table
/F5e5TKT/1B9kgJVuQttsg: folds
2PHCSXghjbGk2qR6jDFe2g: folds
Xl/zzIZf2hmO234sDWM1HQ: raises $30 to $40
KVUX8NzxJOWN94yxutATnw: calls $30
*** FLOP *** [9c Jc Qs]
0OfLwED3kKs3FwY+JlHC0g joins the table at seat #3
Xl/zzIZf2hmO234sDWM1HQ: bets $60
KVUX8NzxJOWN94yxutATnw: raises $60 to $120
Xl/zzIZf2hmO234sDWM1HQ: calls $60
*** TURN *** [9c Jc Qs] [Tc]
Xl/zzIZf2hmO234sDWM1HQ: bets $40
KVUX8NzxJOWN94yxutATnw: calls $40 and is all-in
*** RIVER *** [9c Jc Qs Tc] [2h]
*** SHOW DOWN ***
Xl/zzIZf2hmO234sDWM1HQ: shows [3s Ks] (a straight, Nine to King)
KVUX8NzxJOWN94yxutATnw: shows [9d Qh] (two pair, Queens and Nines)
7SUIdtQak1SCtldWHjwnFA joins the table at seat #2
Xl/zzIZf2hmO234sDWM1HQ collected $398 from pot
7SUIdtQak1SCtldWHjwnFA is sitting out
*** SUMMARY ***
Total pot $400 | Rake $2
Board [9c Jc Qs Tc 2h]
Seat 1: KVUX8NzxJOWN94yxutATnw (big blind) showed [9d Qh] and lost with two pair, Queens and Nines
Seat 2: 1s1h7qXmZxmowl9P1VNe2Q folded before Flop (didn't bet)
Seat 4: /F5e5TKT/1B9kgJVuQttsg folded before Flop (didn't bet)
Seat 5: 2PHCSXghjbGk2qR6jDFe2g (button) folded before Flop (didn't bet)
Seat 6: Xl/zzIZf2hmO234sDWM1HQ (small blind) showed [3s Ks] and won ($398) with a straight, Nine to King



PokerStars Game #59962943878:  Hold'em No Limit ($5/$10) - 2009/07/01 11:43:27 ET
Table 'mAacPTyMuJ4IQhEFOonFPg' 2-max Seat #2 is the button
Seat 1: XFruyoQqeueL4N+qXEkusw ($1000 in chips)
Seat 2: ezwKQeNDkLTr+c7tP2UjNw ($973 in chips)
ezwKQeNDkLTr+c7tP2UjNw: posts small blind $5
XFruyoQqeueL4N+qXEkusw: posts big blind $10
*** HOLE CARDS ***
ezwKQeNDkLTr+c7tP2UjNw: raises $20 to $30
XFruyoQqeueL4N+qXEkusw: folds
ezwKQeNDkLTr+c7tP2UjNw collected $20 from pot
ezwKQeNDkLTr+c7tP2UjNw: doesn't show hand
*** SUMMARY ***
Total pot $20 | Rake $0
Seat 1: XFruyoQqeueL4N+qXEkusw (big blind) folded before Flop
Seat 2: ezwKQeNDkLTr+c7tP2UjNw (button) (small blind) collected ($20)



PokerStars Game #59962946758:  Hold'em No Limit ($5/$10) - 2009/07/01 11:43:31 ET
Table 'AI1fZ7Tsbf9DI8mC4EWoQQ' 9-max Seat #1 is the button
Seat 1: ve1LEJosAmuFjNNCQuPnPg ($1032.50 in chips)
Seat 2: voSAIKXtXUUbJnds83sYfQ ($1162 in chips)
Seat 4: efhcaDPhNqQ/H48kMHLa8w ($1000 in chips)
Seat 5: 2PHCSXghjbGk2qR6jDFe2g ($937 in chips)
Seat 6: l9mDFuns/ycIDiFx40BMVw ($815 in chips)
Seat 7: ettgJAblGnistIlqNz4Jww ($1015 in chips)
Seat 8: UgBUE0pOJDwUdQ53XJt8MQ ($185 in chips)
Seat 9: 1s1h7qXmZxmowl9P1VNe2Q ($222 in chips)
voSAIKXtXUUbJnds83sYfQ: posts small blind $5
vM2kcH3Ff9H6Drv0NwoocA: is sitting out
efhcaDPhNqQ/H48kMHLa8w: posts big blind $10
*** HOLE CARDS ***
2PHCSXghjbGk2qR6jDFe2g: folds
vM2kcH3Ff9H6Drv0NwoocA leaves the table
l9mDFuns/ycIDiFx40BMVw: folds
ettgJAblGnistIlqNz4Jww: folds
UgBUE0pOJDwUdQ53XJt8MQ: folds
1s1h7qXmZxmowl9P1VNe2Q: folds
ve1LEJosAmuFjNNCQuPnPg: raises $10 to $20
voSAIKXtXUUbJnds83sYfQ: calls $15
ZaYCGtNHUeItoUEheoYDMw joins the table at seat #3
efhcaDPhNqQ/H48kMHLa8w: folds
*** FLOP *** [5c 6c 3h]
voSAIKXtXUUbJnds83sYfQ: checks
ve1LEJosAmuFjNNCQuPnPg: checks
*** TURN *** [5c 6c 3h] [Kh]
voSAIKXtXUUbJnds83sYfQ: bets $35
ve1LEJosAmuFjNNCQuPnPg: raises $65 to $100
voSAIKXtXUUbJnds83sYfQ: folds
ve1LEJosAmuFjNNCQuPnPg collected $117 from pot
*** SUMMARY ***
Total pot $120 | Rake $3
Board [5c 6c 3h Kh]
Seat 1: ve1LEJosAmuFjNNCQuPnPg (button) collected ($117)
Seat 2: voSAIKXtXUUbJnds83sYfQ (small blind) folded on the Turn
Seat 4: efhcaDPhNqQ/H48kMHLa8w (big blind) folded before Flop
Seat 5: 2PHCSXghjbGk2qR6jDFe2g folded before Flop (didn't bet)
Seat 6: l9mDFuns/ycIDiFx40BMVw folded before Flop (didn't bet)
Seat 7: ettgJAblGnistIlqNz4Jww folded before Flop (didn't bet)
Seat 8: UgBUE0pOJDwUdQ53XJt8MQ folded before Flop (didn't bet)
Seat 9: 1s1h7qXmZxmowl9P1VNe2Q folded before Flop (didn't bet)



PokerStars Game #59962949418:  Hold'em No Limit ($5/$10) - 2009/07/01 11:43:34 ET
Table 'mAacPTyMuJ4IQhEFOonFPg' 2-max Seat #1 is the button
Seat 1: XFruyoQqeueL4N+qXEkusw ($1000 in chips)
Seat 2: ezwKQeNDkLTr+c7tP2UjNw ($983 in chips)
XFruyoQqeueL4N+qXEkusw: posts small blind $5
ezwKQeNDkLTr+c7tP2UjNw: posts big blind $10
*** HOLE CARDS ***
XFruyoQqeueL4N+qXEkusw: folds
ezwKQeNDkLTr+c7tP2UjNw collected $10 from pot
ezwKQeNDkLTr+c7tP2UjNw: doesn't show hand
*** SUMMARY ***
Total pot $10 | Rake $0
Seat 1: XFruyoQqeueL4N+qXEkusw (button) (small blind) folded before Flop
Seat 2: ezwKQeNDkLTr+c7tP2UjNw (big blind) collected ($10)



PokerStars Game #59962950666:  Hold'em No Limit ($5/$10) - 2009/07/01 11:43:35 ET
Table 'dwLGEw3aoH/cOAI7JsLdmw' 6-max Seat #2 is the button
Seat 1: is0C+o+4W8624tMaRmJg7A ($1148 in chips)
Seat 2: 1ScqYmNf7/uWx1XSBgPTBw ($233 in chips)
Seat 3: voSAIKXtXUUbJnds83sYfQ ($1181 in chips)
Seat 4: efhcaDPhNqQ/H48kMHLa8w ($1000 in chips)
Seat 6: 3mTlg4g0FJN2bo939h/0Wg ($469.75 in chips)
voSAIKXtXUUbJnds83sYfQ: posts small blind $5
efhcaDPhNqQ/H48kMHLa8w: posts big blind $10
*** HOLE CARDS ***
3mTlg4g0FJN2bo939h/0Wg: raises $20 to $30
is0C+o+4W8624tMaRmJg7A: folds
1ScqYmNf7/uWx1XSBgPTBw: folds
jkH6qYMpn8JA/IyBOhQPMw leaves the table
UcFkfWngu95uR8Jhrj+HrQ joins the table at seat #5
voSAIKXtXUUbJnds83sYfQ: folds
efhcaDPhNqQ/H48kMHLa8w: folds
3mTlg4g0FJN2bo939h/0Wg collected $25 from pot
*** SUMMARY ***
Total pot $25 | Rake $0
Seat 1: is0C+o+4W8624tMaRmJg7A folded before Flop (didn't bet)
Seat 2: 1ScqYmNf7/uWx1XSBgPTBw (button) folded before Flop (didn't bet)
Seat 3: voSAIKXtXUUbJnds83sYfQ (small blind) folded before Flop
Seat 4: efhcaDPhNqQ/H48kMHLa8w (big blind) folded before Flop
Seat 6: 3mTlg4g0FJN2bo939h/0Wg collected ($25)



PokerStars Game #59962951114:  Hold'em No Limit ($5/$10) - 2009/07/01 11:43:36 ET
Table '1Dt9cpcLUVE6HYkx5dUEdQ' 6-max Seat #4 is the button
Seat 1: Xl+I49lxCJwPGRuegiaHoA ($1000 in chips)
Seat 2: zdS2zKkZYSRe8p+GVcXMgg ($2038.10 in chips)
Seat 3: Lne9leXjEzXWbU3BGFWsxQ ($1040 in chips)
Seat 4: voSAIKXtXUUbJnds83sYfQ ($1963.75 in chips)
Seat 6: 3mTlg4g0FJN2bo939h/0Wg ($1136.75 in chips)
3mTlg4g0FJN2bo939h/0Wg: posts small blind $5
Xl+I49lxCJwPGRuegiaHoA: posts big blind $10
*** HOLE CARDS ***
zdS2zKkZYSRe8p+GVcXMgg: calls $10
Lne9leXjEzXWbU3BGFWsxQ: raises $30 to $40
voSAIKXtXUUbJnds83sYfQ: folds
jkH6qYMpn8JA/IyBOhQPMw leaves the table
3mTlg4g0FJN2bo939h/0Wg: folds
Xl+I49lxCJwPGRuegiaHoA: folds
is0C+o+4W8624tMaRmJg7A joins the table at seat #5
zdS2zKkZYSRe8p+GVcXMgg: calls $30
*** FLOP *** [4s Kh Qh]
zdS2zKkZYSRe8p+GVcXMgg: checks
Lne9leXjEzXWbU3BGFWsxQ: checks
*** TURN *** [4s Kh Qh] [Ac]
zdS2zKkZYSRe8p+GVcXMgg: checks
Lne9leXjEzXWbU3BGFWsxQ: checks
*** RIVER *** [4s Kh Qh Ac] [Td]
zdS2zKkZYSRe8p+GVcXMgg: bets $30
Lne9leXjEzXWbU3BGFWsxQ: folds
zdS2zKkZYSRe8p+GVcXMgg collected $93 from pot
*** SUMMARY ***
Total pot $95 | Rake $2
Board [4s Kh Qh Ac Td]
Seat 1: Xl+I49lxCJwPGRuegiaHoA (big blind) folded before Flop
Seat 2: zdS2zKkZYSRe8p+GVcXMgg collected ($93)
Seat 3: Lne9leXjEzXWbU3BGFWsxQ folded on the River
Seat 4: voSAIKXtXUUbJnds83sYfQ (button) folded before Flop (didn't bet)
Seat 6: 3mTlg4g0FJN2bo939h/0Wg (small blind) folded before Flop



PokerStars Game #59962956522:  Hold'em No Limit ($5/$10) - 2009/07/01 11:43:42 ET
Table 'mAacPTyMuJ4IQhEFOonFPg' 2-max Seat #2 is the button
Seat 1: XFruyoQqeueL4N+qXEkusw ($1000 in chips)
Seat 2: ezwKQeNDkLTr+c7tP2UjNw ($988 in chips)
ezwKQeNDkLTr+c7tP2UjNw: posts small blind $5
XFruyoQqeueL4N+qXEkusw: posts big blind $10
*** HOLE CARDS ***
ezwKQeNDkLTr+c7tP2UjNw: folds
XFruyoQqeueL4N+qXEkusw collected $10 from pot
XFruyoQqeueL4N+qXEkusw: doesn't show hand
*** SUMMARY ***
Total pot $10 | Rake $0
Seat 1: XFruyoQqeueL4N+qXEkusw (big blind) collected ($10)
Seat 2: ezwKQeNDkLTr+c7tP2UjNw (button) (small blind) folded before Flop



PokerStars Game #59962961162:  Hold'em No Limit ($5/$10) - 2009/07/01 11:43:47 ET
Table 'mAacPTyMuJ4IQhEFOonFPg' 2-max Seat #1 is the button
Seat 1: XFruyoQqeueL4N+qXEkusw ($1005 in chips)
Seat 2: ezwKQeNDkLTr+c7tP2UjNw ($983 in chips)
XFruyoQqeueL4N+qXEkusw: posts small blind $5
ezwKQeNDkLTr+c7tP2UjNw: posts big blind $10
*** HOLE CARDS ***
XFruyoQqeueL4N+qXEkusw: raises $20 to $30
ezwKQeNDkLTr+c7tP2UjNw: folds
XFruyoQqeueL4N+qXEkusw collected $20 from pot
XFruyoQqeueL4N+qXEkusw: doesn't show hand
*** SUMMARY ***
Total pot $20 | Rake $0
Seat 1: XFruyoQqeueL4N+qXEkusw (button) (small blind) collected ($20)
Seat 2: ezwKQeNDkLTr+c7tP2UjNw (big blind) folded before Flop



PokerStars Game #59962968690:  Hold'em No Limit ($5/$10) - 2009/07/01 11:43:56 ET
Table 'mAacPTyMuJ4IQhEFOonFPg' 2-max Seat #2 is the button
Seat 1: XFruyoQqeueL4N+qXEkusw ($1015 in chips)
Seat 2: ezwKQeNDkLTr+c7tP2UjNw ($973 in chips)
ezwKQeNDkLTr+c7tP2UjNw: posts small blind $5
XFruyoQqeueL4N+qXEkusw: posts big blind $10
*** HOLE CARDS ***
ezwKQeNDkLTr+c7tP2UjNw: folds
XFruyoQqeueL4N+qXEkusw collected $10 from pot
XFruyoQqeueL4N+qXEkusw: doesn't show hand
*** SUMMARY ***
Total pot $10 | Rake $0
Seat 1: XFruyoQqeueL4N+qXEkusw (big blind) collected ($10)
Seat 2: ezwKQeNDkLTr+c7tP2UjNw (button) (small blind) folded before Flop



PokerStars Game #59962979772:  Hold'em No Limit ($5/$10) - 2009/07/01 11:44:08 ET
Table '2a86NK3xhs21kwGZmbj0QA' 6-max Seat #2 is the button
Seat 1: is0C+o+4W8624tMaRmJg7A ($1000 in chips)
Seat 2: Xl+I49lxCJwPGRuegiaHoA ($3501 in chips)
Seat 3: voSAIKXtXUUbJnds83sYfQ ($1288 in chips)
Seat 4: 1ScqYmNf7/uWx1XSBgPTBw ($175.25 in chips)
Seat 6: 0OfLwED3kKs3FwY+JlHC0g ($1000 in chips)
voSAIKXtXUUbJnds83sYfQ: posts small blind $5
1ScqYmNf7/uWx1XSBgPTBw: posts big blind $10
*** HOLE CARDS ***
efhcaDPhNqQ/H48kMHLa8w joins the table at seat #5
0OfLwED3kKs3FwY+JlHC0g: raises $10 to $20
is0C+o+4W8624tMaRmJg7A: calls $20
Xl+I49lxCJwPGRuegiaHoA: folds
voSAIKXtXUUbJnds83sYfQ: folds
1ScqYmNf7/uWx1XSBgPTBw: folds
*** FLOP *** [5d 5h 4c]
0OfLwED3kKs3FwY+JlHC0g: checks
is0C+o+4W8624tMaRmJg7A: bets $35
0OfLwED3kKs3FwY+JlHC0g: folds
is0C+o+4W8624tMaRmJg7A collected $53 from pot
is0C+o+4W8624tMaRmJg7A: doesn't show hand
*** SUMMARY ***
Total pot $55 | Rake $2
Board [5d 5h 4c]
Seat 1: is0C+o+4W8624tMaRmJg7A collected ($53)
Seat 2: Xl+I49lxCJwPGRuegiaHoA (button) folded before Flop (didn't bet)
Seat 3: voSAIKXtXUUbJnds83sYfQ (small blind) folded before Flop
Seat 4: 1ScqYmNf7/uWx1XSBgPTBw (big blind) folded before Flop
Seat 6: 0OfLwED3kKs3FwY+JlHC0g folded on the Flop



PokerStars Game #59962992240:  Hold'em No Limit ($5/$10) - 2009/07/01 11:44:23 ET
Table 'dwLGEw3aoH/cOAI7JsLdmw' 6-max Seat #3 is the button
Seat 1: is0C+o+4W8624tMaRmJg7A ($1148 in chips)
Seat 2: 1ScqYmNf7/uWx1XSBgPTBw ($233 in chips)
Seat 3: voSAIKXtXUUbJnds83sYfQ ($1176 in chips)
Seat 4: efhcaDPhNqQ/H48kMHLa8w ($1000 in chips)
Seat 5: UcFkfWngu95uR8Jhrj+HrQ ($200 in chips)
Seat 6: 3mTlg4g0FJN2bo939h/0Wg ($484.75 in chips)
efhcaDPhNqQ/H48kMHLa8w: posts small blind $5
UcFkfWngu95uR8Jhrj+HrQ: posts big blind $10
*** HOLE CARDS ***
3mTlg4g0FJN2bo939h/0Wg: raises $20 to $30
is0C+o+4W8624tMaRmJg7A: folds
1ScqYmNf7/uWx1XSBgPTBw: folds
voSAIKXtXUUbJnds83sYfQ: folds
efhcaDPhNqQ/H48kMHLa8w: folds
UcFkfWngu95uR8Jhrj+HrQ: folds
3mTlg4g0FJN2bo939h/0Wg collected $25 from pot
*** SUMMARY ***
Total pot $25 | Rake $0
Seat 1: is0C+o+4W8624tMaRmJg7A folded before Flop (didn't bet)
Seat 2: 1ScqYmNf7/uWx1XSBgPTBw folded before Flop (didn't bet)
Seat 3: voSAIKXtXUUbJnds83sYfQ (button) folded before Flop (didn't bet)
Seat 4: efhcaDPhNqQ/H48kMHLa8w (small blind) folded before Flop
Seat 5: UcFkfWngu95uR8Jhrj+HrQ (big blind) folded before Flop
Seat 6: 3mTlg4g0FJN2bo939h/0Wg collected ($25)



PokerStars Game #59963000486:  Hold'em No Limit ($5/$10) - 2009/07/01 11:44:32 ET
Table '1Dt9cpcLUVE6HYkx5dUEdQ' 6-max Seat #6 is the button
Seat 1: Xl+I49lxCJwPGRuegiaHoA ($1000 in chips)
Seat 2: zdS2zKkZYSRe8p+GVcXMgg ($2091.10 in chips)
Seat 3: Lne9leXjEzXWbU3BGFWsxQ ($1000 in chips)
Seat 4: voSAIKXtXUUbJnds83sYfQ ($1963.75 in chips)
Seat 6: 3mTlg4g0FJN2bo939h/0Wg ($1131.75 in chips)
Xl+I49lxCJwPGRuegiaHoA: posts small blind $5
zdS2zKkZYSRe8p+GVcXMgg: posts big blind $10
is0C+o+4W8624tMaRmJg7A: sits out
*** HOLE CARDS ***
Lne9leXjEzXWbU3BGFWsxQ: folds
voSAIKXtXUUbJnds83sYfQ: folds
3mTlg4g0FJN2bo939h/0Wg: raises $20 to $30
Xl+I49lxCJwPGRuegiaHoA: folds
zdS2zKkZYSRe8p+GVcXMgg: folds
3mTlg4g0FJN2bo939h/0Wg collected $25 from pot
*** SUMMARY ***
Total pot $25 | Rake $0
Seat 1: Xl+I49lxCJwPGRuegiaHoA (small blind) folded before Flop
Seat 2: zdS2zKkZYSRe8p+GVcXMgg (big blind) folded before Flop
Seat 3: Lne9leXjEzXWbU3BGFWsxQ folded before Flop (didn't bet)
Seat 4: voSAIKXtXUUbJnds83sYfQ folded before Flop (didn't bet)
Seat 6: 3mTlg4g0FJN2bo939h/0Wg (button) collected ($25)



PokerStars Game #59963013052:  Hold'em No Limit ($5/$10) - 2009/07/01 11:44:47 ET
Table 'AI1fZ7Tsbf9DI8mC4EWoQQ' 9-max Seat #2 is the button
Seat 1: ve1LEJosAmuFjNNCQuPnPg ($1094.50 in chips)
Seat 2: voSAIKXtXUUbJnds83sYfQ ($1107 in chips)
Seat 4: efhcaDPhNqQ/H48kMHLa8w ($1000 in chips)
Seat 5: 2PHCSXghjbGk2qR6jDFe2g ($1000 in chips)
Seat 6: l9mDFuns/ycIDiFx40BMVw ($815 in chips)
Seat 7: ettgJAblGnistIlqNz4Jww ($1015 in chips)
Seat 8: UgBUE0pOJDwUdQ53XJt8MQ ($185 in chips)
Seat 9: 1s1h7qXmZxmowl9P1VNe2Q ($222 in chips)
ZaYCGtNHUeItoUEheoYDMw will be allowed to play after the button
efhcaDPhNqQ/H48kMHLa8w: posts small blind $5
2PHCSXghjbGk2qR6jDFe2g: posts big blind $10
*** HOLE CARDS ***
l9mDFuns/ycIDiFx40BMVw: folds
ettgJAblGnistIlqNz4Jww: folds
UgBUE0pOJDwUdQ53XJt8MQ: folds
1s1h7qXmZxmowl9P1VNe2Q: folds
ve1LEJosAmuFjNNCQuPnPg: folds
voSAIKXtXUUbJnds83sYfQ: folds
efhcaDPhNqQ/H48kMHLa8w: raises $30 to $40
2PHCSXghjbGk2qR6jDFe2g: folds
efhcaDPhNqQ/H48kMHLa8w collected $20 from pot
*** SUMMARY ***
Total pot $20 | Rake $0
Seat 1: ve1LEJosAmuFjNNCQuPnPg folded before Flop (didn't bet)
Seat 2: voSAIKXtXUUbJnds83sYfQ (button) folded before Flop (didn't bet)
Seat 4: efhcaDPhNqQ/H48kMHLa8w (small blind) collected ($20)
Seat 5: 2PHCSXghjbGk2qR6jDFe2g (big blind) folded before Flop
Seat 6: l9mDFuns/ycIDiFx40BMVw folded before Flop (didn't bet)
Seat 7: ettgJAblGnistIlqNz4Jww folded before Flop (didn't bet)
Seat 8: UgBUE0pOJDwUdQ53XJt8MQ folded before Flop (didn't bet)
Seat 9: 1s1h7qXmZxmowl9P1VNe2Q folded before Flop (didn't bet)



PokerStars Game #59963015038:  Hold'em No Limit ($5/$10) - 2009/07/01 11:44:49 ET
Table '2a86NK3xhs21kwGZmbj0QA' 6-max Seat #3 is the button
Seat 1: is0C+o+4W8624tMaRmJg7A ($1033 in chips)
Seat 2: Xl+I49lxCJwPGRuegiaHoA ($3501 in chips)
Seat 3: voSAIKXtXUUbJnds83sYfQ ($1283 in chips)
Seat 4: 1ScqYmNf7/uWx1XSBgPTBw ($165.25 in chips)
Seat 5: efhcaDPhNqQ/H48kMHLa8w ($1000 in chips)
Seat 6: 0OfLwED3kKs3FwY+JlHC0g ($1000 in chips)
1ScqYmNf7/uWx1XSBgPTBw: posts small blind $5
efhcaDPhNqQ/H48kMHLa8w: posts big blind $10
*** HOLE CARDS ***
0OfLwED3kKs3FwY+JlHC0g: raises $20 to $30
is0C+o+4W8624tMaRmJg7A: raises $70 to $100
Xl+I49lxCJwPGRuegiaHoA: folds
voSAIKXtXUUbJnds83sYfQ: folds
1ScqYmNf7/uWx1XSBgPTBw: folds
efhcaDPhNqQ/H48kMHLa8w: folds
0OfLwED3kKs3FwY+JlHC0g: folds
is0C+o+4W8624tMaRmJg7A collected $75 from pot
is0C+o+4W8624tMaRmJg7A: doesn't show hand
*** SUMMARY ***
Total pot $75 | Rake $0
Seat 1: is0C+o+4W8624tMaRmJg7A collected ($75)
Seat 2: Xl+I49lxCJwPGRuegiaHoA folded before Flop (didn't bet)
Seat 3: voSAIKXtXUUbJnds83sYfQ (button) folded before Flop (didn't bet)
Seat 4: 1ScqYmNf7/uWx1XSBgPTBw (small blind) folded before Flop
Seat 5: efhcaDPhNqQ/H48kMHLa8w (big blind) folded before Flop
Seat 6: 0OfLwED3kKs3FwY+JlHC0g folded before Flop



PokerStars Game #59963015594:  Hold'em No Limit ($5/$10) - 2009/07/01 11:44:50 ET
Table 'dwLGEw3aoH/cOAI7JsLdmw' 6-max Seat #4 is the button
Seat 1: is0C+o+4W8624tMaRmJg7A ($1148 in chips)
Seat 2: 1ScqYmNf7/uWx1XSBgPTBw ($233 in chips)
Seat 3: voSAIKXtXUUbJnds83sYfQ ($1176 in chips)
Seat 4: efhcaDPhNqQ/H48kMHLa8w ($1000 in chips)
Seat 5: UcFkfWngu95uR8Jhrj+HrQ ($190 in chips)
Seat 6: 3mTlg4g0FJN2bo939h/0Wg ($499.75 in chips)
UcFkfWngu95uR8Jhrj+HrQ: posts small blind $5
3mTlg4g0FJN2bo939h/0Wg: posts big blind $10
*** HOLE CARDS ***
is0C+o+4W8624tMaRmJg7A: folds
1ScqYmNf7/uWx1XSBgPTBw: folds
voSAIKXtXUUbJnds83sYfQ: folds
efhcaDPhNqQ/H48kMHLa8w: folds
UcFkfWngu95uR8Jhrj+HrQ: raises $180 to $190 and is all-in
3mTlg4g0FJN2bo939h/0Wg: folds
UcFkfWngu95uR8Jhrj+HrQ collected $20 from pot
*** SUMMARY ***
Total pot $20 | Rake $0
Seat 1: is0C+o+4W8624tMaRmJg7A folded before Flop (didn't bet)
Seat 2: 1ScqYmNf7/uWx1XSBgPTBw folded before Flop (didn't bet)
Seat 3: voSAIKXtXUUbJnds83sYfQ folded before Flop (didn't bet)
Seat 4: efhcaDPhNqQ/H48kMHLa8w (button) folded before Flop (didn't bet)
Seat 5: UcFkfWngu95uR8Jhrj+HrQ (small blind) collected ($20)
Seat 6: 3mTlg4g0FJN2bo939h/0Wg (big blind) folded before Flop



PokerStars Game #59963027214:  Hold'em No Limit ($5/$10) - 2009/07/01 11:45:02 ET
Table '1Dt9cpcLUVE6HYkx5dUEdQ' 6-max Seat #1 is the button
Seat 1: Xl+I49lxCJwPGRuegiaHoA ($1000 in chips)
Seat 2: zdS2zKkZYSRe8p+GVcXMgg ($2081.10 in chips)
Seat 3: Lne9leXjEzXWbU3BGFWsxQ ($1000 in chips)
Seat 4: voSAIKXtXUUbJnds83sYfQ ($1963.75 in chips)
Seat 6: 3mTlg4g0FJN2bo939h/0Wg ($1146.75 in chips)
zdS2zKkZYSRe8p+GVcXMgg: posts small blind $5
Lne9leXjEzXWbU3BGFWsxQ: posts big blind $10
is0C+o+4W8624tMaRmJg7A: sits out
*** HOLE CARDS ***
voSAIKXtXUUbJnds83sYfQ: folds
3mTlg4g0FJN2bo939h/0Wg: folds
Xl+I49lxCJwPGRuegiaHoA: raises $20 to $30
zdS2zKkZYSRe8p+GVcXMgg: calls $25
Lne9leXjEzXWbU3BGFWsxQ: raises $120 to $150
Xl+I49lxCJwPGRuegiaHoA: folds
zdS2zKkZYSRe8p+GVcXMgg: folds
Lne9leXjEzXWbU3BGFWsxQ collected $90 from pot
*** SUMMARY ***
Total pot $90 | Rake $0
Seat 1: Xl+I49lxCJwPGRuegiaHoA (button) folded before Flop
Seat 2: zdS2zKkZYSRe8p+GVcXMgg (small blind) folded before Flop
Seat 3: Lne9leXjEzXWbU3BGFWsxQ (big blind) collected ($90)
Seat 4: voSAIKXtXUUbJnds83sYfQ folded before Flop (didn't bet)
Seat 6: 3mTlg4g0FJN2bo939h/0Wg folded before Flop (didn't bet)



PokerStars Game #59963048376:  Hold'em No Limit ($5/$10) - 2009/07/01 11:45:27 ET
Table 'AI1fZ7Tsbf9DI8mC4EWoQQ' 9-max Seat #4 is the button
Seat 1: ve1LEJosAmuFjNNCQuPnPg ($1094.50 in chips)
Seat 2: voSAIKXtXUUbJnds83sYfQ ($1107 in chips)
Seat 3: ZaYCGtNHUeItoUEheoYDMw ($200 in chips)
Seat 4: efhcaDPhNqQ/H48kMHLa8w ($1010 in chips)
Seat 5: 2PHCSXghjbGk2qR6jDFe2g ($990 in chips)
Seat 6: l9mDFuns/ycIDiFx40BMVw ($815 in chips)
Seat 7: ettgJAblGnistIlqNz4Jww ($1015 in chips)
Seat 8: UgBUE0pOJDwUdQ53XJt8MQ ($185 in chips)
Seat 9: 1s1h7qXmZxmowl9P1VNe2Q ($222 in chips)
2PHCSXghjbGk2qR6jDFe2g: posts small blind $5
l9mDFuns/ycIDiFx40BMVw: posts big blind $10
ZaYCGtNHUeItoUEheoYDMw: posts big blind $10
*** HOLE CARDS ***
ettgJAblGnistIlqNz4Jww: folds
UgBUE0pOJDwUdQ53XJt8MQ: folds
1s1h7qXmZxmowl9P1VNe2Q: folds
ve1LEJosAmuFjNNCQuPnPg: folds
voSAIKXtXUUbJnds83sYfQ: folds
ZaYCGtNHUeItoUEheoYDMw: raises $10 to $20
efhcaDPhNqQ/H48kMHLa8w: folds
2PHCSXghjbGk2qR6jDFe2g: folds
l9mDFuns/ycIDiFx40BMVw: folds
ZaYCGtNHUeItoUEheoYDMw collected $25 from pot
*** SUMMARY ***
Total pot $25 | Rake $0
Seat 1: ve1LEJosAmuFjNNCQuPnPg folded before Flop (didn't bet)
Seat 2: voSAIKXtXUUbJnds83sYfQ folded before Flop (didn't bet)
Seat 3: ZaYCGtNHUeItoUEheoYDMw collected ($25)
Seat 4: efhcaDPhNqQ/H48kMHLa8w (button) folded before Flop (didn't bet)
Seat 5: 2PHCSXghjbGk2qR6jDFe2g (small blind) folded before Flop
Seat 6: l9mDFuns/ycIDiFx40BMVw (big blind) folded before Flop
Seat 7: ettgJAblGnistIlqNz4Jww folded before Flop (didn't bet)
Seat 8: UgBUE0pOJDwUdQ53XJt8MQ folded before Flop (didn't bet)
Seat 9: 1s1h7qXmZxmowl9P1VNe2Q folded before Flop (didn't bet)



PokerStars Game #59963052528:  Hold'em No Limit ($5/$10) - 2009/07/01 11:45:32 ET
Table 'dwLGEw3aoH/cOAI7JsLdmw' 6-max Seat #5 is the button
Seat 2: 1ScqYmNf7/uWx1XSBgPTBw ($233 in chips)
Seat 3: voSAIKXtXUUbJnds83sYfQ ($1176 in chips)
Seat 4: efhcaDPhNqQ/H48kMHLa8w ($1000 in chips)
Seat 5: UcFkfWngu95uR8Jhrj+HrQ ($200 in chips)
Seat 6: 3mTlg4g0FJN2bo939h/0Wg ($489.75 in chips)
3mTlg4g0FJN2bo939h/0Wg: posts small blind $5
is0C+o+4W8624tMaRmJg7A: is sitting out
1ScqYmNf7/uWx1XSBgPTBw: posts big blind $10
*** HOLE CARDS ***
voSAIKXtXUUbJnds83sYfQ: folds
efhcaDPhNqQ/H48kMHLa8w: folds
UcFkfWngu95uR8Jhrj+HrQ: raises $10 to $20
3mTlg4g0FJN2bo939h/0Wg: calls $15
1ScqYmNf7/uWx1XSBgPTBw: calls $10
*** FLOP *** [Qd 8d 3c]
3mTlg4g0FJN2bo939h/0Wg: checks
1ScqYmNf7/uWx1XSBgPTBw: checks
UcFkfWngu95uR8Jhrj+HrQ: bets $40
3mTlg4g0FJN2bo939h/0Wg: folds
1ScqYmNf7/uWx1XSBgPTBw: folds
UcFkfWngu95uR8Jhrj+HrQ collected $58 from pot
UcFkfWngu95uR8Jhrj+HrQ: doesn't show hand
*** SUMMARY ***
Total pot $60 | Rake $2
Board [Qd 8d 3c]
Seat 2: 1ScqYmNf7/uWx1XSBgPTBw (big blind) folded on the Flop
Seat 3: voSAIKXtXUUbJnds83sYfQ folded before Flop (didn't bet)
Seat 4: efhcaDPhNqQ/H48kMHLa8w folded before Flop (didn't bet)
Seat 5: UcFkfWngu95uR8Jhrj+HrQ (button) collected ($58)
Seat 6: 3mTlg4g0FJN2bo939h/0Wg (small blind) folded on the Flop



PokerStars Game #59963053954:  Hold'em No Limit ($5/$10) - 2009/07/01 11:45:33 ET
Table '1Dt9cpcLUVE6HYkx5dUEdQ' 6-max Seat #2 is the button
Seat 1: Xl+I49lxCJwPGRuegiaHoA ($1000 in chips)
Seat 2: zdS2zKkZYSRe8p+GVcXMgg ($2051.10 in chips)
Seat 3: Lne9leXjEzXWbU3BGFWsxQ ($1060 in chips)
Seat 4: voSAIKXtXUUbJnds83sYfQ ($1963.75 in chips)
Seat 6: 3mTlg4g0FJN2bo939h/0Wg ($1146.75 in chips)
Lne9leXjEzXWbU3BGFWsxQ: posts small blind $5
voSAIKXtXUUbJnds83sYfQ: posts big blind $10
is0C+o+4W8624tMaRmJg7A: sits out
*** HOLE CARDS ***
3mTlg4g0FJN2bo939h/0Wg: folds
Xl+I49lxCJwPGRuegiaHoA: folds
zdS2zKkZYSRe8p+GVcXMgg: folds
Lne9leXjEzXWbU3BGFWsxQ: folds
voSAIKXtXUUbJnds83sYfQ collected $10 from pot
*** SUMMARY ***
Total pot $10 | Rake $0
Seat 1: Xl+I49lxCJwPGRuegiaHoA folded before Flop (didn't bet)
Seat 2: zdS2zKkZYSRe8p+GVcXMgg (button) folded before Flop (didn't bet)
Seat 3: Lne9leXjEzXWbU3BGFWsxQ (small blind) folded before Flop
Seat 4: voSAIKXtXUUbJnds83sYfQ (big blind) collected ($10)
Seat 6: 3mTlg4g0FJN2bo939h/0Wg folded before Flop (didn't bet)



PokerStars Game #59963064082:  Hold'em No Limit ($5/$10) - 2009/07/01 11:45:45 ET
Table '2a86NK3xhs21kwGZmbj0QA' 6-max Seat #4 is the button
Seat 1: is0C+o+4W8624tMaRmJg7A ($1078 in chips)
Seat 2: Xl+I49lxCJwPGRuegiaHoA ($3501 in chips)
Seat 3: voSAIKXtXUUbJnds83sYfQ ($1283 in chips)
Seat 4: 1ScqYmNf7/uWx1XSBgPTBw ($160.25 in chips)
Seat 5: efhcaDPhNqQ/H48kMHLa8w ($1000 in chips)
Seat 6: 0OfLwED3kKs3FwY+JlHC0g ($1000 in chips)
efhcaDPhNqQ/H48kMHLa8w: posts small blind $5
0OfLwED3kKs3FwY+JlHC0g: posts big blind $10
*** HOLE CARDS ***
is0C+o+4W8624tMaRmJg7A: folds
Xl+I49lxCJwPGRuegiaHoA: folds
voSAIKXtXUUbJnds83sYfQ: folds
1ScqYmNf7/uWx1XSBgPTBw: raises $10 to $20
efhcaDPhNqQ/H48kMHLa8w: folds
0OfLwED3kKs3FwY+JlHC0g: folds
1ScqYmNf7/uWx1XSBgPTBw collected $25 from pot
1ScqYmNf7/uWx1XSBgPTBw: doesn't show hand
*** SUMMARY ***
Total pot $25 | Rake $0
Seat 1: is0C+o+4W8624tMaRmJg7A folded before Flop (didn't bet)
Seat 2: Xl+I49lxCJwPGRuegiaHoA folded before Flop (didn't bet)
Seat 3: voSAIKXtXUUbJnds83sYfQ folded before Flop (didn't bet)
Seat 4: 1ScqYmNf7/uWx1XSBgPTBw (button) collected ($25)
Seat 5: efhcaDPhNqQ/H48kMHLa8w (small blind) folded before Flop
Seat 6: 0OfLwED3kKs3FwY+JlHC0g (big blind) folded before Flop



PokerStars Game #59963067734:  Hold'em No Limit ($5/$10) - 2009/07/01 11:45:49 ET
Table '1Dt9cpcLUVE6HYkx5dUEdQ' 6-max Seat #3 is the button
Seat 1: Xl+I49lxCJwPGRuegiaHoA ($1000 in chips)
Seat 2: zdS2zKkZYSRe8p+GVcXMgg ($2051.10 in chips)
Seat 3: Lne9leXjEzXWbU3BGFWsxQ ($1055 in chips)
Seat 4: voSAIKXtXUUbJnds83sYfQ ($1968.75 in chips)
Seat 6: 3mTlg4g0FJN2bo939h/0Wg ($1146.75 in chips)
voSAIKXtXUUbJnds83sYfQ: posts small blind $5
is0C+o+4W8624tMaRmJg7A: is sitting out
3mTlg4g0FJN2bo939h/0Wg: posts big blind $10
*** HOLE CARDS ***
Xl+I49lxCJwPGRuegiaHoA: folds
zdS2zKkZYSRe8p+GVcXMgg: folds
Lne9leXjEzXWbU3BGFWsxQ: folds
voSAIKXtXUUbJnds83sYfQ: folds
3mTlg4g0FJN2bo939h/0Wg collected $10 from pot
*** SUMMARY ***
Total pot $10 | Rake $0
Seat 1: Xl+I49lxCJwPGRuegiaHoA folded before Flop (didn't bet)
Seat 2: zdS2zKkZYSRe8p+GVcXMgg folded before Flop (didn't bet)
Seat 3: Lne9leXjEzXWbU3BGFWsxQ (button) folded before Flop (didn't bet)
Seat 4: voSAIKXtXUUbJnds83sYfQ (small blind) folded before Flop
Seat 6: 3mTlg4g0FJN2bo939h/0Wg (big blind) collected ($10)



PokerStars Game #59963081570:  Hold'em No Limit ($5/$10) - 2009/07/01 11:46:05 ET
Table '1Dt9cpcLUVE6HYkx5dUEdQ' 6-max Seat #4 is the button
Seat 1: Xl+I49lxCJwPGRuegiaHoA ($1000 in chips)
Seat 2: zdS2zKkZYSRe8p+GVcXMgg ($2051.10 in chips)
Seat 3: Lne9leXjEzXWbU3BGFWsxQ ($1055 in chips)
Seat 4: voSAIKXtXUUbJnds83sYfQ ($1963.75 in chips)
Seat 6: 3mTlg4g0FJN2bo939h/0Wg ($1151.75 in chips)
3mTlg4g0FJN2bo939h/0Wg: posts small blind $5
Xl+I49lxCJwPGRuegiaHoA: posts big blind $10
*** HOLE CARDS ***
zdS2zKkZYSRe8p+GVcXMgg: calls $10
Lne9leXjEzXWbU3BGFWsxQ: folds
voSAIKXtXUUbJnds83sYfQ: folds
3mTlg4g0FJN2bo939h/0Wg: raises $20 to $30
Xl+I49lxCJwPGRuegiaHoA: folds
zdS2zKkZYSRe8p+GVcXMgg: calls $20
*** FLOP *** [7d 6h 4c]
3mTlg4g0FJN2bo939h/0Wg: checks
zdS2zKkZYSRe8p+GVcXMgg: checks
*** TURN *** [7d 6h 4c] [9c]
3mTlg4g0FJN2bo939h/0Wg: bets $40
is0C+o+4W8624tMaRmJg7A leaves the table
zdS2zKkZYSRe8p+GVcXMgg: calls $40
*** RIVER *** [7d 6h 4c 9c] [Ac]
1ScqYmNf7/uWx1XSBgPTBw joins the table at seat #5
3mTlg4g0FJN2bo939h/0Wg: bets $100
zdS2zKkZYSRe8p+GVcXMgg: folds
3mTlg4g0FJN2bo939h/0Wg collected $148 from pot
*** SUMMARY ***
Total pot $150 | Rake $2
Board [7d 6h 4c 9c Ac]
Seat 1: Xl+I49lxCJwPGRuegiaHoA (big blind) folded before Flop
Seat 2: zdS2zKkZYSRe8p+GVcXMgg folded on the River
Seat 3: Lne9leXjEzXWbU3BGFWsxQ folded before Flop (didn't bet)
Seat 4: voSAIKXtXUUbJnds83sYfQ (button) folded before Flop (didn't bet)
Seat 6: 3mTlg4g0FJN2bo939h/0Wg (small blind) collected ($148)



PokerStars Game #59963084168:  Hold'em No Limit ($5/$10) - 2009/07/01 11:46:08 ET
Table '2a86NK3xhs21kwGZmbj0QA' 6-max Seat #5 is the button
Seat 2: Xl+I49lxCJwPGRuegiaHoA ($3501 in chips)
Seat 3: voSAIKXtXUUbJnds83sYfQ ($1283 in chips)
Seat 4: 1ScqYmNf7/uWx1XSBgPTBw ($175.25 in chips)
Seat 5: efhcaDPhNqQ/H48kMHLa8w ($1000 in chips)
Seat 6: 0OfLwED3kKs3FwY+JlHC0g ($1000 in chips)
0OfLwED3kKs3FwY+JlHC0g: posts small blind $5
is0C+o+4W8624tMaRmJg7A: is sitting out
Xl+I49lxCJwPGRuegiaHoA: posts big blind $10
*** HOLE CARDS ***
voSAIKXtXUUbJnds83sYfQ: folds
1ScqYmNf7/uWx1XSBgPTBw: folds
efhcaDPhNqQ/H48kMHLa8w: raises $10 to $20
0OfLwED3kKs3FwY+JlHC0g: folds
Xl+I49lxCJwPGRuegiaHoA: calls $10
*** FLOP *** [9h 8h 5c]
Xl+I49lxCJwPGRuegiaHoA: checks
efhcaDPhNqQ/H48kMHLa8w: checks
*** TURN *** [9h 8h 5c] [2c]
Xl+I49lxCJwPGRuegiaHoA: checks
is0C+o+4W8624tMaRmJg7A leaves the table
efhcaDPhNqQ/H48kMHLa8w: checks
*** RIVER *** [9h 8h 5c 2c] [Qs]
Xl+I49lxCJwPGRuegiaHoA: bets $35
efhcaDPhNqQ/H48kMHLa8w: raises $85 to $120
Xl+I49lxCJwPGRuegiaHoA: folds
efhcaDPhNqQ/H48kMHLa8w collected $113 from pot
efhcaDPhNqQ/H48kMHLa8w: doesn't show hand
*** SUMMARY ***
Total pot $115 | Rake $2
Board [9h 8h 5c 2c Qs]
Seat 2: Xl+I49lxCJwPGRuegiaHoA (big blind) folded on the River
Seat 3: voSAIKXtXUUbJnds83sYfQ folded before Flop (didn't bet)
Seat 4: 1ScqYmNf7/uWx1XSBgPTBw folded before Flop (didn't bet)
Seat 5: efhcaDPhNqQ/H48kMHLa8w (button) collected ($113)
Seat 6: 0OfLwED3kKs3FwY+JlHC0g (small blind) folded before Flop



PokerStars Game #59963088244:  Hold'em No Limit ($5/$10) - 2009/07/01 11:46:13 ET
Table 'AI1fZ7Tsbf9DI8mC4EWoQQ' 9-max Seat #5 is the button
Seat 1: ve1LEJosAmuFjNNCQuPnPg ($1094.50 in chips)
Seat 2: voSAIKXtXUUbJnds83sYfQ ($1107 in chips)
Seat 3: ZaYCGtNHUeItoUEheoYDMw ($215 in chips)
Seat 4: efhcaDPhNqQ/H48kMHLa8w ($1010 in chips)
Seat 5: 2PHCSXghjbGk2qR6jDFe2g ($985 in chips)
Seat 6: l9mDFuns/ycIDiFx40BMVw ($805 in chips)
Seat 7: ettgJAblGnistIlqNz4Jww ($1015 in chips)
Seat 8: UgBUE0pOJDwUdQ53XJt8MQ ($185 in chips)
Seat 9: 1s1h7qXmZxmowl9P1VNe2Q ($222 in chips)
l9mDFuns/ycIDiFx40BMVw: posts small blind $5
ettgJAblGnistIlqNz4Jww: posts big blind $10
*** HOLE CARDS ***
UgBUE0pOJDwUdQ53XJt8MQ: folds
1s1h7qXmZxmowl9P1VNe2Q: folds
ve1LEJosAmuFjNNCQuPnPg: folds
voSAIKXtXUUbJnds83sYfQ: folds
ZaYCGtNHUeItoUEheoYDMw: folds
efhcaDPhNqQ/H48kMHLa8w: folds
2PHCSXghjbGk2qR6jDFe2g: folds
l9mDFuns/ycIDiFx40BMVw: raises $30 to $40
ettgJAblGnistIlqNz4Jww: folds
l9mDFuns/ycIDiFx40BMVw collected $20 from pot
*** SUMMARY ***
Total pot $20 | Rake $0
Seat 1: ve1LEJosAmuFjNNCQuPnPg folded before Flop (didn't bet)
Seat 2: voSAIKXtXUUbJnds83sYfQ folded before Flop (didn't bet)
Seat 3: ZaYCGtNHUeItoUEheoYDMw folded before Flop (didn't bet)
Seat 4: efhcaDPhNqQ/H48kMHLa8w folded before Flop (didn't bet)
Seat 5: 2PHCSXghjbGk2qR6jDFe2g (button) folded before Flop (didn't bet)
Seat 6: l9mDFuns/ycIDiFx40BMVw (small blind) collected ($20)
Seat 7: ettgJAblGnistIlqNz4Jww (big blind) folded before Flop
Seat 8: UgBUE0pOJDwUdQ53XJt8MQ folded before Flop (didn't bet)
Seat 9: 1s1h7qXmZxmowl9P1VNe2Q folded before Flop (didn't bet)



PokerStars Game #59963096488:  Hold'em No Limit ($5/$10) - 2009/07/01 11:46:22 ET
Table 'dwLGEw3aoH/cOAI7JsLdmw' 6-max Seat #6 is the button
Seat 2: 1ScqYmNf7/uWx1XSBgPTBw ($213 in chips)
Seat 3: voSAIKXtXUUbJnds83sYfQ ($1176 in chips)
Seat 4: efhcaDPhNqQ/H48kMHLa8w ($1000 in chips)
Seat 5: UcFkfWngu95uR8Jhrj+HrQ ($238 in chips)
Seat 6: 3mTlg4g0FJN2bo939h/0Wg ($469.75 in chips)
1ScqYmNf7/uWx1XSBgPTBw: posts small blind $5
voSAIKXtXUUbJnds83sYfQ: posts big blind $10
*** HOLE CARDS ***
efhcaDPhNqQ/H48kMHLa8w: folds
UcFkfWngu95uR8Jhrj+HrQ: folds
3mTlg4g0FJN2bo939h/0Wg: raises $20 to $30
1ScqYmNf7/uWx1XSBgPTBw: folds
voSAIKXtXUUbJnds83sYfQ: calls $20
*** FLOP *** [6c 7d Jc]
voSAIKXtXUUbJnds83sYfQ: checks
3mTlg4g0FJN2bo939h/0Wg: checks
*** TURN *** [6c 7d Jc] [Jh]
voSAIKXtXUUbJnds83sYfQ: checks
3mTlg4g0FJN2bo939h/0Wg: bets $30
voSAIKXtXUUbJnds83sYfQ: folds
is0C+o+4W8624tMaRmJg7A leaves the table
3mTlg4g0FJN2bo939h/0Wg collected $63 from pot
*** SUMMARY ***
Total pot $65 | Rake $2
Board [6c 7d Jc Jh]
Seat 2: 1ScqYmNf7/uWx1XSBgPTBw (small blind) folded before Flop
Seat 3: voSAIKXtXUUbJnds83sYfQ (big blind) folded on the Turn
Seat 4: efhcaDPhNqQ/H48kMHLa8w folded before Flop (didn't bet)
Seat 5: UcFkfWngu95uR8Jhrj+HrQ folded before Flop (didn't bet)
Seat 6: 3mTlg4g0FJN2bo939h/0Wg (button) collected ($63)



PokerStars Game #59963128048:  Hold'em No Limit ($5/$10) - 2009/07/01 11:46:58 ET
Table 'dwLGEw3aoH/cOAI7JsLdmw' 6-max Seat #2 is the button
Seat 2: 1ScqYmNf7/uWx1XSBgPTBw ($208 in chips)
Seat 3: voSAIKXtXUUbJnds83sYfQ ($1146 in chips)
Seat 4: efhcaDPhNqQ/H48kMHLa8w ($1000 in chips)
Seat 5: UcFkfWngu95uR8Jhrj+HrQ ($238 in chips)
Seat 6: 3mTlg4g0FJN2bo939h/0Wg ($502.75 in chips)
voSAIKXtXUUbJnds83sYfQ: posts small blind $5
efhcaDPhNqQ/H48kMHLa8w: posts big blind $10
*** HOLE CARDS ***
UcFkfWngu95uR8Jhrj+HrQ: folds
3mTlg4g0FJN2bo939h/0Wg: raises $20 to $30
1ScqYmNf7/uWx1XSBgPTBw: folds
voSAIKXtXUUbJnds83sYfQ: folds
efhcaDPhNqQ/H48kMHLa8w: folds
3mTlg4g0FJN2bo939h/0Wg collected $25 from pot
*** SUMMARY ***
Total pot $25 | Rake $0
Seat 2: 1ScqYmNf7/uWx1XSBgPTBw (button) folded before Flop (didn't bet)
Seat 3: voSAIKXtXUUbJnds83sYfQ (small blind) folded before Flop
Seat 4: efhcaDPhNqQ/H48kMHLa8w (big blind) folded before Flop
Seat 5: UcFkfWngu95uR8Jhrj+HrQ folded before Flop (didn't bet)
Seat 6: 3mTlg4g0FJN2bo939h/0Wg collected ($25)



PokerStars Game #59963129518:  Hold'em No Limit ($5/$10) - 2009/07/01 11:46:59 ET
Table 'AI1fZ7Tsbf9DI8mC4EWoQQ' 9-max Seat #6 is the button
Seat 1: ve1LEJosAmuFjNNCQuPnPg ($1094.50 in chips)
Seat 2: voSAIKXtXUUbJnds83sYfQ ($1107 in chips)
Seat 3: ZaYCGtNHUeItoUEheoYDMw ($215 in chips)
Seat 4: efhcaDPhNqQ/H48kMHLa8w ($1010 in chips)
Seat 5: 2PHCSXghjbGk2qR6jDFe2g ($985 in chips)
Seat 6: l9mDFuns/ycIDiFx40BMVw ($815 in chips)
Seat 7: ettgJAblGnistIlqNz4Jww ($1005 in chips)
Seat 8: UgBUE0pOJDwUdQ53XJt8MQ ($185 in chips)
Seat 9: 1s1h7qXmZxmowl9P1VNe2Q ($222 in chips)
ettgJAblGnistIlqNz4Jww: posts small blind $5
UgBUE0pOJDwUdQ53XJt8MQ: posts big blind $10
*** HOLE CARDS ***
1s1h7qXmZxmowl9P1VNe2Q: raises $10 to $20
ve1LEJosAmuFjNNCQuPnPg: folds
voSAIKXtXUUbJnds83sYfQ: folds
ZaYCGtNHUeItoUEheoYDMw: folds
efhcaDPhNqQ/H48kMHLa8w: folds
2PHCSXghjbGk2qR6jDFe2g: folds
l9mDFuns/ycIDiFx40BMVw: folds
ettgJAblGnistIlqNz4Jww: folds
UgBUE0pOJDwUdQ53XJt8MQ: calls $10
*** FLOP *** [Jd 2d Qd]
UgBUE0pOJDwUdQ53XJt8MQ: checks
1s1h7qXmZxmowl9P1VNe2Q: bets $20
UgBUE0pOJDwUdQ53XJt8MQ: folds
1s1h7qXmZxmowl9P1VNe2Q collected $42.75 from pot
*** SUMMARY ***
Total pot $45 | Rake $2.25
Board [Jd 2d Qd]
Seat 1: ve1LEJosAmuFjNNCQuPnPg folded before Flop (didn't bet)
Seat 2: voSAIKXtXUUbJnds83sYfQ folded before Flop (didn't bet)
Seat 3: ZaYCGtNHUeItoUEheoYDMw folded before Flop (didn't bet)
Seat 4: efhcaDPhNqQ/H48kMHLa8w folded before Flop (didn't bet)
Seat 5: 2PHCSXghjbGk2qR6jDFe2g folded before Flop (didn't bet)
Seat 6: l9mDFuns/ycIDiFx40BMVw (button) folded before Flop (didn't bet)
Seat 7: ettgJAblGnistIlqNz4Jww (small blind) folded before Flop
Seat 8: UgBUE0pOJDwUdQ53XJt8MQ (big blind) folded on the Flop
Seat 9: 1s1h7qXmZxmowl9P1VNe2Q collected ($42.75)



PokerStars Game #59963147222:  Hold'em No Limit ($5/$10) - 2009/07/01 11:47:20 ET
Table '1Dt9cpcLUVE6HYkx5dUEdQ' 6-max Seat #6 is the button
Seat 1: Xl+I49lxCJwPGRuegiaHoA ($1000 in chips)
Seat 2: zdS2zKkZYSRe8p+GVcXMgg ($1981.10 in chips)
Seat 3: Lne9leXjEzXWbU3BGFWsxQ ($1055 in chips)
Seat 4: voSAIKXtXUUbJnds83sYfQ ($1963.75 in chips)
Seat 6: 3mTlg4g0FJN2bo939h/0Wg ($1229.75 in chips)
Xl+I49lxCJwPGRuegiaHoA: posts small blind $5
zdS2zKkZYSRe8p+GVcXMgg: posts big blind $10
1ScqYmNf7/uWx1XSBgPTBw: sits out
*** HOLE CARDS ***
Lne9leXjEzXWbU3BGFWsxQ: raises $20 to $30
voSAIKXtXUUbJnds83sYfQ: raises $70 to $100
3mTlg4g0FJN2bo939h/0Wg: folds
Xl+I49lxCJwPGRuegiaHoA: folds
zdS2zKkZYSRe8p+GVcXMgg: folds
Lne9leXjEzXWbU3BGFWsxQ: raises $150 to $250
voSAIKXtXUUbJnds83sYfQ: folds
Lne9leXjEzXWbU3BGFWsxQ collected $215 from pot
*** SUMMARY ***
Total pot $215 | Rake $0
Seat 1: Xl+I49lxCJwPGRuegiaHoA (small blind) folded before Flop
Seat 2: zdS2zKkZYSRe8p+GVcXMgg (big blind) folded before Flop
Seat 3: Lne9leXjEzXWbU3BGFWsxQ collected ($215)
Seat 4: voSAIKXtXUUbJnds83sYfQ folded before Flop
Seat 6: 3mTlg4g0FJN2bo939h/0Wg (button) folded before Flop (didn't bet)



PokerStars Game #59963151594:  Hold'em No Limit ($5/$10) - 2009/07/01 11:47:24 ET
Table 'dwLGEw3aoH/cOAI7JsLdmw' 6-max Seat #3 is the button
Seat 2: 1ScqYmNf7/uWx1XSBgPTBw ($208 in chips)
Seat 3: voSAIKXtXUUbJnds83sYfQ ($1141 in chips)
Seat 4: efhcaDPhNqQ/H48kMHLa8w ($1000 in chips)
Seat 6: 3mTlg4g0FJN2bo939h/0Wg ($517.75 in chips)
efhcaDPhNqQ/H48kMHLa8w: posts small blind $5
UcFkfWngu95uR8Jhrj+HrQ: is sitting out
UcFkfWngu95uR8Jhrj+HrQ leaves the table
3mTlg4g0FJN2bo939h/0Wg: posts big blind $10
*** HOLE CARDS ***
nCI/286bRXONuVN/6Bn49Q joins the table at seat #1
1ScqYmNf7/uWx1XSBgPTBw: folds
voSAIKXtXUUbJnds83sYfQ: raises $20 to $30
efhcaDPhNqQ/H48kMHLa8w: folds
3mTlg4g0FJN2bo939h/0Wg: calls $20
*** FLOP *** [7c Qc Tc]
3mTlg4g0FJN2bo939h/0Wg: bets $30
voSAIKXtXUUbJnds83sYfQ: calls $30
*** TURN *** [7c Qc Tc] [3h]
3mTlg4g0FJN2bo939h/0Wg: bets $50
Razed&Cnfusd joins the table at seat #5
voSAIKXtXUUbJnds83sYfQ: raises $100 to $150
3mTlg4g0FJN2bo939h/0Wg: calls $100
*** RIVER *** [7c Qc Tc 3h] [4h]
3mTlg4g0FJN2bo939h/0Wg: bets $100
voSAIKXtXUUbJnds83sYfQ: raises $250 to $350
3mTlg4g0FJN2bo939h/0Wg: calls $207.75 and is all-in
*** SHOW DOWN ***
voSAIKXtXUUbJnds83sYfQ: shows [Jc Ac] (a flush, Ace high)
3mTlg4g0FJN2bo939h/0Wg: mucks hand
voSAIKXtXUUbJnds83sYfQ collected $1038.50 from pot
*** SUMMARY ***
Total pot $1040.50 | Rake $2
Board [7c Qc Tc 3h 4h]
Seat 2: 1ScqYmNf7/uWx1XSBgPTBw folded before Flop (didn't bet)
Seat 3: voSAIKXtXUUbJnds83sYfQ (button) showed [Jc Ac] and won ($1038.50) with a flush, Ace high
Seat 4: efhcaDPhNqQ/H48kMHLa8w (small blind) folded before Flop
Seat 6: 3mTlg4g0FJN2bo939h/0Wg (big blind) mucked



PokerStars Game #59963153680:  Hold'em No Limit ($5/$10) - 2009/07/01 11:47:27 ET
Table '2a86NK3xhs21kwGZmbj0QA' 6-max Seat #6 is the button
Seat 2: Xl+I49lxCJwPGRuegiaHoA ($3446 in chips)
Seat 3: voSAIKXtXUUbJnds83sYfQ ($1283 in chips)
Seat 4: 1ScqYmNf7/uWx1XSBgPTBw ($175.25 in chips)
Seat 5: efhcaDPhNqQ/H48kMHLa8w ($1058 in chips)
Seat 6: 0OfLwED3kKs3FwY+JlHC0g ($1000 in chips)
Xl+I49lxCJwPGRuegiaHoA: posts small blind $5
voSAIKXtXUUbJnds83sYfQ: posts big blind $10
*** HOLE CARDS ***
1ScqYmNf7/uWx1XSBgPTBw: raises $10 to $20
efhcaDPhNqQ/H48kMHLa8w: folds
0OfLwED3kKs3FwY+JlHC0g: folds
Xl+I49lxCJwPGRuegiaHoA: folds
UcFkfWngu95uR8Jhrj+HrQ joins the table at seat #1
voSAIKXtXUUbJnds83sYfQ: folds
1ScqYmNf7/uWx1XSBgPTBw collected $25 from pot
1ScqYmNf7/uWx1XSBgPTBw: doesn't show hand
*** SUMMARY ***
Total pot $25 | Rake $0
Seat 2: Xl+I49lxCJwPGRuegiaHoA (small blind) folded before Flop
Seat 3: voSAIKXtXUUbJnds83sYfQ (big blind) folded before Flop
Seat 4: 1ScqYmNf7/uWx1XSBgPTBw collected ($25)
Seat 5: efhcaDPhNqQ/H48kMHLa8w folded before Flop (didn't bet)
Seat 6: 0OfLwED3kKs3FwY+JlHC0g (button) folded before Flop (didn't bet)



PokerStars Game #59963174338:  Hold'em No Limit ($5/$10) - 2009/07/01 11:47:51 ET
Table '2a86NK3xhs21kwGZmbj0QA' 6-max Seat #2 is the button
Seat 2: Xl+I49lxCJwPGRuegiaHoA ($3441 in chips)
Seat 3: voSAIKXtXUUbJnds83sYfQ ($1273 in chips)
Seat 4: 1ScqYmNf7/uWx1XSBgPTBw ($190.25 in chips)
Seat 5: efhcaDPhNqQ/H48kMHLa8w ($1058 in chips)
Seat 6: 0OfLwED3kKs3FwY+JlHC0g ($1000 in chips)
voSAIKXtXUUbJnds83sYfQ: posts small blind $5
1ScqYmNf7/uWx1XSBgPTBw: posts big blind $10
UcFkfWngu95uR8Jhrj+HrQ: sits out
*** HOLE CARDS ***
efhcaDPhNqQ/H48kMHLa8w: raises $20 to $30
0OfLwED3kKs3FwY+JlHC0g: folds
Xl+I49lxCJwPGRuegiaHoA: folds
voSAIKXtXUUbJnds83sYfQ: calls $25
1ScqYmNf7/uWx1XSBgPTBw: folds
*** FLOP *** [6c 4s 2c]
voSAIKXtXUUbJnds83sYfQ: checks
efhcaDPhNqQ/H48kMHLa8w: checks
*** TURN *** [6c 4s 2c] [2d]
voSAIKXtXUUbJnds83sYfQ: bets $50
efhcaDPhNqQ/H48kMHLa8w: folds
voSAIKXtXUUbJnds83sYfQ collected $68 from pot
voSAIKXtXUUbJnds83sYfQ: doesn't show hand
*** SUMMARY ***
Total pot $70 | Rake $2
Board [6c 4s 2c 2d]
Seat 2: Xl+I49lxCJwPGRuegiaHoA (button) folded before Flop (didn't bet)
Seat 3: voSAIKXtXUUbJnds83sYfQ (small blind) collected ($68)
Seat 4: 1ScqYmNf7/uWx1XSBgPTBw (big blind) folded before Flop
Seat 5: efhcaDPhNqQ/H48kMHLa8w folded on the Turn
Seat 6: 0OfLwED3kKs3FwY+JlHC0g folded before Flop (didn't bet)



PokerStars Game #59963177746:  Hold'em No Limit ($5/$10) - 2009/07/01 11:47:54 ET
Table 'AI1fZ7Tsbf9DI8mC4EWoQQ' 9-max Seat #7 is the button
Seat 1: ve1LEJosAmuFjNNCQuPnPg ($1094.50 in chips)
Seat 2: voSAIKXtXUUbJnds83sYfQ ($1107 in chips)
Seat 3: ZaYCGtNHUeItoUEheoYDMw ($215 in chips)
Seat 4: efhcaDPhNqQ/H48kMHLa8w ($1010 in chips)
Seat 5: 2PHCSXghjbGk2qR6jDFe2g ($985 in chips)
Seat 6: l9mDFuns/ycIDiFx40BMVw ($815 in chips)
Seat 7: ettgJAblGnistIlqNz4Jww ($1000 in chips)
Seat 8: UgBUE0pOJDwUdQ53XJt8MQ ($165 in chips)
Seat 9: 1s1h7qXmZxmowl9P1VNe2Q ($244.75 in chips)
UgBUE0pOJDwUdQ53XJt8MQ: posts small blind $5
1s1h7qXmZxmowl9P1VNe2Q: posts big blind $10
*** HOLE CARDS ***
ve1LEJosAmuFjNNCQuPnPg: folds
voSAIKXtXUUbJnds83sYfQ: folds
ZaYCGtNHUeItoUEheoYDMw: folds
efhcaDPhNqQ/H48kMHLa8w: folds
2PHCSXghjbGk2qR6jDFe2g: folds
l9mDFuns/ycIDiFx40BMVw: raises $20 to $30
ettgJAblGnistIlqNz4Jww: folds
UgBUE0pOJDwUdQ53XJt8MQ: folds
1s1h7qXmZxmowl9P1VNe2Q: folds
l9mDFuns/ycIDiFx40BMVw collected $25 from pot
*** SUMMARY ***
Total pot $25 | Rake $0
Seat 1: ve1LEJosAmuFjNNCQuPnPg folded before Flop (didn't bet)
Seat 2: voSAIKXtXUUbJnds83sYfQ folded before Flop (didn't bet)
Seat 3: ZaYCGtNHUeItoUEheoYDMw folded before Flop (didn't bet)
Seat 4: efhcaDPhNqQ/H48kMHLa8w folded before Flop (didn't bet)
Seat 5: 2PHCSXghjbGk2qR6jDFe2g folded before Flop (didn't bet)
Seat 6: l9mDFuns/ycIDiFx40BMVw collected ($25)
Seat 7: ettgJAblGnistIlqNz4Jww (button) folded before Flop (didn't bet)
Seat 8: UgBUE0pOJDwUdQ53XJt8MQ (small blind) folded before Flop
Seat 9: 1s1h7qXmZxmowl9P1VNe2Q (big blind) folded before Flop



PokerStars Game #59963183246:  Hold'em No Limit ($5/$10) - 2009/07/01 11:48:01 ET
Table '1Dt9cpcLUVE6HYkx5dUEdQ' 6-max Seat #1 is the button
Seat 1: Xl+I49lxCJwPGRuegiaHoA ($1000 in chips)
Seat 2: zdS2zKkZYSRe8p+GVcXMgg ($1971.10 in chips)
Seat 3: Lne9leXjEzXWbU3BGFWsxQ ($1170 in chips)
Seat 4: voSAIKXtXUUbJnds83sYfQ ($1863.75 in chips)
Seat 6: 3mTlg4g0FJN2bo939h/0Wg ($1229.75 in chips)
zdS2zKkZYSRe8p+GVcXMgg: posts small blind $5
Lne9leXjEzXWbU3BGFWsxQ: posts big blind $10
1ScqYmNf7/uWx1XSBgPTBw: sits out
*** HOLE CARDS ***
voSAIKXtXUUbJnds83sYfQ: folds
3mTlg4g0FJN2bo939h/0Wg: folds
Xl+I49lxCJwPGRuegiaHoA: raises $20 to $30
zdS2zKkZYSRe8p+GVcXMgg: calls $25
Lne9leXjEzXWbU3BGFWsxQ: raises $120 to $150
Xl+I49lxCJwPGRuegiaHoA: folds
zdS2zKkZYSRe8p+GVcXMgg: folds
Lne9leXjEzXWbU3BGFWsxQ collected $90 from pot
*** SUMMARY ***
Total pot $90 | Rake $0
Seat 1: Xl+I49lxCJwPGRuegiaHoA (button) folded before Flop
Seat 2: zdS2zKkZYSRe8p+GVcXMgg (small blind) folded before Flop
Seat 3: Lne9leXjEzXWbU3BGFWsxQ (big blind) collected ($90)
Seat 4: voSAIKXtXUUbJnds83sYfQ folded before Flop (didn't bet)
Seat 6: 3mTlg4g0FJN2bo939h/0Wg folded before Flop (didn't bet)



PokerStars Game #59963211946:  Hold'em No Limit ($5/$10) - 2009/07/01 11:48:34 ET
Table '1Dt9cpcLUVE6HYkx5dUEdQ' 6-max Seat #2 is the button
Seat 1: Xl+I49lxCJwPGRuegiaHoA ($1000 in chips)
Seat 2: zdS2zKkZYSRe8p+GVcXMgg ($1941.10 in chips)
Seat 3: Lne9leXjEzXWbU3BGFWsxQ ($1230 in chips)
Seat 4: voSAIKXtXUUbJnds83sYfQ ($1863.75 in chips)
Seat 6: 3mTlg4g0FJN2bo939h/0Wg ($1229.75 in chips)
Lne9leXjEzXWbU3BGFWsxQ: posts small blind $5
voSAIKXtXUUbJnds83sYfQ: posts big blind $10
1ScqYmNf7/uWx1XSBgPTBw: sits out
*** HOLE CARDS ***
3mTlg4g0FJN2bo939h/0Wg: folds
Xl+I49lxCJwPGRuegiaHoA: folds
zdS2zKkZYSRe8p+GVcXMgg: folds
Lne9leXjEzXWbU3BGFWsxQ: folds
voSAIKXtXUUbJnds83sYfQ collected $10 from pot
*** SUMMARY ***
Total pot $10 | Rake $0
Seat 1: Xl+I49lxCJwPGRuegiaHoA folded before Flop (didn't bet)
Seat 2: zdS2zKkZYSRe8p+GVcXMgg (button) folded before Flop (didn't bet)
Seat 3: Lne9leXjEzXWbU3BGFWsxQ (small blind) folded before Flop
Seat 4: voSAIKXtXUUbJnds83sYfQ (big blind) collected ($10)
Seat 6: 3mTlg4g0FJN2bo939h/0Wg folded before Flop (didn't bet)



PokerStars Game #59963219122:  Hold'em No Limit ($5/$10) - 2009/07/01 11:48:42 ET
Table 'AI1fZ7Tsbf9DI8mC4EWoQQ' 9-max Seat #8 is the button
Seat 1: ve1LEJosAmuFjNNCQuPnPg ($1094.50 in chips)
Seat 2: voSAIKXtXUUbJnds83sYfQ ($1107 in chips)
Seat 3: ZaYCGtNHUeItoUEheoYDMw ($215 in chips)
Seat 4: efhcaDPhNqQ/H48kMHLa8w ($1010 in chips)
Seat 5: 2PHCSXghjbGk2qR6jDFe2g ($985 in chips)
Seat 6: l9mDFuns/ycIDiFx40BMVw ($830 in chips)
Seat 7: ettgJAblGnistIlqNz4Jww ($1000 in chips)
Seat 8: UgBUE0pOJDwUdQ53XJt8MQ ($160 in chips)
Seat 9: 1s1h7qXmZxmowl9P1VNe2Q ($234.75 in chips)
1s1h7qXmZxmowl9P1VNe2Q: posts small blind $5
ve1LEJosAmuFjNNCQuPnPg: posts big blind $10
*** HOLE CARDS ***
voSAIKXtXUUbJnds83sYfQ: folds
ZaYCGtNHUeItoUEheoYDMw: folds
efhcaDPhNqQ/H48kMHLa8w: folds
2PHCSXghjbGk2qR6jDFe2g: folds
l9mDFuns/ycIDiFx40BMVw: folds
ettgJAblGnistIlqNz4Jww: folds
UgBUE0pOJDwUdQ53XJt8MQ: folds
1s1h7qXmZxmowl9P1VNe2Q: folds
ve1LEJosAmuFjNNCQuPnPg collected $10 from pot
*** SUMMARY ***
Total pot $10 | Rake $0
Seat 1: ve1LEJosAmuFjNNCQuPnPg (big blind) collected ($10)
Seat 2: voSAIKXtXUUbJnds83sYfQ folded before Flop (didn't bet)
Seat 3: ZaYCGtNHUeItoUEheoYDMw folded before Flop (didn't bet)
Seat 4: efhcaDPhNqQ/H48kMHLa8w folded before Flop (didn't bet)
Seat 5: 2PHCSXghjbGk2qR6jDFe2g folded before Flop (didn't bet)
Seat 6: l9mDFuns/ycIDiFx40BMVw folded before Flop (didn't bet)
Seat 7: ettgJAblGnistIlqNz4Jww folded before Flop (didn't bet)
Seat 8: UgBUE0pOJDwUdQ53XJt8MQ (button) folded before Flop (didn't bet)
Seat 9: 1s1h7qXmZxmowl9P1VNe2Q (small blind) folded before Flop



PokerStars Game #59963230202:  Hold'em No Limit ($5/$10) - 2009/07/01 11:48:55 ET
Table '2a86NK3xhs21kwGZmbj0QA' 6-max Seat #3 is the button
Seat 2: Xl+I49lxCJwPGRuegiaHoA ($3441 in chips)
Seat 3: voSAIKXtXUUbJnds83sYfQ ($1311 in chips)
Seat 4: 1ScqYmNf7/uWx1XSBgPTBw ($180.25 in chips)
Seat 5: efhcaDPhNqQ/H48kMHLa8w ($1028 in chips)
Seat 6: 0OfLwED3kKs3FwY+JlHC0g ($1000 in chips)
1ScqYmNf7/uWx1XSBgPTBw: posts small blind $5
efhcaDPhNqQ/H48kMHLa8w: posts big blind $10
UcFkfWngu95uR8Jhrj+HrQ: sits out
*** HOLE CARDS ***
0OfLwED3kKs3FwY+JlHC0g: folds
Xl+I49lxCJwPGRuegiaHoA: folds
voSAIKXtXUUbJnds83sYfQ: folds
1ScqYmNf7/uWx1XSBgPTBw: folds
efhcaDPhNqQ/H48kMHLa8w collected $10 from pot
efhcaDPhNqQ/H48kMHLa8w: doesn't show hand
*** SUMMARY ***
Total pot $10 | Rake $0
Seat 2: Xl+I49lxCJwPGRuegiaHoA folded before Flop (didn't bet)
Seat 3: voSAIKXtXUUbJnds83sYfQ (button) folded before Flop (didn't bet)
Seat 4: 1ScqYmNf7/uWx1XSBgPTBw (small blind) folded before Flop
Seat 5: efhcaDPhNqQ/H48kMHLa8w (big blind) collected ($10)
Seat 6: 0OfLwED3kKs3FwY+JlHC0g folded before Flop (didn't bet)



PokerStars Game #59963234972:  Hold'em No Limit ($5/$10) - 2009/07/01 11:49:00 ET
Table '1Dt9cpcLUVE6HYkx5dUEdQ' 6-max Seat #3 is the button
Seat 1: Xl+I49lxCJwPGRuegiaHoA ($1000 in chips)
Seat 2: zdS2zKkZYSRe8p+GVcXMgg ($1941.10 in chips)
Seat 3: Lne9leXjEzXWbU3BGFWsxQ ($1225 in chips)
Seat 4: voSAIKXtXUUbJnds83sYfQ ($1868.75 in chips)
Seat 5: 1ScqYmNf7/uWx1XSBgPTBw ($200 in chips)
Seat 6: 3mTlg4g0FJN2bo939h/0Wg ($1229.75 in chips)
voSAIKXtXUUbJnds83sYfQ: posts small blind $5
1ScqYmNf7/uWx1XSBgPTBw: posts big blind $10
*** HOLE CARDS ***
3mTlg4g0FJN2bo939h/0Wg: folds
3mTlg4g0FJN2bo939h/0Wg leaves the table
Xl+I49lxCJwPGRuegiaHoA: folds
zdS2zKkZYSRe8p+GVcXMgg: folds
Lne9leXjEzXWbU3BGFWsxQ: raises $20 to $30
voSAIKXtXUUbJnds83sYfQ: folds
1ScqYmNf7/uWx1XSBgPTBw: folds
efhcaDPhNqQ/H48kMHLa8w joins the table at seat #6
Lne9leXjEzXWbU3BGFWsxQ collected $25 from pot
*** SUMMARY ***
Total pot $25 | Rake $0
Seat 1: Xl+I49lxCJwPGRuegiaHoA folded before Flop (didn't bet)
Seat 2: zdS2zKkZYSRe8p+GVcXMgg folded before Flop (didn't bet)
Seat 3: Lne9leXjEzXWbU3BGFWsxQ (button) collected ($25)
Seat 4: voSAIKXtXUUbJnds83sYfQ (small blind) folded before Flop
Seat 5: 1ScqYmNf7/uWx1XSBgPTBw (big blind) folded before Flop
Seat 6: 3mTlg4g0FJN2bo939h/0Wg folded before Flop (didn't bet)



PokerStars Game #59963244396:  Hold'em No Limit ($5/$10) - 2009/07/01 11:49:11 ET
Table '2a86NK3xhs21kwGZmbj0QA' 6-max Seat #4 is the button
Seat 2: Xl+I49lxCJwPGRuegiaHoA ($3441 in chips)
Seat 3: voSAIKXtXUUbJnds83sYfQ ($1311 in chips)
Seat 4: 1ScqYmNf7/uWx1XSBgPTBw ($175.25 in chips)
Seat 5: efhcaDPhNqQ/H48kMHLa8w ($1033 in chips)
Seat 6: 0OfLwED3kKs3FwY+JlHC0g ($1000 in chips)
efhcaDPhNqQ/H48kMHLa8w: posts small blind $5
0OfLwED3kKs3FwY+JlHC0g: posts big blind $10
UcFkfWngu95uR8Jhrj+HrQ: sits out
*** HOLE CARDS ***
Xl+I49lxCJwPGRuegiaHoA: folds
voSAIKXtXUUbJnds83sYfQ: folds
1ScqYmNf7/uWx1XSBgPTBw: folds
efhcaDPhNqQ/H48kMHLa8w: folds
0OfLwED3kKs3FwY+JlHC0g collected $10 from pot
0OfLwED3kKs3FwY+JlHC0g: doesn't show hand
*** SUMMARY ***
Total pot $10 | Rake $0
Seat 2: Xl+I49lxCJwPGRuegiaHoA folded before Flop (didn't bet)
Seat 3: voSAIKXtXUUbJnds83sYfQ folded before Flop (didn't bet)
Seat 4: 1ScqYmNf7/uWx1XSBgPTBw (button) folded before Flop (didn't bet)
Seat 5: efhcaDPhNqQ/H48kMHLa8w (small blind) folded before Flop
Seat 6: 0OfLwED3kKs3FwY+JlHC0g (big blind) collected ($10)



PokerStars Game #59963245060:  Hold'em No Limit ($5/$10) - 2009/07/01 11:49:12 ET
Table 'AI1fZ7Tsbf9DI8mC4EWoQQ' 9-max Seat #9 is the button
Seat 1: ve1LEJosAmuFjNNCQuPnPg ($1099.50 in chips)
Seat 2: voSAIKXtXUUbJnds83sYfQ ($1107 in chips)
Seat 3: ZaYCGtNHUeItoUEheoYDMw ($215 in chips)
Seat 4: efhcaDPhNqQ/H48kMHLa8w ($1010 in chips)
Seat 5: 2PHCSXghjbGk2qR6jDFe2g ($985 in chips)
Seat 6: l9mDFuns/ycIDiFx40BMVw ($830 in chips)
Seat 7: ettgJAblGnistIlqNz4Jww ($1000 in chips)
Seat 8: UgBUE0pOJDwUdQ53XJt8MQ ($160 in chips)
Seat 9: 1s1h7qXmZxmowl9P1VNe2Q ($229.75 in chips)
ve1LEJosAmuFjNNCQuPnPg: posts small blind $5
voSAIKXtXUUbJnds83sYfQ: posts big blind $10
*** HOLE CARDS ***
ZaYCGtNHUeItoUEheoYDMw: folds
efhcaDPhNqQ/H48kMHLa8w: folds
2PHCSXghjbGk2qR6jDFe2g: folds
l9mDFuns/ycIDiFx40BMVw: folds
ettgJAblGnistIlqNz4Jww: raises $20 to $30
UgBUE0pOJDwUdQ53XJt8MQ: folds
1s1h7qXmZxmowl9P1VNe2Q: folds
ve1LEJosAmuFjNNCQuPnPg: folds
voSAIKXtXUUbJnds83sYfQ: folds
ettgJAblGnistIlqNz4Jww collected $25 from pot
ettgJAblGnistIlqNz4Jww: doesn't show hand
*** SUMMARY ***
Total pot $25 | Rake $0
Seat 1: ve1LEJosAmuFjNNCQuPnPg (small blind) folded before Flop
Seat 2: voSAIKXtXUUbJnds83sYfQ (big blind) folded before Flop
Seat 3: ZaYCGtNHUeItoUEheoYDMw folded before Flop (didn't bet)
Seat 4: efhcaDPhNqQ/H48kMHLa8w folded before Flop (didn't bet)
Seat 5: 2PHCSXghjbGk2qR6jDFe2g folded before Flop (didn't bet)
Seat 6: l9mDFuns/ycIDiFx40BMVw folded before Flop (didn't bet)
Seat 7: ettgJAblGnistIlqNz4Jww collected ($25)
Seat 8: UgBUE0pOJDwUdQ53XJt8MQ folded before Flop (didn't bet)
Seat 9: 1s1h7qXmZxmowl9P1VNe2Q (button) folded before Flop (didn't bet)



PokerStars Game #59963254612:  Hold'em No Limit ($5/$10) - 2009/07/01 11:49:23 ET
Table '1Dt9cpcLUVE6HYkx5dUEdQ' 6-max Seat #4 is the button
Seat 1: Xl+I49lxCJwPGRuegiaHoA ($1000 in chips)
Seat 2: zdS2zKkZYSRe8p+GVcXMgg ($1941.10 in chips)
Seat 3: Lne9leXjEzXWbU3BGFWsxQ ($1240 in chips)
Seat 4: voSAIKXtXUUbJnds83sYfQ ($1863.75 in chips)
Seat 5: 1ScqYmNf7/uWx1XSBgPTBw ($190 in chips)
Seat 6: efhcaDPhNqQ/H48kMHLa8w ($1000 in chips)
1ScqYmNf7/uWx1XSBgPTBw: posts small blind $5
efhcaDPhNqQ/H48kMHLa8w: posts big blind $10
*** HOLE CARDS ***
Xl+I49lxCJwPGRuegiaHoA: folds
zdS2zKkZYSRe8p+GVcXMgg: calls $10
Lne9leXjEzXWbU3BGFWsxQ: folds
voSAIKXtXUUbJnds83sYfQ: raises $30 to $40
1ScqYmNf7/uWx1XSBgPTBw: folds
efhcaDPhNqQ/H48kMHLa8w: folds
zdS2zKkZYSRe8p+GVcXMgg: calls $30
*** FLOP *** [Kd 7d 2c]
zdS2zKkZYSRe8p+GVcXMgg: checks
voSAIKXtXUUbJnds83sYfQ: bets $70
zdS2zKkZYSRe8p+GVcXMgg: calls $70
*** TURN *** [Kd 7d 2c] [Td]
zdS2zKkZYSRe8p+GVcXMgg: bets $125
voSAIKXtXUUbJnds83sYfQ: folds
zdS2zKkZYSRe8p+GVcXMgg collected $232 from pot
*** SUMMARY ***
Total pot $235 | Rake $3
Board [Kd 7d 2c Td]
Seat 1: Xl+I49lxCJwPGRuegiaHoA folded before Flop (didn't bet)
Seat 2: zdS2zKkZYSRe8p+GVcXMgg collected ($232)
Seat 3: Lne9leXjEzXWbU3BGFWsxQ folded before Flop (didn't bet)
Seat 4: voSAIKXtXUUbJnds83sYfQ (button) folded on the Turn
Seat 5: 1ScqYmNf7/uWx1XSBgPTBw (small blind) folded before Flop
Seat 6: efhcaDPhNqQ/H48kMHLa8w (big blind) folded before Flop



PokerStars Game #59963261956:  Hold'em No Limit ($5/$10) - 2009/07/01 11:49:31 ET
Table '2a86NK3xhs21kwGZmbj0QA' 6-max Seat #5 is the button
Seat 1: UcFkfWngu95uR8Jhrj+HrQ ($200 in chips)
Seat 2: Xl+I49lxCJwPGRuegiaHoA ($3441 in chips)
Seat 3: voSAIKXtXUUbJnds83sYfQ ($1311 in chips)
Seat 4: 1ScqYmNf7/uWx1XSBgPTBw ($175.25 in chips)
Seat 5: efhcaDPhNqQ/H48kMHLa8w ($1028 in chips)
Seat 6: 0OfLwED3kKs3FwY+JlHC0g ($1005 in chips)
0OfLwED3kKs3FwY+JlHC0g: posts small blind $5
UcFkfWngu95uR8Jhrj+HrQ: posts big blind $10
*** HOLE CARDS ***
Xl+I49lxCJwPGRuegiaHoA: folds
voSAIKXtXUUbJnds83sYfQ: folds
1ScqYmNf7/uWx1XSBgPTBw: raises $10 to $20
efhcaDPhNqQ/H48kMHLa8w: folds
0OfLwED3kKs3FwY+JlHC0g: folds
UcFkfWngu95uR8Jhrj+HrQ: calls $10
*** FLOP *** [3h 6d Qs]
UcFkfWngu95uR8Jhrj+HrQ: bets $10
1ScqYmNf7/uWx1XSBgPTBw: raises $20 to $30
UcFkfWngu95uR8Jhrj+HrQ: folds
1ScqYmNf7/uWx1XSBgPTBw collected $62 from pot
1ScqYmNf7/uWx1XSBgPTBw: doesn't show hand
*** SUMMARY ***
Total pot $65 | Rake $3
Board [3h 6d Qs]
Seat 1: UcFkfWngu95uR8Jhrj+HrQ (big blind) folded on the Flop
Seat 2: Xl+I49lxCJwPGRuegiaHoA folded before Flop (didn't bet)
Seat 3: voSAIKXtXUUbJnds83sYfQ folded before Flop (didn't bet)
Seat 4: 1ScqYmNf7/uWx1XSBgPTBw collected ($62)
Seat 5: efhcaDPhNqQ/H48kMHLa8w (button) folded before Flop (didn't bet)
Seat 6: 0OfLwED3kKs3FwY+JlHC0g (small blind) folded before Flop



PokerStars Game #59963285662:  Hold'em No Limit ($5/$10) - 2009/07/01 11:49:58 ET
Table '2a86NK3xhs21kwGZmbj0QA' 6-max Seat #6 is the button
Seat 1: UcFkfWngu95uR8Jhrj+HrQ ($170 in chips)
Seat 2: Xl+I49lxCJwPGRuegiaHoA ($3441 in chips)
Seat 3: voSAIKXtXUUbJnds83sYfQ ($1311 in chips)
Seat 4: 1ScqYmNf7/uWx1XSBgPTBw ($207.25 in chips)
Seat 5: efhcaDPhNqQ/H48kMHLa8w ($1028 in chips)
Seat 6: 0OfLwED3kKs3FwY+JlHC0g ($1000 in chips)
UcFkfWngu95uR8Jhrj+HrQ: posts small blind $5
Xl+I49lxCJwPGRuegiaHoA: posts big blind $10
*** HOLE CARDS ***
voSAIKXtXUUbJnds83sYfQ: folds
1ScqYmNf7/uWx1XSBgPTBw: folds
efhcaDPhNqQ/H48kMHLa8w: folds
0OfLwED3kKs3FwY+JlHC0g: folds
UcFkfWngu95uR8Jhrj+HrQ: folds
Xl+I49lxCJwPGRuegiaHoA collected $10 from pot
Xl+I49lxCJwPGRuegiaHoA: doesn't show hand
*** SUMMARY ***
Total pot $10 | Rake $0
Seat 1: UcFkfWngu95uR8Jhrj+HrQ (small blind) folded before Flop
Seat 2: Xl+I49lxCJwPGRuegiaHoA (big blind) collected ($10)
Seat 3: voSAIKXtXUUbJnds83sYfQ folded before Flop (didn't bet)
Seat 4: 1ScqYmNf7/uWx1XSBgPTBw folded before Flop (didn't bet)
Seat 5: efhcaDPhNqQ/H48kMHLa8w folded before Flop (didn't bet)
Seat 6: 0OfLwED3kKs3FwY+JlHC0g (button) folded before Flop (didn't bet)



PokerStars Game #59963287502:  Hold'em No Limit ($5/$10) - 2009/07/01 11:50:00 ET
Table 'AI1fZ7Tsbf9DI8mC4EWoQQ' 9-max Seat #1 is the button
Seat 1: ve1LEJosAmuFjNNCQuPnPg ($1094.50 in chips)
Seat 2: voSAIKXtXUUbJnds83sYfQ ($1097 in chips)
Seat 3: ZaYCGtNHUeItoUEheoYDMw ($215 in chips)
Seat 4: efhcaDPhNqQ/H48kMHLa8w ($1010 in chips)
Seat 5: 2PHCSXghjbGk2qR6jDFe2g ($985 in chips)
Seat 6: l9mDFuns/ycIDiFx40BMVw ($830 in chips)
Seat 7: ettgJAblGnistIlqNz4Jww ($1015 in chips)
Seat 8: UgBUE0pOJDwUdQ53XJt8MQ ($160 in chips)
Seat 9: 1s1h7qXmZxmowl9P1VNe2Q ($229.75 in chips)
voSAIKXtXUUbJnds83sYfQ: posts small blind $5
ZaYCGtNHUeItoUEheoYDMw: posts big blind $10
*** HOLE CARDS ***
efhcaDPhNqQ/H48kMHLa8w: folds
2PHCSXghjbGk2qR6jDFe2g: folds
l9mDFuns/ycIDiFx40BMVw: folds
ettgJAblGnistIlqNz4Jww: folds
UgBUE0pOJDwUdQ53XJt8MQ: folds
1s1h7qXmZxmowl9P1VNe2Q: folds
ve1LEJosAmuFjNNCQuPnPg: raises $10 to $20
voSAIKXtXUUbJnds83sYfQ: folds
ZaYCGtNHUeItoUEheoYDMw: calls $10
*** FLOP *** [8c Js Qs]
ZaYCGtNHUeItoUEheoYDMw: checks
ve1LEJosAmuFjNNCQuPnPg: bets $30
ZaYCGtNHUeItoUEheoYDMw: folds
ve1LEJosAmuFjNNCQuPnPg collected $42.75 from pot
*** SUMMARY ***
Total pot $45 | Rake $2.25
Board [8c Js Qs]
Seat 1: ve1LEJosAmuFjNNCQuPnPg (button) collected ($42.75)
Seat 2: voSAIKXtXUUbJnds83sYfQ (small blind) folded before Flop
Seat 3: ZaYCGtNHUeItoUEheoYDMw (big blind) folded on the Flop
Seat 4: efhcaDPhNqQ/H48kMHLa8w folded before Flop (didn't bet)
Seat 5: 2PHCSXghjbGk2qR6jDFe2g folded before Flop (didn't bet)
Seat 6: l9mDFuns/ycIDiFx40BMVw folded before Flop (didn't bet)
Seat 7: ettgJAblGnistIlqNz4Jww folded before Flop (didn't bet)
Seat 8: UgBUE0pOJDwUdQ53XJt8MQ folded before Flop (didn't bet)
Seat 9: 1s1h7qXmZxmowl9P1VNe2Q folded before Flop (didn't bet)



PokerStars Game #59963304580:  Hold'em No Limit ($5/$10) - 2009/07/01 11:50:19 ET
Table '1Dt9cpcLUVE6HYkx5dUEdQ' 6-max Seat #5 is the button
Seat 1: Xl+I49lxCJwPGRuegiaHoA ($1000 in chips)
Seat 2: zdS2zKkZYSRe8p+GVcXMgg ($2063.10 in chips)
Seat 3: Lne9leXjEzXWbU3BGFWsxQ ($1240 in chips)
Seat 4: voSAIKXtXUUbJnds83sYfQ ($1753.75 in chips)
Seat 5: 1ScqYmNf7/uWx1XSBgPTBw ($185 in chips)
Seat 6: efhcaDPhNqQ/H48kMHLa8w ($1000 in chips)
efhcaDPhNqQ/H48kMHLa8w: posts small blind $5
Xl+I49lxCJwPGRuegiaHoA: posts big blind $10
*** HOLE CARDS ***
zdS2zKkZYSRe8p+GVcXMgg: folds
Lne9leXjEzXWbU3BGFWsxQ: folds
voSAIKXtXUUbJnds83sYfQ: folds
1ScqYmNf7/uWx1XSBgPTBw: folds
efhcaDPhNqQ/H48kMHLa8w: raises $30 to $40
Xl+I49lxCJwPGRuegiaHoA: raises $80 to $120
efhcaDPhNqQ/H48kMHLa8w: calls $80
*** FLOP *** [4h 7d 5h]
efhcaDPhNqQ/H48kMHLa8w: bets $150
Xl+I49lxCJwPGRuegiaHoA: raises $150 to $300
efhcaDPhNqQ/H48kMHLa8w: raises $580 to $880 and is all-in
Xl+I49lxCJwPGRuegiaHoA: calls $580 and is all-in
*** TURN *** [4h 7d 5h] [6d]
*** RIVER *** [4h 7d 5h 6d] [6s]
*** SHOW DOWN ***
efhcaDPhNqQ/H48kMHLa8w: shows [8c 7c] (a straight, Four to Eight)
Xl+I49lxCJwPGRuegiaHoA: mucks hand
efhcaDPhNqQ/H48kMHLa8w collected $1997 from pot
*** SUMMARY ***
Total pot $2000 | Rake $3
Board [4h 7d 5h 6d 6s]
Seat 1: Xl+I49lxCJwPGRuegiaHoA (big blind) mucked
Seat 2: zdS2zKkZYSRe8p+GVcXMgg folded before Flop (didn't bet)
Seat 3: Lne9leXjEzXWbU3BGFWsxQ folded before Flop (didn't bet)
Seat 4: voSAIKXtXUUbJnds83sYfQ folded before Flop (didn't bet)
Seat 5: 1ScqYmNf7/uWx1XSBgPTBw (button) folded before Flop (didn't bet)
Seat 6: efhcaDPhNqQ/H48kMHLa8w (small blind) showed [8c 7c] and won ($1997) with a straight, Four to Eight



PokerStars Game #59963387926:  Hold'em No Limit ($5/$10) - 2009/07/01 11:51:53 ET
Table '1Dt9cpcLUVE6HYkx5dUEdQ' 6-max Seat #6 is the button
Seat 1: Xl+I49lxCJwPGRuegiaHoA ($1000 in chips)
Seat 2: zdS2zKkZYSRe8p+GVcXMgg ($2063.10 in chips)
Seat 3: Lne9leXjEzXWbU3BGFWsxQ ($1240 in chips)
Seat 4: voSAIKXtXUUbJnds83sYfQ ($1753.75 in chips)
Seat 5: 1ScqYmNf7/uWx1XSBgPTBw ($185 in chips)
Seat 6: efhcaDPhNqQ/H48kMHLa8w ($1997 in chips)
Xl+I49lxCJwPGRuegiaHoA: posts small blind $5
zdS2zKkZYSRe8p+GVcXMgg: posts big blind $10
*** HOLE CARDS ***
Lne9leXjEzXWbU3BGFWsxQ: folds
voSAIKXtXUUbJnds83sYfQ: folds
1ScqYmNf7/uWx1XSBgPTBw: folds
efhcaDPhNqQ/H48kMHLa8w: raises $10 to $20
Xl+I49lxCJwPGRuegiaHoA: raises $60 to $80
zdS2zKkZYSRe8p+GVcXMgg: folds
efhcaDPhNqQ/H48kMHLa8w: folds
Xl+I49lxCJwPGRuegiaHoA collected $50 from pot
*** SUMMARY ***
Total pot $50 | Rake $0
Seat 1: Xl+I49lxCJwPGRuegiaHoA (small blind) collected ($50)
Seat 2: zdS2zKkZYSRe8p+GVcXMgg (big blind) folded before Flop
Seat 3: Lne9leXjEzXWbU3BGFWsxQ folded before Flop (didn't bet)
Seat 4: voSAIKXtXUUbJnds83sYfQ folded before Flop (didn't bet)
Seat 5: 1ScqYmNf7/uWx1XSBgPTBw folded before Flop (didn't bet)
Seat 6: efhcaDPhNqQ/H48kMHLa8w (button) folded before Flop



PokerStars Game #59963389662:  Hold'em No Limit ($5/$10) - 2009/07/01 11:51:55 ET
Table 'AI1fZ7Tsbf9DI8mC4EWoQQ' 9-max Seat #2 is the button
Seat 1: ve1LEJosAmuFjNNCQuPnPg ($1117.25 in chips)
Seat 2: voSAIKXtXUUbJnds83sYfQ ($1092 in chips)
Seat 3: ZaYCGtNHUeItoUEheoYDMw ($195 in chips)
Seat 4: efhcaDPhNqQ/H48kMHLa8w ($1010 in chips)
Seat 5: 2PHCSXghjbGk2qR6jDFe2g ($985 in chips)
Seat 6: l9mDFuns/ycIDiFx40BMVw ($830 in chips)
Seat 7: ettgJAblGnistIlqNz4Jww ($1015 in chips)
Seat 8: UgBUE0pOJDwUdQ53XJt8MQ ($160 in chips)
Seat 9: 1s1h7qXmZxmowl9P1VNe2Q ($229.75 in chips)
ZaYCGtNHUeItoUEheoYDMw: posts small blind $5
efhcaDPhNqQ/H48kMHLa8w: posts big blind $10
*** HOLE CARDS ***
2PHCSXghjbGk2qR6jDFe2g: folds
l9mDFuns/ycIDiFx40BMVw: folds
ettgJAblGnistIlqNz4Jww: folds
UgBUE0pOJDwUdQ53XJt8MQ: folds
1s1h7qXmZxmowl9P1VNe2Q: folds
ve1LEJosAmuFjNNCQuPnPg: folds
voSAIKXtXUUbJnds83sYfQ: folds
ZaYCGtNHUeItoUEheoYDMw: folds
efhcaDPhNqQ/H48kMHLa8w collected $10 from pot
*** SUMMARY ***
Total pot $10 | Rake $0
Seat 1: ve1LEJosAmuFjNNCQuPnPg folded before Flop (didn't bet)
Seat 2: voSAIKXtXUUbJnds83sYfQ (button) folded before Flop (didn't bet)
Seat 3: ZaYCGtNHUeItoUEheoYDMw (small blind) folded before Flop
Seat 4: efhcaDPhNqQ/H48kMHLa8w (big blind) collected ($10)
Seat 5: 2PHCSXghjbGk2qR6jDFe2g folded before Flop (didn't bet)
Seat 6: l9mDFuns/ycIDiFx40BMVw folded before Flop (didn't bet)
Seat 7: ettgJAblGnistIlqNz4Jww folded before Flop (didn't bet)
Seat 8: UgBUE0pOJDwUdQ53XJt8MQ folded before Flop (didn't bet)
Seat 9: 1s1h7qXmZxmowl9P1VNe2Q folded before Flop (didn't bet)



PokerStars Game #59963419866:  Hold'em No Limit ($5/$10) - 2009/07/01 11:52:29 ET
Table 'AI1fZ7Tsbf9DI8mC4EWoQQ' 9-max Seat #3 is the button
Seat 1: ve1LEJosAmuFjNNCQuPnPg ($1117.25 in chips)
Seat 2: voSAIKXtXUUbJnds83sYfQ ($1092 in chips)
Seat 3: ZaYCGtNHUeItoUEheoYDMw ($190 in chips)
Seat 4: efhcaDPhNqQ/H48kMHLa8w ($1015 in chips)
Seat 5: 2PHCSXghjbGk2qR6jDFe2g ($985 in chips)
Seat 6: l9mDFuns/ycIDiFx40BMVw ($830 in chips)
Seat 7: ettgJAblGnistIlqNz4Jww ($1015 in chips)
Seat 8: UgBUE0pOJDwUdQ53XJt8MQ ($160 in chips)
Seat 9: 1s1h7qXmZxmowl9P1VNe2Q ($229.75 in chips)
efhcaDPhNqQ/H48kMHLa8w: posts small blind $5
2PHCSXghjbGk2qR6jDFe2g: posts big blind $10
*** HOLE CARDS ***
l9mDFuns/ycIDiFx40BMVw: folds
ettgJAblGnistIlqNz4Jww: folds
UgBUE0pOJDwUdQ53XJt8MQ: folds
1s1h7qXmZxmowl9P1VNe2Q: raises $10 to $20
ve1LEJosAmuFjNNCQuPnPg: folds
voSAIKXtXUUbJnds83sYfQ: folds
ZaYCGtNHUeItoUEheoYDMw: folds
efhcaDPhNqQ/H48kMHLa8w: folds
2PHCSXghjbGk2qR6jDFe2g: calls $10
*** FLOP *** [3h Qs 3s]
2PHCSXghjbGk2qR6jDFe2g: checks
1s1h7qXmZxmowl9P1VNe2Q: bets $20
2PHCSXghjbGk2qR6jDFe2g: raises $20 to $40
1s1h7qXmZxmowl9P1VNe2Q: calls $20
*** TURN *** [3h Qs 3s] [4c]
2PHCSXghjbGk2qR6jDFe2g: bets $60
1s1h7qXmZxmowl9P1VNe2Q: folds
2PHCSXghjbGk2qR6jDFe2g collected $122 from pot
*** SUMMARY ***
Total pot $125 | Rake $3
Board [3h Qs 3s 4c]
Seat 1: ve1LEJosAmuFjNNCQuPnPg folded before Flop (didn't bet)
Seat 2: voSAIKXtXUUbJnds83sYfQ folded before Flop (didn't bet)
Seat 3: ZaYCGtNHUeItoUEheoYDMw (button) folded before Flop (didn't bet)
Seat 4: efhcaDPhNqQ/H48kMHLa8w (small blind) folded before Flop
Seat 5: 2PHCSXghjbGk2qR6jDFe2g (big blind) collected ($122)
Seat 6: l9mDFuns/ycIDiFx40BMVw folded before Flop (didn't bet)
Seat 7: ettgJAblGnistIlqNz4Jww folded before Flop (didn't bet)
Seat 8: UgBUE0pOJDwUdQ53XJt8MQ folded before Flop (didn't bet)
Seat 9: 1s1h7qXmZxmowl9P1VNe2Q folded on the Turn



PokerStars Game #59963421592:  Hold'em No Limit ($5/$10) - 2009/07/01 11:52:31 ET
Table '1Dt9cpcLUVE6HYkx5dUEdQ' 6-max Seat #1 is the button
Seat 1: Xl+I49lxCJwPGRuegiaHoA ($1030 in chips)
Seat 2: zdS2zKkZYSRe8p+GVcXMgg ($2053.10 in chips)
Seat 3: Lne9leXjEzXWbU3BGFWsxQ ($1240 in chips)
Seat 4: voSAIKXtXUUbJnds83sYfQ ($1753.75 in chips)
Seat 5: 1ScqYmNf7/uWx1XSBgPTBw ($185 in chips)
Seat 6: efhcaDPhNqQ/H48kMHLa8w ($1977 in chips)
zdS2zKkZYSRe8p+GVcXMgg: posts small blind $5
Lne9leXjEzXWbU3BGFWsxQ: posts big blind $10
*** HOLE CARDS ***
voSAIKXtXUUbJnds83sYfQ: folds
1ScqYmNf7/uWx1XSBgPTBw: folds
efhcaDPhNqQ/H48kMHLa8w: folds
Xl+I49lxCJwPGRuegiaHoA: folds
zdS2zKkZYSRe8p+GVcXMgg: calls $5
Lne9leXjEzXWbU3BGFWsxQ: raises $30 to $40
zdS2zKkZYSRe8p+GVcXMgg: calls $30
*** FLOP *** [4d 3h 3c]
zdS2zKkZYSRe8p+GVcXMgg: checks
Lne9leXjEzXWbU3BGFWsxQ: bets $50
zdS2zKkZYSRe8p+GVcXMgg: folds
Lne9leXjEzXWbU3BGFWsxQ collected $77 from pot
*** SUMMARY ***
Total pot $80 | Rake $3
Board [4d 3h 3c]
Seat 1: Xl+I49lxCJwPGRuegiaHoA (button) folded before Flop (didn't bet)
Seat 2: zdS2zKkZYSRe8p+GVcXMgg (small blind) folded on the Flop
Seat 3: Lne9leXjEzXWbU3BGFWsxQ (big blind) collected ($77)
Seat 4: voSAIKXtXUUbJnds83sYfQ folded before Flop (didn't bet)
Seat 5: 1ScqYmNf7/uWx1XSBgPTBw folded before Flop (didn't bet)
Seat 6: efhcaDPhNqQ/H48kMHLa8w folded before Flop (didn't bet)



PokerStars Game #59963496994:  Hold'em No Limit ($5/$10) - 2009/07/01 11:53:56 ET
Table 'AI1fZ7Tsbf9DI8mC4EWoQQ' 9-max Seat #4 is the button
Seat 1: ve1LEJosAmuFjNNCQuPnPg ($1117.25 in chips)
Seat 2: voSAIKXtXUUbJnds83sYfQ ($1092 in chips)
Seat 3: ZaYCGtNHUeItoUEheoYDMw ($190 in chips)
Seat 4: efhcaDPhNqQ/H48kMHLa8w ($1010 in chips)
Seat 5: 2PHCSXghjbGk2qR6jDFe2g ($1047 in chips)
Seat 6: l9mDFuns/ycIDiFx40BMVw ($830 in chips)
Seat 7: ettgJAblGnistIlqNz4Jww ($1015 in chips)
Seat 8: UgBUE0pOJDwUdQ53XJt8MQ ($160 in chips)
Seat 9: 1s1h7qXmZxmowl9P1VNe2Q ($169.75 in chips)
2PHCSXghjbGk2qR6jDFe2g: posts small blind $5
l9mDFuns/ycIDiFx40BMVw: posts big blind $10
*** HOLE CARDS ***
ettgJAblGnistIlqNz4Jww: folds
UgBUE0pOJDwUdQ53XJt8MQ: folds
1s1h7qXmZxmowl9P1VNe2Q: raises $10 to $20
ve1LEJosAmuFjNNCQuPnPg: folds
voSAIKXtXUUbJnds83sYfQ: folds
ZaYCGtNHUeItoUEheoYDMw: folds
efhcaDPhNqQ/H48kMHLa8w: folds
2PHCSXghjbGk2qR6jDFe2g: folds
l9mDFuns/ycIDiFx40BMVw: folds
1s1h7qXmZxmowl9P1VNe2Q collected $25 from pot
*** SUMMARY ***
Total pot $25 | Rake $0
Seat 1: ve1LEJosAmuFjNNCQuPnPg folded before Flop (didn't bet)
Seat 2: voSAIKXtXUUbJnds83sYfQ folded before Flop (didn't bet)
Seat 3: ZaYCGtNHUeItoUEheoYDMw folded before Flop (didn't bet)
Seat 4: efhcaDPhNqQ/H48kMHLa8w (button) folded before Flop (didn't bet)
Seat 5: 2PHCSXghjbGk2qR6jDFe2g (small blind) folded before Flop
Seat 6: l9mDFuns/ycIDiFx40BMVw (big blind) folded before Flop
Seat 7: ettgJAblGnistIlqNz4Jww folded before Flop (didn't bet)
Seat 8: UgBUE0pOJDwUdQ53XJt8MQ folded before Flop (didn't bet)
Seat 9: 1s1h7qXmZxmowl9P1VNe2Q collected ($25)



PokerStars Game #59963506788:  Hold'em No Limit ($5/$10) - 2009/07/01 11:54:07 ET
Table '1Dt9cpcLUVE6HYkx5dUEdQ' 6-max Seat #2 is the button
Seat 1: Xl+I49lxCJwPGRuegiaHoA ($1030 in chips)
Seat 2: zdS2zKkZYSRe8p+GVcXMgg ($2013.10 in chips)
Seat 3: Lne9leXjEzXWbU3BGFWsxQ ($1277 in chips)
Seat 4: voSAIKXtXUUbJnds83sYfQ ($1753.75 in chips)
Seat 5: 1ScqYmNf7/uWx1XSBgPTBw ($185 in chips)
Seat 6: efhcaDPhNqQ/H48kMHLa8w ($1977 in chips)
Lne9leXjEzXWbU3BGFWsxQ: posts small blind $5
voSAIKXtXUUbJnds83sYfQ: posts big blind $10
*** HOLE CARDS ***
1ScqYmNf7/uWx1XSBgPTBw: raises $10 to $20
efhcaDPhNqQ/H48kMHLa8w: folds
Xl+I49lxCJwPGRuegiaHoA: folds
zdS2zKkZYSRe8p+GVcXMgg: folds
Lne9leXjEzXWbU3BGFWsxQ: folds
voSAIKXtXUUbJnds83sYfQ: folds
1ScqYmNf7/uWx1XSBgPTBw collected $25 from pot
*** SUMMARY ***
Total pot $25 | Rake $0
Seat 1: Xl+I49lxCJwPGRuegiaHoA folded before Flop (didn't bet)
Seat 2: zdS2zKkZYSRe8p+GVcXMgg (button) folded before Flop (didn't bet)
Seat 3: Lne9leXjEzXWbU3BGFWsxQ (small blind) folded before Flop
Seat 4: voSAIKXtXUUbJnds83sYfQ (big blind) folded before Flop
Seat 5: 1ScqYmNf7/uWx1XSBgPTBw collected ($25)
Seat 6: efhcaDPhNqQ/H48kMHLa8w folded before Flop (didn't bet)



PokerStars Game #59963522648:  Hold'em No Limit ($5/$10) - 2009/07/01 11:54:25 ET
Table '1Dt9cpcLUVE6HYkx5dUEdQ' 6-max Seat #3 is the button
Seat 1: Xl+I49lxCJwPGRuegiaHoA ($1030 in chips)
Seat 2: zdS2zKkZYSRe8p+GVcXMgg ($2013.10 in chips)
Seat 3: Lne9leXjEzXWbU3BGFWsxQ ($1272 in chips)
Seat 4: voSAIKXtXUUbJnds83sYfQ ($1743.75 in chips)
Seat 5: 1ScqYmNf7/uWx1XSBgPTBw ($200 in chips)
Seat 6: efhcaDPhNqQ/H48kMHLa8w ($1977 in chips)
voSAIKXtXUUbJnds83sYfQ: posts small blind $5
1ScqYmNf7/uWx1XSBgPTBw: posts big blind $10
*** HOLE CARDS ***
efhcaDPhNqQ/H48kMHLa8w: raises $20 to $30
Xl+I49lxCJwPGRuegiaHoA: folds
zdS2zKkZYSRe8p+GVcXMgg: folds
Lne9leXjEzXWbU3BGFWsxQ: folds
voSAIKXtXUUbJnds83sYfQ: folds
1ScqYmNf7/uWx1XSBgPTBw: folds
efhcaDPhNqQ/H48kMHLa8w collected $25 from pot
*** SUMMARY ***
Total pot $25 | Rake $0
Seat 1: Xl+I49lxCJwPGRuegiaHoA folded before Flop (didn't bet)
Seat 2: zdS2zKkZYSRe8p+GVcXMgg folded before Flop (didn't bet)
Seat 3: Lne9leXjEzXWbU3BGFWsxQ (button) folded before Flop (didn't bet)
Seat 4: voSAIKXtXUUbJnds83sYfQ (small blind) folded before Flop
Seat 5: 1ScqYmNf7/uWx1XSBgPTBw (big blind) folded before Flop
Seat 6: efhcaDPhNqQ/H48kMHLa8w collected ($25)



PokerStars Game #59963530704:  Hold'em No Limit ($5/$10) - 2009/07/01 11:54:34 ET
Table 'AI1fZ7Tsbf9DI8mC4EWoQQ' 9-max Seat #5 is the button
Seat 1: ve1LEJosAmuFjNNCQuPnPg ($1117.25 in chips)
Seat 2: voSAIKXtXUUbJnds83sYfQ ($1092 in chips)
Seat 3: ZaYCGtNHUeItoUEheoYDMw ($190 in chips)
Seat 4: efhcaDPhNqQ/H48kMHLa8w ($1010 in chips)
Seat 5: 2PHCSXghjbGk2qR6jDFe2g ($1042 in chips)
Seat 6: l9mDFuns/ycIDiFx40BMVw ($820 in chips)
Seat 7: ettgJAblGnistIlqNz4Jww ($1015 in chips)
Seat 8: UgBUE0pOJDwUdQ53XJt8MQ ($160 in chips)
Seat 9: 1s1h7qXmZxmowl9P1VNe2Q ($184.75 in chips)
l9mDFuns/ycIDiFx40BMVw: posts small blind $5
ettgJAblGnistIlqNz4Jww: posts big blind $10
*** HOLE CARDS ***
UgBUE0pOJDwUdQ53XJt8MQ: folds
1s1h7qXmZxmowl9P1VNe2Q: folds
ve1LEJosAmuFjNNCQuPnPg: raises $20 to $30
voSAIKXtXUUbJnds83sYfQ: folds
ZaYCGtNHUeItoUEheoYDMw: folds
efhcaDPhNqQ/H48kMHLa8w: folds
2PHCSXghjbGk2qR6jDFe2g: calls $30
l9mDFuns/ycIDiFx40BMVw: calls $25
ettgJAblGnistIlqNz4Jww: calls $20
*** FLOP *** [4h 8s Ks]
l9mDFuns/ycIDiFx40BMVw: checks
ettgJAblGnistIlqNz4Jww: bets $70
ve1LEJosAmuFjNNCQuPnPg: calls $70
2PHCSXghjbGk2qR6jDFe2g: folds
l9mDFuns/ycIDiFx40BMVw: folds
*** TURN *** [4h 8s Ks] [8c]
ettgJAblGnistIlqNz4Jww: bets $175
ve1LEJosAmuFjNNCQuPnPg: calls $175
*** RIVER *** [4h 8s Ks 8c] [9s]
ettgJAblGnistIlqNz4Jww: bets $450
ve1LEJosAmuFjNNCQuPnPg: raises $392.25 to $842.25 and is all-in
ettgJAblGnistIlqNz4Jww: calls $290 and is all-in
*** SHOW DOWN ***
ve1LEJosAmuFjNNCQuPnPg: shows [4d 4s] (a full house, Fours full of Eights)
ettgJAblGnistIlqNz4Jww: mucks hand
ve1LEJosAmuFjNNCQuPnPg collected $2087 from pot
*** SUMMARY ***
Total pot $2090 | Rake $3
Board [4h 8s Ks 8c 9s]
Seat 1: ve1LEJosAmuFjNNCQuPnPg showed [4d 4s] and won ($2087) with a full house, Fours full of Eights
Seat 2: voSAIKXtXUUbJnds83sYfQ folded before Flop (didn't bet)
Seat 3: ZaYCGtNHUeItoUEheoYDMw folded before Flop (didn't bet)
Seat 4: efhcaDPhNqQ/H48kMHLa8w folded before Flop (didn't bet)
Seat 5: 2PHCSXghjbGk2qR6jDFe2g (button) folded on the Flop
Seat 6: l9mDFuns/ycIDiFx40BMVw (small blind) folded on the Flop
Seat 7: ettgJAblGnistIlqNz4Jww (big blind) mucked
Seat 8: UgBUE0pOJDwUdQ53XJt8MQ folded before Flop (didn't bet)
Seat 9: 1s1h7qXmZxmowl9P1VNe2Q folded before Flop (didn't bet)



PokerStars Game #59963541298:  Hold'em No Limit ($5/$10) - 2009/07/01 11:54:46 ET
Table '1Dt9cpcLUVE6HYkx5dUEdQ' 6-max Seat #4 is the button
Seat 1: Xl+I49lxCJwPGRuegiaHoA ($1030 in chips)
Seat 2: zdS2zKkZYSRe8p+GVcXMgg ($2013.10 in chips)
Seat 3: Lne9leXjEzXWbU3BGFWsxQ ($1272 in chips)
Seat 4: voSAIKXtXUUbJnds83sYfQ ($1738.75 in chips)
Seat 5: 1ScqYmNf7/uWx1XSBgPTBw ($190 in chips)
Seat 6: efhcaDPhNqQ/H48kMHLa8w ($1992 in chips)
1ScqYmNf7/uWx1XSBgPTBw: posts small blind $5
efhcaDPhNqQ/H48kMHLa8w: posts big blind $10
*** HOLE CARDS ***
Xl+I49lxCJwPGRuegiaHoA: folds
zdS2zKkZYSRe8p+GVcXMgg: folds
Lne9leXjEzXWbU3BGFWsxQ: folds
voSAIKXtXUUbJnds83sYfQ: folds
1ScqYmNf7/uWx1XSBgPTBw: folds
efhcaDPhNqQ/H48kMHLa8w collected $10 from pot
efhcaDPhNqQ/H48kMHLa8w: doesn't show hand
*** SUMMARY ***
Total pot $10 | Rake $0
Seat 1: Xl+I49lxCJwPGRuegiaHoA folded before Flop (didn't bet)
Seat 2: zdS2zKkZYSRe8p+GVcXMgg folded before Flop (didn't bet)
Seat 3: Lne9leXjEzXWbU3BGFWsxQ folded before Flop (didn't bet)
Seat 4: voSAIKXtXUUbJnds83sYfQ (button) folded before Flop (didn't bet)
Seat 5: 1ScqYmNf7/uWx1XSBgPTBw (small blind) folded before Flop
Seat 6: efhcaDPhNqQ/H48kMHLa8w (big blind) collected ($10)



PokerStars Game #59963556756:  Hold'em No Limit ($5/$10) - 2009/07/01 11:55:04 ET
Table '1Dt9cpcLUVE6HYkx5dUEdQ' 6-max Seat #5 is the button
Seat 1: Xl+I49lxCJwPGRuegiaHoA ($1030 in chips)
Seat 2: zdS2zKkZYSRe8p+GVcXMgg ($2013.10 in chips)
Seat 3: Lne9leXjEzXWbU3BGFWsxQ ($1272 in chips)
Seat 4: voSAIKXtXUUbJnds83sYfQ ($1738.75 in chips)
Seat 5: 1ScqYmNf7/uWx1XSBgPTBw ($185 in chips)
Seat 6: efhcaDPhNqQ/H48kMHLa8w ($1997 in chips)
efhcaDPhNqQ/H48kMHLa8w: posts small blind $5
Xl+I49lxCJwPGRuegiaHoA: posts big blind $10
*** HOLE CARDS ***
zdS2zKkZYSRe8p+GVcXMgg: folds
Lne9leXjEzXWbU3BGFWsxQ: folds
voSAIKXtXUUbJnds83sYfQ: folds
1ScqYmNf7/uWx1XSBgPTBw: folds
efhcaDPhNqQ/H48kMHLa8w: raises $30 to $40
Xl+I49lxCJwPGRuegiaHoA: calls $30
*** FLOP *** [3s 3h As]
efhcaDPhNqQ/H48kMHLa8w: bets $40
Xl+I49lxCJwPGRuegiaHoA: calls $40
*** TURN *** [3s 3h As] [Qd]
efhcaDPhNqQ/H48kMHLa8w: checks
Xl+I49lxCJwPGRuegiaHoA: checks
*** RIVER *** [3s 3h As Qd] [Kd]
efhcaDPhNqQ/H48kMHLa8w: checks
Xl+I49lxCJwPGRuegiaHoA: checks
*** SHOW DOWN ***
efhcaDPhNqQ/H48kMHLa8w: shows [7c 6c] (a pair of Threes)
Xl+I49lxCJwPGRuegiaHoA: shows [Kc Js] (two pair, Kings and Threes)
Xl+I49lxCJwPGRuegiaHoA collected $157 from pot
*** SUMMARY ***
Total pot $160 | Rake $3
Board [3s 3h As Qd Kd]
Seat 1: Xl+I49lxCJwPGRuegiaHoA (big blind) showed [Kc Js] and won ($157) with two pair, Kings and Threes
Seat 2: zdS2zKkZYSRe8p+GVcXMgg folded before Flop (didn't bet)
Seat 3: Lne9leXjEzXWbU3BGFWsxQ folded before Flop (didn't bet)
Seat 4: voSAIKXtXUUbJnds83sYfQ folded before Flop (didn't bet)
Seat 5: 1ScqYmNf7/uWx1XSBgPTBw (button) folded before Flop (didn't bet)
Seat 6: efhcaDPhNqQ/H48kMHLa8w (small blind) showed [7c 6c] and lost with a pair of Threes



PokerStars Game #59963567704:  Hold'em No Limit ($5/$10) - 2009/07/01 11:55:16 ET
Table 'AiNa6yyp/njJVRYl/Lz1KQ' 6-max Seat #6 is the button
Seat 1: C515ewji10HLkUifdjurhw ($190 in chips)
Seat 2: 7SUIdtQak1SCtldWHjwnFA ($178 in chips)
Seat 3: 3mTlg4g0FJN2bo939h/0Wg ($220 in chips)
Seat 4: /F5e5TKT/1B9kgJVuQttsg ($335.05 in chips)
Seat 5: 2PHCSXghjbGk2qR6jDFe2g ($436 in chips)
Seat 6: kem0o3a/3AcDZBJg3cdvpQ ($185 in chips)
C515ewji10HLkUifdjurhw: posts small blind $5
7SUIdtQak1SCtldWHjwnFA: posts big blind $10
*** HOLE CARDS ***
3mTlg4g0FJN2bo939h/0Wg: raises $20 to $30
/F5e5TKT/1B9kgJVuQttsg: folds
2PHCSXghjbGk2qR6jDFe2g: folds
kem0o3a/3AcDZBJg3cdvpQ: folds
C515ewji10HLkUifdjurhw: folds
7SUIdtQak1SCtldWHjwnFA: folds
3mTlg4g0FJN2bo939h/0Wg collected $25 from pot
3mTlg4g0FJN2bo939h/0Wg: doesn't show hand
*** SUMMARY ***
Total pot $25 | Rake $0
Seat 1: C515ewji10HLkUifdjurhw (small blind) folded before Flop
Seat 2: 7SUIdtQak1SCtldWHjwnFA (big blind) folded before Flop
Seat 3: 3mTlg4g0FJN2bo939h/0Wg collected ($25)
Seat 4: /F5e5TKT/1B9kgJVuQttsg folded before Flop (didn't bet)
Seat 5: 2PHCSXghjbGk2qR6jDFe2g folded before Flop (didn't bet)
Seat 6: kem0o3a/3AcDZBJg3cdvpQ (button) folded before Flop (didn't bet)



PokerStars Game #59963584092:  Hold'em No Limit ($5/$10) - 2009/07/01 11:55:35 ET
Table 'AiNa6yyp/njJVRYl/Lz1KQ' 6-max Seat #1 is the button
Seat 1: C515ewji10HLkUifdjurhw ($185 in chips)
Seat 2: 7SUIdtQak1SCtldWHjwnFA ($168 in chips)
Seat 3: 3mTlg4g0FJN2bo939h/0Wg ($235 in chips)
Seat 4: /F5e5TKT/1B9kgJVuQttsg ($335.05 in chips)
Seat 5: 2PHCSXghjbGk2qR6jDFe2g ($436 in chips)
Seat 6: kem0o3a/3AcDZBJg3cdvpQ ($185 in chips)
7SUIdtQak1SCtldWHjwnFA: posts small blind $5
3mTlg4g0FJN2bo939h/0Wg: posts big blind $10
*** HOLE CARDS ***
/F5e5TKT/1B9kgJVuQttsg: folds
2PHCSXghjbGk2qR6jDFe2g: folds
kem0o3a/3AcDZBJg3cdvpQ: folds
C515ewji10HLkUifdjurhw: folds
7SUIdtQak1SCtldWHjwnFA: raises $12 to $22
3mTlg4g0FJN2bo939h/0Wg: calls $12
*** FLOP *** [Qc Qd 5h]
7SUIdtQak1SCtldWHjwnFA: bets $23
3mTlg4g0FJN2bo939h/0Wg: raises $190 to $213 and is all-in
7SUIdtQak1SCtldWHjwnFA: folds
3mTlg4g0FJN2bo939h/0Wg collected $87 from pot
*** SUMMARY ***
Total pot $90 | Rake $3
Board [Qc Qd 5h]
Seat 1: C515ewji10HLkUifdjurhw (button) folded before Flop (didn't bet)
Seat 2: 7SUIdtQak1SCtldWHjwnFA (small blind) folded on the Flop
Seat 3: 3mTlg4g0FJN2bo939h/0Wg (big blind) collected ($87)
Seat 4: /F5e5TKT/1B9kgJVuQttsg folded before Flop (didn't bet)
Seat 5: 2PHCSXghjbGk2qR6jDFe2g folded before Flop (didn't bet)
Seat 6: kem0o3a/3AcDZBJg3cdvpQ folded before Flop (didn't bet)



PokerStars Game #59963614062:  Hold'em No Limit ($5/$10) - 2009/07/01 11:56:09 ET
Table 'AiNa6yyp/njJVRYl/Lz1KQ' 6-max Seat #2 is the button
Seat 1: C515ewji10HLkUifdjurhw ($185 in chips)
Seat 2: 7SUIdtQak1SCtldWHjwnFA ($123 in chips)
Seat 3: 3mTlg4g0FJN2bo939h/0Wg ($277 in chips)
Seat 4: /F5e5TKT/1B9kgJVuQttsg ($335.05 in chips)
Seat 5: 2PHCSXghjbGk2qR6jDFe2g ($436 in chips)
Seat 6: kem0o3a/3AcDZBJg3cdvpQ ($185 in chips)
3mTlg4g0FJN2bo939h/0Wg: posts small blind $5
/F5e5TKT/1B9kgJVuQttsg: posts big blind $10
*** HOLE CARDS ***
2PHCSXghjbGk2qR6jDFe2g: folds
kem0o3a/3AcDZBJg3cdvpQ: folds
C515ewji10HLkUifdjurhw: folds
7SUIdtQak1SCtldWHjwnFA: folds
3mTlg4g0FJN2bo939h/0Wg: calls $5
/F5e5TKT/1B9kgJVuQttsg: raises $20 to $30
3mTlg4g0FJN2bo939h/0Wg: calls $20
*** FLOP *** [Qc Qh 5c]
3mTlg4g0FJN2bo939h/0Wg: checks
/F5e5TKT/1B9kgJVuQttsg: checks
*** TURN *** [Qc Qh 5c] [Tc]
3mTlg4g0FJN2bo939h/0Wg: bets $30
/F5e5TKT/1B9kgJVuQttsg: calls $30
*** RIVER *** [Qc Qh 5c Tc] [2s]
3mTlg4g0FJN2bo939h/0Wg: bets $70
/F5e5TKT/1B9kgJVuQttsg: folds
3mTlg4g0FJN2bo939h/0Wg collected $117 from pot
*** SUMMARY ***
Total pot $120 | Rake $3
Board [Qc Qh 5c Tc 2s]
Seat 1: C515ewji10HLkUifdjurhw folded before Flop (didn't bet)
Seat 2: 7SUIdtQak1SCtldWHjwnFA (button) folded before Flop (didn't bet)
Seat 3: 3mTlg4g0FJN2bo939h/0Wg (small blind) collected ($117)
Seat 4: /F5e5TKT/1B9kgJVuQttsg (big blind) folded on the River
Seat 5: 2PHCSXghjbGk2qR6jDFe2g folded before Flop (didn't bet)
Seat 6: kem0o3a/3AcDZBJg3cdvpQ folded before Flop (didn't bet)



PokerStars Game #59963615086:  Hold'em No Limit ($5/$10) - 2009/07/01 11:56:10 ET
Table '1Dt9cpcLUVE6HYkx5dUEdQ' 6-max Seat #6 is the button
Seat 1: Xl+I49lxCJwPGRuegiaHoA ($1107 in chips)
Seat 2: zdS2zKkZYSRe8p+GVcXMgg ($2013.10 in chips)
Seat 3: Lne9leXjEzXWbU3BGFWsxQ ($1272 in chips)
Seat 4: voSAIKXtXUUbJnds83sYfQ ($1738.75 in chips)
Seat 5: 1ScqYmNf7/uWx1XSBgPTBw ($185 in chips)
Seat 6: efhcaDPhNqQ/H48kMHLa8w ($1917 in chips)
Xl+I49lxCJwPGRuegiaHoA: posts small blind $5
zdS2zKkZYSRe8p+GVcXMgg: posts big blind $10
*** HOLE CARDS ***
Lne9leXjEzXWbU3BGFWsxQ: raises $20 to $30
voSAIKXtXUUbJnds83sYfQ: folds
1ScqYmNf7/uWx1XSBgPTBw: folds
efhcaDPhNqQ/H48kMHLa8w: folds
Xl+I49lxCJwPGRuegiaHoA: folds
zdS2zKkZYSRe8p+GVcXMgg: calls $20
*** FLOP *** [7d 6d 8s]
zdS2zKkZYSRe8p+GVcXMgg: checks
Lne9leXjEzXWbU3BGFWsxQ: checks
*** TURN *** [7d 6d 8s] [Js]
zdS2zKkZYSRe8p+GVcXMgg: checks
Lne9leXjEzXWbU3BGFWsxQ: checks
*** RIVER *** [7d 6d 8s Js] [3d]
zdS2zKkZYSRe8p+GVcXMgg: checks
Lne9leXjEzXWbU3BGFWsxQ: checks
*** SHOW DOWN ***
zdS2zKkZYSRe8p+GVcXMgg: shows [5s 6c] (a pair of Sixes)
Lne9leXjEzXWbU3BGFWsxQ: mucks hand
zdS2zKkZYSRe8p+GVcXMgg collected $62 from pot
*** SUMMARY ***
Total pot $65 | Rake $3
Board [7d 6d 8s Js 3d]
Seat 1: Xl+I49lxCJwPGRuegiaHoA (small blind) folded before Flop
Seat 2: zdS2zKkZYSRe8p+GVcXMgg (big blind) showed [5s 6c] and won ($62) with a pair of Sixes
Seat 3: Lne9leXjEzXWbU3BGFWsxQ mucked
Seat 4: voSAIKXtXUUbJnds83sYfQ folded before Flop (didn't bet)
Seat 5: 1ScqYmNf7/uWx1XSBgPTBw folded before Flop (didn't bet)
Seat 6: efhcaDPhNqQ/H48kMHLa8w (button) folded before Flop (didn't bet)



PokerStars Game #59963616132:  Hold'em No Limit ($5/$10) - 2009/07/01 11:56:11 ET
Table 'AI1fZ7Tsbf9DI8mC4EWoQQ' 9-max Seat #6 is the button
Seat 1: ve1LEJosAmuFjNNCQuPnPg ($2189.25 in chips)
Seat 2: voSAIKXtXUUbJnds83sYfQ ($1092 in chips)
Seat 3: ZaYCGtNHUeItoUEheoYDMw ($190 in chips)
Seat 4: efhcaDPhNqQ/H48kMHLa8w ($1010 in chips)
Seat 5: 2PHCSXghjbGk2qR6jDFe2g ($1012 in chips)
Seat 6: l9mDFuns/ycIDiFx40BMVw ($790 in chips)
Seat 7: ettgJAblGnistIlqNz4Jww ($1000 in chips)
Seat 8: UgBUE0pOJDwUdQ53XJt8MQ ($160 in chips)
Seat 9: 1s1h7qXmZxmowl9P1VNe2Q ($184.75 in chips)
ettgJAblGnistIlqNz4Jww: posts small blind $5
UgBUE0pOJDwUdQ53XJt8MQ: posts big blind $10
*** HOLE CARDS ***
1s1h7qXmZxmowl9P1VNe2Q: folds
ve1LEJosAmuFjNNCQuPnPg: folds
voSAIKXtXUUbJnds83sYfQ: folds
ZaYCGtNHUeItoUEheoYDMw: folds
efhcaDPhNqQ/H48kMHLa8w: folds
2PHCSXghjbGk2qR6jDFe2g: folds
l9mDFuns/ycIDiFx40BMVw: raises $20 to $30
ettgJAblGnistIlqNz4Jww: folds
UgBUE0pOJDwUdQ53XJt8MQ: folds
l9mDFuns/ycIDiFx40BMVw collected $25 from pot
*** SUMMARY ***
Total pot $25 | Rake $0
Seat 1: ve1LEJosAmuFjNNCQuPnPg folded before Flop (didn't bet)
Seat 2: voSAIKXtXUUbJnds83sYfQ folded before Flop (didn't bet)
Seat 3: ZaYCGtNHUeItoUEheoYDMw folded before Flop (didn't bet)
Seat 4: efhcaDPhNqQ/H48kMHLa8w folded before Flop (didn't bet)
Seat 5: 2PHCSXghjbGk2qR6jDFe2g folded before Flop (didn't bet)
Seat 6: l9mDFuns/ycIDiFx40BMVw (button) collected ($25)
Seat 7: ettgJAblGnistIlqNz4Jww (small blind) folded before Flop
Seat 8: UgBUE0pOJDwUdQ53XJt8MQ (big blind) folded before Flop
Seat 9: 1s1h7qXmZxmowl9P1VNe2Q folded before Flop (didn't bet)



PokerStars Game #59963644396:  Hold'em No Limit ($5/$10) - 2009/07/01 11:56:43 ET
Table 'AI1fZ7Tsbf9DI8mC4EWoQQ' 9-max Seat #7 is the button
Seat 1: ve1LEJosAmuFjNNCQuPnPg ($2189.25 in chips)
Seat 2: voSAIKXtXUUbJnds83sYfQ ($1092 in chips)
Seat 3: ZaYCGtNHUeItoUEheoYDMw ($190 in chips)
Seat 4: efhcaDPhNqQ/H48kMHLa8w ($1010 in chips)
Seat 5: 2PHCSXghjbGk2qR6jDFe2g ($1012 in chips)
Seat 6: l9mDFuns/ycIDiFx40BMVw ($805 in chips)
Seat 7: ettgJAblGnistIlqNz4Jww ($1000 in chips)
Seat 8: UgBUE0pOJDwUdQ53XJt8MQ ($150 in chips)
Seat 9: 1s1h7qXmZxmowl9P1VNe2Q ($184.75 in chips)
UgBUE0pOJDwUdQ53XJt8MQ: posts small blind $5
1s1h7qXmZxmowl9P1VNe2Q: posts big blind $10
*** HOLE CARDS ***
ve1LEJosAmuFjNNCQuPnPg: folds
ve1LEJosAmuFjNNCQuPnPg is sitting out
voSAIKXtXUUbJnds83sYfQ: folds
ZaYCGtNHUeItoUEheoYDMw: folds
efhcaDPhNqQ/H48kMHLa8w: folds
2PHCSXghjbGk2qR6jDFe2g: folds
l9mDFuns/ycIDiFx40BMVw: folds
ettgJAblGnistIlqNz4Jww: folds
UgBUE0pOJDwUdQ53XJt8MQ: raises $20 to $30
1s1h7qXmZxmowl9P1VNe2Q: raises $154.75 to $184.75 and is all-in
UgBUE0pOJDwUdQ53XJt8MQ: folds
1s1h7qXmZxmowl9P1VNe2Q collected $60 from pot
*** SUMMARY ***
Total pot $60 | Rake $0
Seat 1: ve1LEJosAmuFjNNCQuPnPg folded before Flop (didn't bet)
Seat 2: voSAIKXtXUUbJnds83sYfQ folded before Flop (didn't bet)
Seat 3: ZaYCGtNHUeItoUEheoYDMw folded before Flop (didn't bet)
Seat 4: efhcaDPhNqQ/H48kMHLa8w folded before Flop (didn't bet)
Seat 5: 2PHCSXghjbGk2qR6jDFe2g folded before Flop (didn't bet)
Seat 6: l9mDFuns/ycIDiFx40BMVw folded before Flop (didn't bet)
Seat 7: ettgJAblGnistIlqNz4Jww (button) folded before Flop (didn't bet)
Seat 8: UgBUE0pOJDwUdQ53XJt8MQ (small blind) folded before Flop
Seat 9: 1s1h7qXmZxmowl9P1VNe2Q (big blind) collected ($60)



PokerStars Game #59963663860:  Hold'em No Limit ($5/$10) - 2009/07/01 11:57:05 ET
Table '1Dt9cpcLUVE6HYkx5dUEdQ' 6-max Seat #1 is the button
Seat 1: Xl+I49lxCJwPGRuegiaHoA ($1102 in chips)
Seat 2: zdS2zKkZYSRe8p+GVcXMgg ($2045.10 in chips)
Seat 3: Lne9leXjEzXWbU3BGFWsxQ ($1242 in chips)
Seat 4: voSAIKXtXUUbJnds83sYfQ ($1738.75 in chips)
Seat 5: 1ScqYmNf7/uWx1XSBgPTBw ($185 in chips)
Seat 6: efhcaDPhNqQ/H48kMHLa8w ($1917 in chips)
zdS2zKkZYSRe8p+GVcXMgg: posts small blind $5
Lne9leXjEzXWbU3BGFWsxQ: posts big blind $10
*** HOLE CARDS ***
voSAIKXtXUUbJnds83sYfQ: folds
1ScqYmNf7/uWx1XSBgPTBw: folds
efhcaDPhNqQ/H48kMHLa8w: folds
Xl+I49lxCJwPGRuegiaHoA: folds
zdS2zKkZYSRe8p+GVcXMgg: calls $5
Lne9leXjEzXWbU3BGFWsxQ: checks
*** FLOP *** [3d Kc 4s]
zdS2zKkZYSRe8p+GVcXMgg: checks
Lne9leXjEzXWbU3BGFWsxQ: bets $10
zdS2zKkZYSRe8p+GVcXMgg: folds
Lne9leXjEzXWbU3BGFWsxQ collected $19 from pot
*** SUMMARY ***
Total pot $20 | Rake $1
Board [3d Kc 4s]
Seat 1: Xl+I49lxCJwPGRuegiaHoA (button) folded before Flop (didn't bet)
Seat 2: zdS2zKkZYSRe8p+GVcXMgg (small blind) folded on the Flop
Seat 3: Lne9leXjEzXWbU3BGFWsxQ (big blind) collected ($19)
Seat 4: voSAIKXtXUUbJnds83sYfQ folded before Flop (didn't bet)
Seat 5: 1ScqYmNf7/uWx1XSBgPTBw folded before Flop (didn't bet)
Seat 6: efhcaDPhNqQ/H48kMHLa8w folded before Flop (didn't bet)



PokerStars Game #59963663804:  Hold'em No Limit ($5/$10) - 2009/07/01 11:57:05 ET
Table 'AiNa6yyp/njJVRYl/Lz1KQ' 6-max Seat #3 is the button
Seat 1: C515ewji10HLkUifdjurhw ($185 in chips)
Seat 2: 7SUIdtQak1SCtldWHjwnFA ($123 in chips)
Seat 3: 3mTlg4g0FJN2bo939h/0Wg ($334 in chips)
Seat 4: /F5e5TKT/1B9kgJVuQttsg ($300 in chips)
Seat 5: 2PHCSXghjbGk2qR6jDFe2g ($436 in chips)
Seat 6: kem0o3a/3AcDZBJg3cdvpQ ($185 in chips)
/F5e5TKT/1B9kgJVuQttsg: posts small blind $5
2PHCSXghjbGk2qR6jDFe2g: posts big blind $10
*** HOLE CARDS ***
kem0o3a/3AcDZBJg3cdvpQ: folds
C515ewji10HLkUifdjurhw: raises $15 to $25
7SUIdtQak1SCtldWHjwnFA: folds
3mTlg4g0FJN2bo939h/0Wg: folds
/F5e5TKT/1B9kgJVuQttsg: folds
2PHCSXghjbGk2qR6jDFe2g: calls $15
*** FLOP *** [6c Kd 3d]
2PHCSXghjbGk2qR6jDFe2g: checks
C515ewji10HLkUifdjurhw: bets $30
2PHCSXghjbGk2qR6jDFe2g: folds
C515ewji10HLkUifdjurhw collected $52.25 from pot
C515ewji10HLkUifdjurhw: doesn't show hand
*** SUMMARY ***
Total pot $55 | Rake $2.75
Board [6c Kd 3d]
Seat 1: C515ewji10HLkUifdjurhw collected ($52.25)
Seat 2: 7SUIdtQak1SCtldWHjwnFA folded before Flop (didn't bet)
Seat 3: 3mTlg4g0FJN2bo939h/0Wg (button) folded before Flop (didn't bet)
Seat 4: /F5e5TKT/1B9kgJVuQttsg (small blind) folded before Flop
Seat 5: 2PHCSXghjbGk2qR6jDFe2g (big blind) folded on the Flop
Seat 6: kem0o3a/3AcDZBJg3cdvpQ folded before Flop (didn't bet)



PokerStars Game #59963690120:  Hold'em No Limit ($5/$10) - 2009/07/01 11:57:35 ET
Table 'AI1fZ7Tsbf9DI8mC4EWoQQ' 9-max Seat #8 is the button
Seat 2: voSAIKXtXUUbJnds83sYfQ ($1092 in chips)
Seat 3: ZaYCGtNHUeItoUEheoYDMw ($190 in chips)
Seat 4: efhcaDPhNqQ/H48kMHLa8w ($1010 in chips)
Seat 5: 2PHCSXghjbGk2qR6jDFe2g ($1012 in chips)
Seat 6: l9mDFuns/ycIDiFx40BMVw ($805 in chips)
Seat 7: ettgJAblGnistIlqNz4Jww ($1000 in chips)
Seat 8: UgBUE0pOJDwUdQ53XJt8MQ ($120 in chips)
Seat 9: 1s1h7qXmZxmowl9P1VNe2Q ($214.75 in chips)
1s1h7qXmZxmowl9P1VNe2Q: posts small blind $5
voSAIKXtXUUbJnds83sYfQ: posts big blind $10
*** HOLE CARDS ***
ZaYCGtNHUeItoUEheoYDMw: folds
efhcaDPhNqQ/H48kMHLa8w: folds
2PHCSXghjbGk2qR6jDFe2g: folds
l9mDFuns/ycIDiFx40BMVw: folds
ettgJAblGnistIlqNz4Jww: folds
UgBUE0pOJDwUdQ53XJt8MQ: folds
1s1h7qXmZxmowl9P1VNe2Q: raises $10 to $20
voSAIKXtXUUbJnds83sYfQ: folds
1s1h7qXmZxmowl9P1VNe2Q collected $20 from pot
*** SUMMARY ***
Total pot $20 | Rake $0
Seat 2: voSAIKXtXUUbJnds83sYfQ (big blind) folded before Flop
Seat 3: ZaYCGtNHUeItoUEheoYDMw folded before Flop (didn't bet)
Seat 4: efhcaDPhNqQ/H48kMHLa8w folded before Flop (didn't bet)
Seat 5: 2PHCSXghjbGk2qR6jDFe2g folded before Flop (didn't bet)
Seat 6: l9mDFuns/ycIDiFx40BMVw folded before Flop (didn't bet)
Seat 7: ettgJAblGnistIlqNz4Jww folded before Flop (didn't bet)
Seat 8: UgBUE0pOJDwUdQ53XJt8MQ (button) folded before Flop (didn't bet)
Seat 9: 1s1h7qXmZxmowl9P1VNe2Q (small blind) collected ($20)



PokerStars Game #59963693886:  Hold'em No Limit ($5/$10) - 2009/07/01 11:57:39 ET
Table '1Dt9cpcLUVE6HYkx5dUEdQ' 6-max Seat #2 is the button
Seat 1: Xl+I49lxCJwPGRuegiaHoA ($1102 in chips)
Seat 2: zdS2zKkZYSRe8p+GVcXMgg ($2035.10 in chips)
Seat 3: Lne9leXjEzXWbU3BGFWsxQ ($1251 in chips)
Seat 4: voSAIKXtXUUbJnds83sYfQ ($1738.75 in chips)
Seat 5: 1ScqYmNf7/uWx1XSBgPTBw ($185 in chips)
Seat 6: efhcaDPhNqQ/H48kMHLa8w ($1917 in chips)
Lne9leXjEzXWbU3BGFWsxQ: posts small blind $5
voSAIKXtXUUbJnds83sYfQ: posts big blind $10
*** HOLE CARDS ***
1ScqYmNf7/uWx1XSBgPTBw: folds
efhcaDPhNqQ/H48kMHLa8w: folds
Xl+I49lxCJwPGRuegiaHoA: folds
zdS2zKkZYSRe8p+GVcXMgg: folds
Lne9leXjEzXWbU3BGFWsxQ: folds
voSAIKXtXUUbJnds83sYfQ collected $10 from pot
*** SUMMARY ***
Total pot $10 | Rake $0
Seat 1: Xl+I49lxCJwPGRuegiaHoA folded before Flop (didn't bet)
Seat 2: zdS2zKkZYSRe8p+GVcXMgg (button) folded before Flop (didn't bet)
Seat 3: Lne9leXjEzXWbU3BGFWsxQ (small blind) folded before Flop
Seat 4: voSAIKXtXUUbJnds83sYfQ (big blind) collected ($10)
Seat 5: 1ScqYmNf7/uWx1XSBgPTBw folded before Flop (didn't bet)
Seat 6: efhcaDPhNqQ/H48kMHLa8w folded before Flop (didn't bet)



PokerStars Game #59963693284:  Hold'em No Limit ($5/$10) - 2009/07/01 11:57:39 ET
Table 'AiNa6yyp/njJVRYl/Lz1KQ' 6-max Seat #4 is the button
Seat 1: C515ewji10HLkUifdjurhw ($212.25 in chips)
Seat 2: 7SUIdtQak1SCtldWHjwnFA ($123 in chips)
Seat 3: 3mTlg4g0FJN2bo939h/0Wg ($334 in chips)
Seat 4: /F5e5TKT/1B9kgJVuQttsg ($300 in chips)
Seat 5: 2PHCSXghjbGk2qR6jDFe2g ($411 in chips)
Seat 6: kem0o3a/3AcDZBJg3cdvpQ ($185 in chips)
2PHCSXghjbGk2qR6jDFe2g: posts small blind $5
kem0o3a/3AcDZBJg3cdvpQ: posts big blind $10
*** HOLE CARDS ***
C515ewji10HLkUifdjurhw: raises $10 to $20
7SUIdtQak1SCtldWHjwnFA: folds
3mTlg4g0FJN2bo939h/0Wg: folds
/F5e5TKT/1B9kgJVuQttsg: folds
2PHCSXghjbGk2qR6jDFe2g: folds
kem0o3a/3AcDZBJg3cdvpQ: folds
C515ewji10HLkUifdjurhw collected $25 from pot
C515ewji10HLkUifdjurhw: doesn't show hand
*** SUMMARY ***
Total pot $25 | Rake $0
Seat 1: C515ewji10HLkUifdjurhw collected ($25)
Seat 2: 7SUIdtQak1SCtldWHjwnFA folded before Flop (didn't bet)
Seat 3: 3mTlg4g0FJN2bo939h/0Wg folded before Flop (didn't bet)
Seat 4: /F5e5TKT/1B9kgJVuQttsg (button) folded before Flop (didn't bet)
Seat 5: 2PHCSXghjbGk2qR6jDFe2g (small blind) folded before Flop
Seat 6: kem0o3a/3AcDZBJg3cdvpQ (big blind) folded before Flop



PokerStars Game #59963708142:  Hold'em No Limit ($5/$10) - 2009/07/01 11:57:56 ET
Table 'AiNa6yyp/njJVRYl/Lz1KQ' 6-max Seat #5 is the button
Seat 1: C515ewji10HLkUifdjurhw ($227.25 in chips)
Seat 2: 7SUIdtQak1SCtldWHjwnFA ($123 in chips)
Seat 3: 3mTlg4g0FJN2bo939h/0Wg ($334 in chips)
Seat 4: /F5e5TKT/1B9kgJVuQttsg ($300 in chips)
Seat 5: 2PHCSXghjbGk2qR6jDFe2g ($406 in chips)
Seat 6: kem0o3a/3AcDZBJg3cdvpQ ($175 in chips)
kem0o3a/3AcDZBJg3cdvpQ: posts small blind $5
C515ewji10HLkUifdjurhw: posts big blind $10
*** HOLE CARDS ***
7SUIdtQak1SCtldWHjwnFA: raises $12 to $22
3mTlg4g0FJN2bo939h/0Wg: folds
/F5e5TKT/1B9kgJVuQttsg: folds
2PHCSXghjbGk2qR6jDFe2g: folds
kem0o3a/3AcDZBJg3cdvpQ: folds
C515ewji10HLkUifdjurhw: folds
7SUIdtQak1SCtldWHjwnFA collected $25 from pot
7SUIdtQak1SCtldWHjwnFA: doesn't show hand
*** SUMMARY ***
Total pot $25 | Rake $0
Seat 1: C515ewji10HLkUifdjurhw (big blind) folded before Flop
Seat 2: 7SUIdtQak1SCtldWHjwnFA collected ($25)
Seat 3: 3mTlg4g0FJN2bo939h/0Wg folded before Flop (didn't bet)
Seat 4: /F5e5TKT/1B9kgJVuQttsg folded before Flop (didn't bet)
Seat 5: 2PHCSXghjbGk2qR6jDFe2g (button) folded before Flop (didn't bet)
Seat 6: kem0o3a/3AcDZBJg3cdvpQ (small blind) folded before Flop



PokerStars Game #59963713480:  Hold'em No Limit ($5/$10) - 2009/07/01 11:58:02 ET
Table 'AI1fZ7Tsbf9DI8mC4EWoQQ' 9-max Seat #9 is the button
Seat 2: voSAIKXtXUUbJnds83sYfQ ($1082 in chips)
Seat 3: ZaYCGtNHUeItoUEheoYDMw ($190 in chips)
Seat 4: efhcaDPhNqQ/H48kMHLa8w ($1010 in chips)
Seat 5: 2PHCSXghjbGk2qR6jDFe2g ($1012 in chips)
Seat 6: l9mDFuns/ycIDiFx40BMVw ($805 in chips)
Seat 7: ettgJAblGnistIlqNz4Jww ($1000 in chips)
Seat 8: UgBUE0pOJDwUdQ53XJt8MQ ($120 in chips)
Seat 9: 1s1h7qXmZxmowl9P1VNe2Q ($224.75 in chips)
voSAIKXtXUUbJnds83sYfQ: posts small blind $5
ZaYCGtNHUeItoUEheoYDMw: posts big blind $10
*** HOLE CARDS ***
efhcaDPhNqQ/H48kMHLa8w: folds
2PHCSXghjbGk2qR6jDFe2g: folds
l9mDFuns/ycIDiFx40BMVw: raises $20 to $30
ettgJAblGnistIlqNz4Jww: folds
UgBUE0pOJDwUdQ53XJt8MQ: folds
1s1h7qXmZxmowl9P1VNe2Q: folds
voSAIKXtXUUbJnds83sYfQ: folds
ZaYCGtNHUeItoUEheoYDMw: folds
l9mDFuns/ycIDiFx40BMVw collected $25 from pot
*** SUMMARY ***
Total pot $25 | Rake $0
Seat 2: voSAIKXtXUUbJnds83sYfQ (small blind) folded before Flop
Seat 3: ZaYCGtNHUeItoUEheoYDMw (big blind) folded before Flop
Seat 4: efhcaDPhNqQ/H48kMHLa8w folded before Flop (didn't bet)
Seat 5: 2PHCSXghjbGk2qR6jDFe2g folded before Flop (didn't bet)
Seat 6: l9mDFuns/ycIDiFx40BMVw collected ($25)
Seat 7: ettgJAblGnistIlqNz4Jww folded before Flop (didn't bet)
Seat 8: UgBUE0pOJDwUdQ53XJt8MQ folded before Flop (didn't bet)
Seat 9: 1s1h7qXmZxmowl9P1VNe2Q (button) folded before Flop (didn't bet)



PokerStars Game #59963715628:  Hold'em No Limit ($5/$10) - 2009/07/01 11:58:04 ET
Table '1Dt9cpcLUVE6HYkx5dUEdQ' 6-max Seat #3 is the button
Seat 1: Xl+I49lxCJwPGRuegiaHoA ($1102 in chips)
Seat 2: zdS2zKkZYSRe8p+GVcXMgg ($2035.10 in chips)
Seat 3: Lne9leXjEzXWbU3BGFWsxQ ($1246 in chips)
Seat 4: voSAIKXtXUUbJnds83sYfQ ($1743.75 in chips)
Seat 5: 1ScqYmNf7/uWx1XSBgPTBw ($185 in chips)
Seat 6: efhcaDPhNqQ/H48kMHLa8w ($1917 in chips)
voSAIKXtXUUbJnds83sYfQ: posts small blind $5
1ScqYmNf7/uWx1XSBgPTBw: posts big blind $10
*** HOLE CARDS ***
efhcaDPhNqQ/H48kMHLa8w: folds
Xl+I49lxCJwPGRuegiaHoA: raises $20 to $30
zdS2zKkZYSRe8p+GVcXMgg: raises $40 to $70
Lne9leXjEzXWbU3BGFWsxQ: calls $70
voSAIKXtXUUbJnds83sYfQ: folds
1ScqYmNf7/uWx1XSBgPTBw: folds
Xl+I49lxCJwPGRuegiaHoA: calls $40
*** FLOP *** [Ah 7s Ac]
Xl+I49lxCJwPGRuegiaHoA: checks
zdS2zKkZYSRe8p+GVcXMgg: checks
Lne9leXjEzXWbU3BGFWsxQ: bets $80
Xl+I49lxCJwPGRuegiaHoA: calls $80
zdS2zKkZYSRe8p+GVcXMgg: calls $80
*** TURN *** [Ah 7s Ac] [Qs]
Xl+I49lxCJwPGRuegiaHoA: checks
zdS2zKkZYSRe8p+GVcXMgg: checks
Lne9leXjEzXWbU3BGFWsxQ: checks
*** RIVER *** [Ah 7s Ac Qs] [2c]
Xl+I49lxCJwPGRuegiaHoA: bets $350
zdS2zKkZYSRe8p+GVcXMgg: folds
Lne9leXjEzXWbU3BGFWsxQ: folds
zdS2zKkZYSRe8p+GVcXMgg said, "kk"
Xl+I49lxCJwPGRuegiaHoA collected $462 from pot
*** SUMMARY ***
Total pot $465 | Rake $3
Board [Ah 7s Ac Qs 2c]
Seat 1: Xl+I49lxCJwPGRuegiaHoA collected ($462)
Seat 2: zdS2zKkZYSRe8p+GVcXMgg folded on the River
Seat 3: Lne9leXjEzXWbU3BGFWsxQ (button) folded on the River
Seat 4: voSAIKXtXUUbJnds83sYfQ (small blind) folded before Flop
Seat 5: 1ScqYmNf7/uWx1XSBgPTBw (big blind) folded before Flop
Seat 6: efhcaDPhNqQ/H48kMHLa8w folded before Flop (didn't bet)



PokerStars Game #59963727612:  Hold'em No Limit ($5/$10) - 2009/07/01 11:58:18 ET
Table 'AiNa6yyp/njJVRYl/Lz1KQ' 6-max Seat #6 is the button
Seat 1: C515ewji10HLkUifdjurhw ($217.25 in chips)
Seat 2: 7SUIdtQak1SCtldWHjwnFA ($138 in chips)
Seat 3: 3mTlg4g0FJN2bo939h/0Wg ($334 in chips)
Seat 4: /F5e5TKT/1B9kgJVuQttsg ($300 in chips)
Seat 5: 2PHCSXghjbGk2qR6jDFe2g ($406 in chips)
Seat 6: kem0o3a/3AcDZBJg3cdvpQ ($170 in chips)
C515ewji10HLkUifdjurhw: posts small blind $5
7SUIdtQak1SCtldWHjwnFA: posts big blind $10
*** HOLE CARDS ***
3mTlg4g0FJN2bo939h/0Wg: raises $10 to $20
/F5e5TKT/1B9kgJVuQttsg: folds
2PHCSXghjbGk2qR6jDFe2g: folds
kem0o3a/3AcDZBJg3cdvpQ: folds
C515ewji10HLkUifdjurhw: folds
7SUIdtQak1SCtldWHjwnFA: raises $118 to $138 and is all-in
3mTlg4g0FJN2bo939h/0Wg: folds
7SUIdtQak1SCtldWHjwnFA collected $45 from pot
7SUIdtQak1SCtldWHjwnFA: doesn't show hand
*** SUMMARY ***
Total pot $45 | Rake $0
Seat 1: C515ewji10HLkUifdjurhw (small blind) folded before Flop
Seat 2: 7SUIdtQak1SCtldWHjwnFA (big blind) collected ($45)
Seat 3: 3mTlg4g0FJN2bo939h/0Wg folded before Flop
Seat 4: /F5e5TKT/1B9kgJVuQttsg folded before Flop (didn't bet)
Seat 5: 2PHCSXghjbGk2qR6jDFe2g folded before Flop (didn't bet)
Seat 6: kem0o3a/3AcDZBJg3cdvpQ (button) folded before Flop (didn't bet)



PokerStars Game #59963739812:  Hold'em No Limit ($5/$10) - 2009/07/01 11:58:31 ET
Table 'AI1fZ7Tsbf9DI8mC4EWoQQ' 9-max Seat #2 is the button
Seat 2: voSAIKXtXUUbJnds83sYfQ ($1077 in chips)
Seat 3: ZaYCGtNHUeItoUEheoYDMw ($180 in chips)
Seat 4: efhcaDPhNqQ/H48kMHLa8w ($1010 in chips)
Seat 5: 2PHCSXghjbGk2qR6jDFe2g ($1012 in chips)
Seat 6: l9mDFuns/ycIDiFx40BMVw ($820 in chips)
Seat 7: ettgJAblGnistIlqNz4Jww ($1000 in chips)
Seat 8: UgBUE0pOJDwUdQ53XJt8MQ ($120 in chips)
Seat 9: 1s1h7qXmZxmowl9P1VNe2Q ($224.75 in chips)
ZaYCGtNHUeItoUEheoYDMw: posts small blind $5
efhcaDPhNqQ/H48kMHLa8w: posts big blind $10
*** HOLE CARDS ***
2PHCSXghjbGk2qR6jDFe2g: folds
l9mDFuns/ycIDiFx40BMVw: folds
ettgJAblGnistIlqNz4Jww: folds
UgBUE0pOJDwUdQ53XJt8MQ: folds
1s1h7qXmZxmowl9P1VNe2Q: folds
voSAIKXtXUUbJnds83sYfQ: folds
ZaYCGtNHUeItoUEheoYDMw: raises $10 to $20
efhcaDPhNqQ/H48kMHLa8w: raises $20 to $40
ZaYCGtNHUeItoUEheoYDMw: raises $140 to $180 and is all-in
efhcaDPhNqQ/H48kMHLa8w: calls $140
*** FLOP *** [7c 9h Qd]
*** TURN *** [7c 9h Qd] [5h]
*** RIVER *** [7c 9h Qd 5h] [Jd]
*** SHOW DOWN ***
ZaYCGtNHUeItoUEheoYDMw: shows [Ac Ah] (a pair of Aces)
efhcaDPhNqQ/H48kMHLa8w: mucks hand
ZaYCGtNHUeItoUEheoYDMw collected $357 from pot
*** SUMMARY ***
Total pot $360 | Rake $3
Board [7c 9h Qd 5h Jd]
Seat 2: voSAIKXtXUUbJnds83sYfQ (button) folded before Flop (didn't bet)
Seat 3: ZaYCGtNHUeItoUEheoYDMw (small blind) showed [Ac Ah] and won ($357) with a pair of Aces
Seat 4: efhcaDPhNqQ/H48kMHLa8w (big blind) mucked
Seat 5: 2PHCSXghjbGk2qR6jDFe2g folded before Flop (didn't bet)
Seat 6: l9mDFuns/ycIDiFx40BMVw folded before Flop (didn't bet)
Seat 7: ettgJAblGnistIlqNz4Jww folded before Flop (didn't bet)
Seat 8: UgBUE0pOJDwUdQ53XJt8MQ folded before Flop (didn't bet)
Seat 9: 1s1h7qXmZxmowl9P1VNe2Q folded before Flop (didn't bet)



PokerStars Game #59963746828:  Hold'em No Limit ($5/$10) - 2009/07/01 11:58:40 ET
Table 'AiNa6yyp/njJVRYl/Lz1KQ' 6-max Seat #1 is the button
Seat 1: C515ewji10HLkUifdjurhw ($212.25 in chips)
Seat 2: 7SUIdtQak1SCtldWHjwnFA ($163 in chips)
Seat 3: 3mTlg4g0FJN2bo939h/0Wg ($314 in chips)
Seat 4: /F5e5TKT/1B9kgJVuQttsg ($300 in chips)
Seat 5: 2PHCSXghjbGk2qR6jDFe2g ($406 in chips)
Seat 6: kem0o3a/3AcDZBJg3cdvpQ ($170 in chips)
7SUIdtQak1SCtldWHjwnFA: posts small blind $5
3mTlg4g0FJN2bo939h/0Wg: posts big blind $10
*** HOLE CARDS ***
/F5e5TKT/1B9kgJVuQttsg: folds
2PHCSXghjbGk2qR6jDFe2g: folds
kem0o3a/3AcDZBJg3cdvpQ: folds
C515ewji10HLkUifdjurhw: folds
7SUIdtQak1SCtldWHjwnFA: folds
3mTlg4g0FJN2bo939h/0Wg collected $10 from pot
*** SUMMARY ***
Total pot $10 | Rake $0
Seat 1: C515ewji10HLkUifdjurhw (button) folded before Flop (didn't bet)
Seat 2: 7SUIdtQak1SCtldWHjwnFA (small blind) folded before Flop
Seat 3: 3mTlg4g0FJN2bo939h/0Wg (big blind) collected ($10)
Seat 4: /F5e5TKT/1B9kgJVuQttsg folded before Flop (didn't bet)
Seat 5: 2PHCSXghjbGk2qR6jDFe2g folded before Flop (didn't bet)
Seat 6: kem0o3a/3AcDZBJg3cdvpQ folded before Flop (didn't bet)



PokerStars Game #59963768470:  Hold'em No Limit ($5/$10) - 2009/07/01 11:59:04 ET
Table 'AiNa6yyp/njJVRYl/Lz1KQ' 6-max Seat #2 is the button
Seat 1: C515ewji10HLkUifdjurhw ($212.25 in chips)
Seat 2: 7SUIdtQak1SCtldWHjwnFA ($158 in chips)
Seat 3: 3mTlg4g0FJN2bo939h/0Wg ($319 in chips)
Seat 4: /F5e5TKT/1B9kgJVuQttsg ($300 in chips)
Seat 5: 2PHCSXghjbGk2qR6jDFe2g ($406 in chips)
Seat 6: kem0o3a/3AcDZBJg3cdvpQ ($170 in chips)
3mTlg4g0FJN2bo939h/0Wg: posts small blind $5
/F5e5TKT/1B9kgJVuQttsg: posts big blind $10
*** HOLE CARDS ***
2PHCSXghjbGk2qR6jDFe2g: folds
kem0o3a/3AcDZBJg3cdvpQ: folds
C515ewji10HLkUifdjurhw: raises $10 to $20
7SUIdtQak1SCtldWHjwnFA: folds
3mTlg4g0FJN2bo939h/0Wg: folds
/F5e5TKT/1B9kgJVuQttsg: folds
C515ewji10HLkUifdjurhw collected $25 from pot
C515ewji10HLkUifdjurhw: doesn't show hand
*** SUMMARY ***
Total pot $25 | Rake $0
Seat 1: C515ewji10HLkUifdjurhw collected ($25)
Seat 2: 7SUIdtQak1SCtldWHjwnFA (button) folded before Flop (didn't bet)
Seat 3: 3mTlg4g0FJN2bo939h/0Wg (small blind) folded before Flop
Seat 4: /F5e5TKT/1B9kgJVuQttsg (big blind) folded before Flop
Seat 5: 2PHCSXghjbGk2qR6jDFe2g folded before Flop (didn't bet)
Seat 6: kem0o3a/3AcDZBJg3cdvpQ folded before Flop (didn't bet)



PokerStars Game #59963788012:  Hold'em No Limit ($5/$10) - 2009/07/01 11:59:26 ET
Table 'AiNa6yyp/njJVRYl/Lz1KQ' 6-max Seat #3 is the button
Seat 1: C515ewji10HLkUifdjurhw ($227.25 in chips)
Seat 2: 7SUIdtQak1SCtldWHjwnFA ($158 in chips)
Seat 3: 3mTlg4g0FJN2bo939h/0Wg ($314 in chips)
Seat 4: /F5e5TKT/1B9kgJVuQttsg ($300 in chips)
Seat 5: 2PHCSXghjbGk2qR6jDFe2g ($406 in chips)
Seat 6: kem0o3a/3AcDZBJg3cdvpQ ($170 in chips)
/F5e5TKT/1B9kgJVuQttsg: posts small blind $5
2PHCSXghjbGk2qR6jDFe2g: posts big blind $10
*** HOLE CARDS ***
kem0o3a/3AcDZBJg3cdvpQ: folds
C515ewji10HLkUifdjurhw: folds
7SUIdtQak1SCtldWHjwnFA: folds
3mTlg4g0FJN2bo939h/0Wg: raises $10 to $20
/F5e5TKT/1B9kgJVuQttsg: raises $280 to $300 and is all-in
2PHCSXghjbGk2qR6jDFe2g has timed out
2PHCSXghjbGk2qR6jDFe2g: folds
2PHCSXghjbGk2qR6jDFe2g is sitting out
2PHCSXghjbGk2qR6jDFe2g has returned
3mTlg4g0FJN2bo939h/0Wg: folds
/F5e5TKT/1B9kgJVuQttsg collected $50 from pot
/F5e5TKT/1B9kgJVuQttsg: doesn't show hand
*** SUMMARY ***
Total pot $50 | Rake $0
Seat 1: C515ewji10HLkUifdjurhw folded before Flop (didn't bet)
Seat 2: 7SUIdtQak1SCtldWHjwnFA folded before Flop (didn't bet)
Seat 3: 3mTlg4g0FJN2bo939h/0Wg (button) folded before Flop
Seat 4: /F5e5TKT/1B9kgJVuQttsg (small blind) collected ($50)
Seat 5: 2PHCSXghjbGk2qR6jDFe2g (big blind) folded before Flop
Seat 6: kem0o3a/3AcDZBJg3cdvpQ folded before Flop (didn't bet)



PokerStars Game #59963795868:  Hold'em No Limit ($5/$10) - 2009/07/01 11:59:35 ET
Table 'AI1fZ7Tsbf9DI8mC4EWoQQ' 9-max Seat #3 is the button
Seat 2: voSAIKXtXUUbJnds83sYfQ ($1077 in chips)
Seat 3: ZaYCGtNHUeItoUEheoYDMw ($357 in chips)
Seat 4: efhcaDPhNqQ/H48kMHLa8w ($1000 in chips)
Seat 5: 2PHCSXghjbGk2qR6jDFe2g ($1012 in chips)
Seat 6: l9mDFuns/ycIDiFx40BMVw ($820 in chips)
Seat 7: ettgJAblGnistIlqNz4Jww ($1000 in chips)
Seat 8: UgBUE0pOJDwUdQ53XJt8MQ ($120 in chips)
Seat 9: 1s1h7qXmZxmowl9P1VNe2Q ($224.75 in chips)
efhcaDPhNqQ/H48kMHLa8w: posts small blind $5
2PHCSXghjbGk2qR6jDFe2g: posts big blind $10
*** HOLE CARDS ***
l9mDFuns/ycIDiFx40BMVw: folds
ettgJAblGnistIlqNz4Jww: folds
UgBUE0pOJDwUdQ53XJt8MQ: folds
1s1h7qXmZxmowl9P1VNe2Q: folds
voSAIKXtXUUbJnds83sYfQ: raises $20 to $30
ZaYCGtNHUeItoUEheoYDMw: folds
efhcaDPhNqQ/H48kMHLa8w: folds
2PHCSXghjbGk2qR6jDFe2g: folds
voSAIKXtXUUbJnds83sYfQ collected $25 from pot
*** SUMMARY ***
Total pot $25 | Rake $0
Seat 2: voSAIKXtXUUbJnds83sYfQ collected ($25)
Seat 3: ZaYCGtNHUeItoUEheoYDMw (button) folded before Flop (didn't bet)
Seat 4: efhcaDPhNqQ/H48kMHLa8w (small blind) folded before Flop
Seat 5: 2PHCSXghjbGk2qR6jDFe2g (big blind) folded before Flop
Seat 6: l9mDFuns/ycIDiFx40BMVw folded before Flop (didn't bet)
Seat 7: ettgJAblGnistIlqNz4Jww folded before Flop (didn't bet)
Seat 8: UgBUE0pOJDwUdQ53XJt8MQ folded before Flop (didn't bet)
Seat 9: 1s1h7qXmZxmowl9P1VNe2Q folded before Flop (didn't bet)



PokerStars Game #59963809494:  Hold'em No Limit ($5/$10) - 2009/07/01 11:59:51 ET
Table '1Dt9cpcLUVE6HYkx5dUEdQ' 6-max Seat #4 is the button
Seat 1: Xl+I49lxCJwPGRuegiaHoA ($1414 in chips)
Seat 2: zdS2zKkZYSRe8p+GVcXMgg ($1885.10 in chips)
Seat 3: Lne9leXjEzXWbU3BGFWsxQ ($1096 in chips)
Seat 4: voSAIKXtXUUbJnds83sYfQ ($1738.75 in chips)
Seat 5: 1ScqYmNf7/uWx1XSBgPTBw ($175 in chips)
Seat 6: efhcaDPhNqQ/H48kMHLa8w ($1917 in chips)
1ScqYmNf7/uWx1XSBgPTBw: posts small blind $5
efhcaDPhNqQ/H48kMHLa8w: posts big blind $10
*** HOLE CARDS ***
Xl+I49lxCJwPGRuegiaHoA: raises $20 to $30
zdS2zKkZYSRe8p+GVcXMgg: folds
Lne9leXjEzXWbU3BGFWsxQ: folds
voSAIKXtXUUbJnds83sYfQ: folds
1ScqYmNf7/uWx1XSBgPTBw: folds
efhcaDPhNqQ/H48kMHLa8w: calls $20
*** FLOP *** [7s 8s Kd]
efhcaDPhNqQ/H48kMHLa8w: checks
Xl+I49lxCJwPGRuegiaHoA: bets $50
efhcaDPhNqQ/H48kMHLa8w: calls $50
*** TURN *** [7s 8s Kd] [3c]
efhcaDPhNqQ/H48kMHLa8w: checks
Xl+I49lxCJwPGRuegiaHoA: bets $145
efhcaDPhNqQ/H48kMHLa8w: folds
Xl+I49lxCJwPGRuegiaHoA collected $162 from pot
*** SUMMARY ***
Total pot $165 | Rake $3
Board [7s 8s Kd 3c]
Seat 1: Xl+I49lxCJwPGRuegiaHoA collected ($162)
Seat 2: zdS2zKkZYSRe8p+GVcXMgg folded before Flop (didn't bet)
Seat 3: Lne9leXjEzXWbU3BGFWsxQ folded before Flop (didn't bet)
Seat 4: voSAIKXtXUUbJnds83sYfQ (button) folded before Flop (didn't bet)
Seat 5: 1ScqYmNf7/uWx1XSBgPTBw (small blind) folded before Flop
Seat 6: efhcaDPhNqQ/H48kMHLa8w (big blind) folded on the Turn



PokerStars Game #59963825586:  Hold'em No Limit ($5/$10) - 2009/07/01 12:00:07 ET
Table 'dwLGEw3aoH/cOAI7JsLdmw' 6-max Seat #5 is the button
Seat 1: nCI/286bRXONuVN/6Bn49Q ($189 in chips)
Seat 2: 1ScqYmNf7/uWx1XSBgPTBw ($153 in chips)
Seat 3: /F5e5TKT/1B9kgJVuQttsg ($307.75 in chips)
Seat 4: efhcaDPhNqQ/H48kMHLa8w ($1168 in chips)
Seat 5: C515ewji10HLkUifdjurhw ($203.50 in chips)
Seat 6: 3mTlg4g0FJN2bo939h/0Wg ($333.55 in chips)
3mTlg4g0FJN2bo939h/0Wg: posts small blind $5
nCI/286bRXONuVN/6Bn49Q: posts big blind $10
*** HOLE CARDS ***
1ScqYmNf7/uWx1XSBgPTBw: folds
/F5e5TKT/1B9kgJVuQttsg: folds
efhcaDPhNqQ/H48kMHLa8w: folds
C515ewji10HLkUifdjurhw: folds
3mTlg4g0FJN2bo939h/0Wg: raises $20 to $30
nCI/286bRXONuVN/6Bn49Q: folds
3mTlg4g0FJN2bo939h/0Wg collected $20 from pot
3mTlg4g0FJN2bo939h/0Wg: doesn't show hand
*** SUMMARY ***
Total pot $20 | Rake $0
Seat 1: nCI/286bRXONuVN/6Bn49Q (big blind) folded before Flop
Seat 2: 1ScqYmNf7/uWx1XSBgPTBw folded before Flop (didn't bet)
Seat 3: /F5e5TKT/1B9kgJVuQttsg folded before Flop (didn't bet)
Seat 4: efhcaDPhNqQ/H48kMHLa8w folded before Flop (didn't bet)
Seat 5: C515ewji10HLkUifdjurhw (button) folded before Flop (didn't bet)
Seat 6: 3mTlg4g0FJN2bo939h/0Wg (small blind) collected ($20)



PokerStars Game #59963832152:  Hold'em No Limit ($5/$10) - 2009/07/01 12:00:14 ET
Table 'AiNa6yyp/njJVRYl/Lz1KQ' 6-max Seat #4 is the button
Seat 1: C515ewji10HLkUifdjurhw ($227.25 in chips)
Seat 2: 7SUIdtQak1SCtldWHjwnFA ($158 in chips)
Seat 3: 3mTlg4g0FJN2bo939h/0Wg ($294 in chips)
Seat 4: /F5e5TKT/1B9kgJVuQttsg ($330 in chips)
Seat 5: 2PHCSXghjbGk2qR6jDFe2g ($396 in chips)
Seat 6: kem0o3a/3AcDZBJg3cdvpQ ($170 in chips)
2PHCSXghjbGk2qR6jDFe2g: posts small blind $5
kem0o3a/3AcDZBJg3cdvpQ: posts big blind $10
*** HOLE CARDS ***
C515ewji10HLkUifdjurhw: folds
7SUIdtQak1SCtldWHjwnFA: raises $12 to $22
3mTlg4g0FJN2bo939h/0Wg: folds
/F5e5TKT/1B9kgJVuQttsg: folds
2PHCSXghjbGk2qR6jDFe2g: folds
kem0o3a/3AcDZBJg3cdvpQ: folds
7SUIdtQak1SCtldWHjwnFA collected $25 from pot
7SUIdtQak1SCtldWHjwnFA: doesn't show hand
*** SUMMARY ***
Total pot $25 | Rake $0
Seat 1: C515ewji10HLkUifdjurhw folded before Flop (didn't bet)
Seat 2: 7SUIdtQak1SCtldWHjwnFA collected ($25)
Seat 3: 3mTlg4g0FJN2bo939h/0Wg folded before Flop (didn't bet)
Seat 4: /F5e5TKT/1B9kgJVuQttsg (button) folded before Flop (didn't bet)
Seat 5: 2PHCSXghjbGk2qR6jDFe2g (small blind) folded before Flop
Seat 6: kem0o3a/3AcDZBJg3cdvpQ (big blind) folded before Flop



PokerStars Game #59963837600:  Hold'em No Limit ($5/$10) - 2009/07/01 12:00:21 ET
Table 'AI1fZ7Tsbf9DI8mC4EWoQQ' 9-max Seat #4 is the button
Seat 2: voSAIKXtXUUbJnds83sYfQ ($1092 in chips)
Seat 3: ZaYCGtNHUeItoUEheoYDMw ($357 in chips)
Seat 4: efhcaDPhNqQ/H48kMHLa8w ($1000 in chips)
Seat 5: 2PHCSXghjbGk2qR6jDFe2g ($1002 in chips)
Seat 6: l9mDFuns/ycIDiFx40BMVw ($820 in chips)
Seat 7: ettgJAblGnistIlqNz4Jww ($1000 in chips)
Seat 8: UgBUE0pOJDwUdQ53XJt8MQ ($120 in chips)
Seat 9: 1s1h7qXmZxmowl9P1VNe2Q ($224.75 in chips)
2PHCSXghjbGk2qR6jDFe2g: posts small blind $5
l9mDFuns/ycIDiFx40BMVw: posts big blind $10
*** HOLE CARDS ***
ettgJAblGnistIlqNz4Jww: folds
UgBUE0pOJDwUdQ53XJt8MQ: folds
1s1h7qXmZxmowl9P1VNe2Q: folds
voSAIKXtXUUbJnds83sYfQ: raises $20 to $30
ZaYCGtNHUeItoUEheoYDMw: folds
efhcaDPhNqQ/H48kMHLa8w: folds
2PHCSXghjbGk2qR6jDFe2g: folds
l9mDFuns/ycIDiFx40BMVw: folds
voSAIKXtXUUbJnds83sYfQ collected $25 from pot
*** SUMMARY ***
Total pot $25 | Rake $0
Seat 2: voSAIKXtXUUbJnds83sYfQ collected ($25)
Seat 3: ZaYCGtNHUeItoUEheoYDMw folded before Flop (didn't bet)
Seat 4: efhcaDPhNqQ/H48kMHLa8w (button) folded before Flop (didn't bet)
Seat 5: 2PHCSXghjbGk2qR6jDFe2g (small blind) folded before Flop
Seat 6: l9mDFuns/ycIDiFx40BMVw (big blind) folded before Flop
Seat 7: ettgJAblGnistIlqNz4Jww folded before Flop (didn't bet)
Seat 8: UgBUE0pOJDwUdQ53XJt8MQ folded before Flop (didn't bet)
Seat 9: 1s1h7qXmZxmowl9P1VNe2Q folded before Flop (didn't bet)



PokerStars Game #59963850740:  Hold'em No Limit ($5/$10) - 2009/07/01 12:00:36 ET
Table 'AiNa6yyp/njJVRYl/Lz1KQ' 6-max Seat #5 is the button
Seat 1: C515ewji10HLkUifdjurhw ($227.25 in chips)
Seat 2: 7SUIdtQak1SCtldWHjwnFA ($173 in chips)
Seat 3: 3mTlg4g0FJN2bo939h/0Wg ($294 in chips)
Seat 4: /F5e5TKT/1B9kgJVuQttsg ($330 in chips)
Seat 5: 2PHCSXghjbGk2qR6jDFe2g ($391 in chips)
Seat 6: kem0o3a/3AcDZBJg3cdvpQ ($160 in chips)
kem0o3a/3AcDZBJg3cdvpQ: posts small blind $5
C515ewji10HLkUifdjurhw: posts big blind $10
*** HOLE CARDS ***
7SUIdtQak1SCtldWHjwnFA: folds
3mTlg4g0FJN2bo939h/0Wg: raises $10 to $20
/F5e5TKT/1B9kgJVuQttsg: folds
2PHCSXghjbGk2qR6jDFe2g: folds
kem0o3a/3AcDZBJg3cdvpQ: folds
C515ewji10HLkUifdjurhw: raises $207.25 to $227.25 and is all-in
3mTlg4g0FJN2bo939h/0Wg: folds
C515ewji10HLkUifdjurhw collected $45 from pot
C515ewji10HLkUifdjurhw: doesn't show hand
*** SUMMARY ***
Total pot $45 | Rake $0
Seat 1: C515ewji10HLkUifdjurhw (big blind) collected ($45)
Seat 2: 7SUIdtQak1SCtldWHjwnFA folded before Flop (didn't bet)
Seat 3: 3mTlg4g0FJN2bo939h/0Wg folded before Flop
Seat 4: /F5e5TKT/1B9kgJVuQttsg folded before Flop (didn't bet)
Seat 5: 2PHCSXghjbGk2qR6jDFe2g (button) folded before Flop (didn't bet)
Seat 6: kem0o3a/3AcDZBJg3cdvpQ (small blind) folded before Flop



PokerStars Game #59963853186:  Hold'em No Limit ($5/$10) - 2009/07/01 12:00:39 ET
Table 'dwLGEw3aoH/cOAI7JsLdmw' 6-max Seat #6 is the button
Seat 1: nCI/286bRXONuVN/6Bn49Q ($179 in chips)
Seat 2: 1ScqYmNf7/uWx1XSBgPTBw ($153 in chips)
Seat 3: /F5e5TKT/1B9kgJVuQttsg ($307.75 in chips)
Seat 4: efhcaDPhNqQ/H48kMHLa8w ($1168 in chips)
Seat 5: C515ewji10HLkUifdjurhw ($203.50 in chips)
Seat 6: 3mTlg4g0FJN2bo939h/0Wg ($343.55 in chips)
nCI/286bRXONuVN/6Bn49Q: posts small blind $5
1ScqYmNf7/uWx1XSBgPTBw: posts big blind $10
*** HOLE CARDS ***
/F5e5TKT/1B9kgJVuQttsg: folds
efhcaDPhNqQ/H48kMHLa8w: folds
C515ewji10HLkUifdjurhw: folds
3mTlg4g0FJN2bo939h/0Wg: folds
nCI/286bRXONuVN/6Bn49Q: raises $20 to $30
1ScqYmNf7/uWx1XSBgPTBw: raises $123 to $153 and is all-in
nCI/286bRXONuVN/6Bn49Q: calls $123
*** FLOP *** [9h 6d 5s]
*** TURN *** [9h 6d 5s] [Tc]
*** RIVER *** [9h 6d 5s Tc] [9s]
*** SHOW DOWN ***
nCI/286bRXONuVN/6Bn49Q: shows [6s 6h] (a full house, Sixes full of Nines)
1ScqYmNf7/uWx1XSBgPTBw: mucks hand
nCI/286bRXONuVN/6Bn49Q collected $303 from pot
*** SUMMARY ***
Total pot $306 | Rake $3
Board [9h 6d 5s Tc 9s]
Seat 1: nCI/286bRXONuVN/6Bn49Q (small blind) showed [6s 6h] and won ($303) with a full house, Sixes full of Nines
Seat 2: 1ScqYmNf7/uWx1XSBgPTBw (big blind) mucked
Seat 3: /F5e5TKT/1B9kgJVuQttsg folded before Flop (didn't bet)
Seat 4: efhcaDPhNqQ/H48kMHLa8w folded before Flop (didn't bet)
Seat 5: C515ewji10HLkUifdjurhw folded before Flop (didn't bet)
Seat 6: 3mTlg4g0FJN2bo939h/0Wg (button) folded before Flop (didn't bet)



PokerStars Game #59963863714:  Hold'em No Limit ($5/$10) - 2009/07/01 12:00:50 ET
Table '1Dt9cpcLUVE6HYkx5dUEdQ' 6-max Seat #5 is the button
Seat 1: Xl+I49lxCJwPGRuegiaHoA ($1496 in chips)
Seat 2: zdS2zKkZYSRe8p+GVcXMgg ($1885.10 in chips)
Seat 3: Lne9leXjEzXWbU3BGFWsxQ ($1096 in chips)
Seat 4: voSAIKXtXUUbJnds83sYfQ ($1738.75 in chips)
Seat 5: 1ScqYmNf7/uWx1XSBgPTBw ($170 in chips)
Seat 6: efhcaDPhNqQ/H48kMHLa8w ($1837 in chips)
efhcaDPhNqQ/H48kMHLa8w: posts small blind $5
Xl+I49lxCJwPGRuegiaHoA: posts big blind $10
*** HOLE CARDS ***
zdS2zKkZYSRe8p+GVcXMgg: folds
Lne9leXjEzXWbU3BGFWsxQ: folds
voSAIKXtXUUbJnds83sYfQ: folds
1ScqYmNf7/uWx1XSBgPTBw: folds
efhcaDPhNqQ/H48kMHLa8w: folds
Xl+I49lxCJwPGRuegiaHoA collected $10 from pot
*** SUMMARY ***
Total pot $10 | Rake $0
Seat 1: Xl+I49lxCJwPGRuegiaHoA (big blind) collected ($10)
Seat 2: zdS2zKkZYSRe8p+GVcXMgg folded before Flop (didn't bet)
Seat 3: Lne9leXjEzXWbU3BGFWsxQ folded before Flop (didn't bet)
Seat 4: voSAIKXtXUUbJnds83sYfQ folded before Flop (didn't bet)
Seat 5: 1ScqYmNf7/uWx1XSBgPTBw (button) folded before Flop (didn't bet)
Seat 6: efhcaDPhNqQ/H48kMHLa8w (small blind) folded before Flop



PokerStars Game #59963870180:  Hold'em No Limit ($5/$10) - 2009/07/01 12:00:58 ET
Table 'AI1fZ7Tsbf9DI8mC4EWoQQ' 9-max Seat #5 is the button
Seat 2: voSAIKXtXUUbJnds83sYfQ ($1107 in chips)
Seat 3: ZaYCGtNHUeItoUEheoYDMw ($357 in chips)
Seat 4: efhcaDPhNqQ/H48kMHLa8w ($1000 in chips)
Seat 5: 2PHCSXghjbGk2qR6jDFe2g ($997 in chips)
Seat 6: l9mDFuns/ycIDiFx40BMVw ($810 in chips)
Seat 7: ettgJAblGnistIlqNz4Jww ($1000 in chips)
Seat 8: UgBUE0pOJDwUdQ53XJt8MQ ($120 in chips)
Seat 9: 1s1h7qXmZxmowl9P1VNe2Q ($224.75 in chips)
l9mDFuns/ycIDiFx40BMVw: posts small blind $5
ettgJAblGnistIlqNz4Jww: posts big blind $10
*** HOLE CARDS ***
UgBUE0pOJDwUdQ53XJt8MQ: folds
1s1h7qXmZxmowl9P1VNe2Q: folds
voSAIKXtXUUbJnds83sYfQ: raises $20 to $30
ZaYCGtNHUeItoUEheoYDMw: folds
efhcaDPhNqQ/H48kMHLa8w: calls $30
2PHCSXghjbGk2qR6jDFe2g: folds
l9mDFuns/ycIDiFx40BMVw: folds
ettgJAblGnistIlqNz4Jww: folds
*** FLOP *** [9d 4h Th]
voSAIKXtXUUbJnds83sYfQ: checks
efhcaDPhNqQ/H48kMHLa8w: checks
*** TURN *** [9d 4h Th] [7c]
voSAIKXtXUUbJnds83sYfQ: bets $50
efhcaDPhNqQ/H48kMHLa8w: folds
voSAIKXtXUUbJnds83sYfQ collected $72 from pot
voSAIKXtXUUbJnds83sYfQ: doesn't show hand
*** SUMMARY ***
Total pot $75 | Rake $3
Board [9d 4h Th 7c]
Seat 2: voSAIKXtXUUbJnds83sYfQ collected ($72)
Seat 3: ZaYCGtNHUeItoUEheoYDMw folded before Flop (didn't bet)
Seat 4: efhcaDPhNqQ/H48kMHLa8w folded on the Turn
Seat 5: 2PHCSXghjbGk2qR6jDFe2g (button) folded before Flop (didn't bet)
Seat 6: l9mDFuns/ycIDiFx40BMVw (small blind) folded before Flop
Seat 7: ettgJAblGnistIlqNz4Jww (big blind) folded before Flop
Seat 8: UgBUE0pOJDwUdQ53XJt8MQ folded before Flop (didn't bet)
Seat 9: 1s1h7qXmZxmowl9P1VNe2Q folded before Flop (didn't bet)



PokerStars Game #59963874616:  Hold'em No Limit ($5/$10) - 2009/07/01 12:01:02 ET
Table 'AiNa6yyp/njJVRYl/Lz1KQ' 6-max Seat #6 is the button
Seat 1: C515ewji10HLkUifdjurhw ($252.25 in chips)
Seat 2: 7SUIdtQak1SCtldWHjwnFA ($173 in chips)
Seat 3: 3mTlg4g0FJN2bo939h/0Wg ($274 in chips)
Seat 4: /F5e5TKT/1B9kgJVuQttsg ($330 in chips)
Seat 5: 2PHCSXghjbGk2qR6jDFe2g ($391 in chips)
Seat 6: kem0o3a/3AcDZBJg3cdvpQ ($200 in chips)
C515ewji10HLkUifdjurhw: posts small blind $5
7SUIdtQak1SCtldWHjwnFA: posts big blind $10
*** HOLE CARDS ***
3mTlg4g0FJN2bo939h/0Wg: folds
/F5e5TKT/1B9kgJVuQttsg: folds
2PHCSXghjbGk2qR6jDFe2g: folds
kem0o3a/3AcDZBJg3cdvpQ: folds
C515ewji10HLkUifdjurhw: folds
7SUIdtQak1SCtldWHjwnFA collected $10 from pot
7SUIdtQak1SCtldWHjwnFA: doesn't show hand
*** SUMMARY ***
Total pot $10 | Rake $0
Seat 1: C515ewji10HLkUifdjurhw (small blind) folded before Flop
Seat 2: 7SUIdtQak1SCtldWHjwnFA (big blind) collected ($10)
Seat 3: 3mTlg4g0FJN2bo939h/0Wg folded before Flop (didn't bet)
Seat 4: /F5e5TKT/1B9kgJVuQttsg folded before Flop (didn't bet)
Seat 5: 2PHCSXghjbGk2qR6jDFe2g folded before Flop (didn't bet)
Seat 6: kem0o3a/3AcDZBJg3cdvpQ (button) folded before Flop (didn't bet)



PokerStars Game #59963877784:  Hold'em No Limit ($5/$10) - 2009/07/01 12:01:06 ET
Table '1Dt9cpcLUVE6HYkx5dUEdQ' 6-max Seat #6 is the button
Seat 1: Xl+I49lxCJwPGRuegiaHoA ($1501 in chips)
Seat 2: zdS2zKkZYSRe8p+GVcXMgg ($1885.10 in chips)
Seat 3: Lne9leXjEzXWbU3BGFWsxQ ($1096 in chips)
Seat 4: voSAIKXtXUUbJnds83sYfQ ($1738.75 in chips)
Seat 5: 1ScqYmNf7/uWx1XSBgPTBw ($170 in chips)
Seat 6: efhcaDPhNqQ/H48kMHLa8w ($1832 in chips)
Xl+I49lxCJwPGRuegiaHoA: posts small blind $5
zdS2zKkZYSRe8p+GVcXMgg: posts big blind $10
*** HOLE CARDS ***
Lne9leXjEzXWbU3BGFWsxQ: folds
voSAIKXtXUUbJnds83sYfQ: folds
1ScqYmNf7/uWx1XSBgPTBw: folds
efhcaDPhNqQ/H48kMHLa8w: raises $10 to $20
Xl+I49lxCJwPGRuegiaHoA: raises $70 to $90
zdS2zKkZYSRe8p+GVcXMgg: folds
efhcaDPhNqQ/H48kMHLa8w: raises $150 to $240
Xl+I49lxCJwPGRuegiaHoA: folds
efhcaDPhNqQ/H48kMHLa8w collected $190 from pot
*** SUMMARY ***
Total pot $190 | Rake $0
Seat 1: Xl+I49lxCJwPGRuegiaHoA (small blind) folded before Flop
Seat 2: zdS2zKkZYSRe8p+GVcXMgg (big blind) folded before Flop
Seat 3: Lne9leXjEzXWbU3BGFWsxQ folded before Flop (didn't bet)
Seat 4: voSAIKXtXUUbJnds83sYfQ folded before Flop (didn't bet)
Seat 5: 1ScqYmNf7/uWx1XSBgPTBw folded before Flop (didn't bet)
Seat 6: efhcaDPhNqQ/H48kMHLa8w (button) collected ($190)



PokerStars Game #59963887650:  Hold'em No Limit ($5/$10) - 2009/07/01 12:01:17 ET
Table 'AiNa6yyp/njJVRYl/Lz1KQ' 6-max Seat #1 is the button
Seat 1: C515ewji10HLkUifdjurhw ($247.25 in chips)
Seat 2: 7SUIdtQak1SCtldWHjwnFA ($178 in chips)
Seat 3: 3mTlg4g0FJN2bo939h/0Wg ($274 in chips)
Seat 4: /F5e5TKT/1B9kgJVuQttsg ($330 in chips)
Seat 5: 2PHCSXghjbGk2qR6jDFe2g ($391 in chips)
Seat 6: kem0o3a/3AcDZBJg3cdvpQ ($200 in chips)
7SUIdtQak1SCtldWHjwnFA: posts small blind $5
3mTlg4g0FJN2bo939h/0Wg: posts big blind $10
*** HOLE CARDS ***
/F5e5TKT/1B9kgJVuQttsg: folds
2PHCSXghjbGk2qR6jDFe2g: folds
kem0o3a/3AcDZBJg3cdvpQ: folds
C515ewji10HLkUifdjurhw: folds
7SUIdtQak1SCtldWHjwnFA: folds
3mTlg4g0FJN2bo939h/0Wg collected $10 from pot
*** SUMMARY ***
Total pot $10 | Rake $0
Seat 1: C515ewji10HLkUifdjurhw (button) folded before Flop (didn't bet)
Seat 2: 7SUIdtQak1SCtldWHjwnFA (small blind) folded before Flop
Seat 3: 3mTlg4g0FJN2bo939h/0Wg (big blind) collected ($10)
Seat 4: /F5e5TKT/1B9kgJVuQttsg folded before Flop (didn't bet)
Seat 5: 2PHCSXghjbGk2qR6jDFe2g folded before Flop (didn't bet)
Seat 6: kem0o3a/3AcDZBJg3cdvpQ folded before Flop (didn't bet)



PokerStars Game #59963894282:  Hold'em No Limit ($5/$10) - 2009/07/01 12:01:25 ET
Table 'dwLGEw3aoH/cOAI7JsLdmw' 6-max Seat #1 is the button
Seat 1: nCI/286bRXONuVN/6Bn49Q ($329 in chips)
Seat 2: 1ScqYmNf7/uWx1XSBgPTBw ($200 in chips)
Seat 3: /F5e5TKT/1B9kgJVuQttsg ($307.75 in chips)
Seat 4: efhcaDPhNqQ/H48kMHLa8w ($1168 in chips)
Seat 5: C515ewji10HLkUifdjurhw ($203.50 in chips)
Seat 6: 3mTlg4g0FJN2bo939h/0Wg ($343.55 in chips)
1ScqYmNf7/uWx1XSBgPTBw: posts small blind $5
/F5e5TKT/1B9kgJVuQttsg: posts big blind $10
*** HOLE CARDS ***
efhcaDPhNqQ/H48kMHLa8w: folds
C515ewji10HLkUifdjurhw: folds
3mTlg4g0FJN2bo939h/0Wg: folds
nCI/286bRXONuVN/6Bn49Q: folds
1ScqYmNf7/uWx1XSBgPTBw: folds
/F5e5TKT/1B9kgJVuQttsg collected $10 from pot
*** SUMMARY ***
Total pot $10 | Rake $0
Seat 1: nCI/286bRXONuVN/6Bn49Q (button) folded before Flop (didn't bet)
Seat 2: 1ScqYmNf7/uWx1XSBgPTBw (small blind) folded before Flop
Seat 3: /F5e5TKT/1B9kgJVuQttsg (big blind) collected ($10)
Seat 4: efhcaDPhNqQ/H48kMHLa8w folded before Flop (didn't bet)
Seat 5: C515ewji10HLkUifdjurhw folded before Flop (didn't bet)
Seat 6: 3mTlg4g0FJN2bo939h/0Wg folded before Flop (didn't bet)



PokerStars Game #59963906660:  Hold'em No Limit ($5/$10) - 2009/07/01 12:01:38 ET
Table 'AiNa6yyp/njJVRYl/Lz1KQ' 6-max Seat #2 is the button
Seat 1: C515ewji10HLkUifdjurhw ($247.25 in chips)
Seat 2: 7SUIdtQak1SCtldWHjwnFA ($173 in chips)
Seat 3: 3mTlg4g0FJN2bo939h/0Wg ($279 in chips)
Seat 4: /F5e5TKT/1B9kgJVuQttsg ($330 in chips)
Seat 5: 2PHCSXghjbGk2qR6jDFe2g ($391 in chips)
Seat 6: kem0o3a/3AcDZBJg3cdvpQ ($200 in chips)
3mTlg4g0FJN2bo939h/0Wg: posts small blind $5
/F5e5TKT/1B9kgJVuQttsg: posts big blind $10
*** HOLE CARDS ***
2PHCSXghjbGk2qR6jDFe2g: raises $10 to $20
kem0o3a/3AcDZBJg3cdvpQ: folds
C515ewji10HLkUifdjurhw: folds
7SUIdtQak1SCtldWHjwnFA: raises $35 to $55
3mTlg4g0FJN2bo939h/0Wg: folds
/F5e5TKT/1B9kgJVuQttsg: folds
2PHCSXghjbGk2qR6jDFe2g: calls $35
*** FLOP *** [Jc 5h As]
2PHCSXghjbGk2qR6jDFe2g: checks
7SUIdtQak1SCtldWHjwnFA: checks
*** TURN *** [Jc 5h As] [3d]
2PHCSXghjbGk2qR6jDFe2g: checks
7SUIdtQak1SCtldWHjwnFA: bets $118 and is all-in
2PHCSXghjbGk2qR6jDFe2g: folds
7SUIdtQak1SCtldWHjwnFA collected $122 from pot
7SUIdtQak1SCtldWHjwnFA: doesn't show hand
*** SUMMARY ***
Total pot $125 | Rake $3
Board [Jc 5h As 3d]
Seat 1: C515ewji10HLkUifdjurhw folded before Flop (didn't bet)
Seat 2: 7SUIdtQak1SCtldWHjwnFA (button) collected ($122)
Seat 3: 3mTlg4g0FJN2bo939h/0Wg (small blind) folded before Flop
Seat 4: /F5e5TKT/1B9kgJVuQttsg (big blind) folded before Flop
Seat 5: 2PHCSXghjbGk2qR6jDFe2g folded on the Turn
Seat 6: kem0o3a/3AcDZBJg3cdvpQ folded before Flop (didn't bet)



PokerStars Game #59963912538:  Hold'em No Limit ($5/$10) - 2009/07/01 12:01:45 ET
Table '1Dt9cpcLUVE6HYkx5dUEdQ' 6-max Seat #1 is the button
Seat 1: Xl+I49lxCJwPGRuegiaHoA ($1411 in chips)
Seat 2: zdS2zKkZYSRe8p+GVcXMgg ($1875.10 in chips)
Seat 3: Lne9leXjEzXWbU3BGFWsxQ ($1096 in chips)
Seat 4: voSAIKXtXUUbJnds83sYfQ ($1738.75 in chips)
Seat 5: 1ScqYmNf7/uWx1XSBgPTBw ($170 in chips)
Seat 6: efhcaDPhNqQ/H48kMHLa8w ($1932 in chips)
zdS2zKkZYSRe8p+GVcXMgg: posts small blind $5
Lne9leXjEzXWbU3BGFWsxQ: posts big blind $10
*** HOLE CARDS ***
voSAIKXtXUUbJnds83sYfQ: folds
1ScqYmNf7/uWx1XSBgPTBw: folds
efhcaDPhNqQ/H48kMHLa8w: raises $20 to $30
Xl+I49lxCJwPGRuegiaHoA: calls $30
zdS2zKkZYSRe8p+GVcXMgg: raises $70 to $100
Lne9leXjEzXWbU3BGFWsxQ: folds
efhcaDPhNqQ/H48kMHLa8w: calls $70
Xl+I49lxCJwPGRuegiaHoA: calls $70
*** FLOP *** [4s 2s 9c]
zdS2zKkZYSRe8p+GVcXMgg: checks
efhcaDPhNqQ/H48kMHLa8w: checks
Xl+I49lxCJwPGRuegiaHoA: bets $145
zdS2zKkZYSRe8p+GVcXMgg: calls $145
efhcaDPhNqQ/H48kMHLa8w: folds
*** TURN *** [4s 2s 9c] [Jc]
zdS2zKkZYSRe8p+GVcXMgg: bets $125
Xl+I49lxCJwPGRuegiaHoA: folds
zdS2zKkZYSRe8p+GVcXMgg collected $597 from pot
*** SUMMARY ***
Total pot $600 | Rake $3
Board [4s 2s 9c Jc]
Seat 1: Xl+I49lxCJwPGRuegiaHoA (button) folded on the Turn
Seat 2: zdS2zKkZYSRe8p+GVcXMgg (small blind) collected ($597)
Seat 3: Lne9leXjEzXWbU3BGFWsxQ (big blind) folded before Flop
Seat 4: voSAIKXtXUUbJnds83sYfQ folded before Flop (didn't bet)
Seat 5: 1ScqYmNf7/uWx1XSBgPTBw folded before Flop (didn't bet)
Seat 6: efhcaDPhNqQ/H48kMHLa8w folded on the Flop



PokerStars Game #59963920128:  Hold'em No Limit ($5/$10) - 2009/07/01 12:01:54 ET
Table 'dwLGEw3aoH/cOAI7JsLdmw' 6-max Seat #2 is the button
Seat 1: nCI/286bRXONuVN/6Bn49Q ($329 in chips)
Seat 2: 1ScqYmNf7/uWx1XSBgPTBw ($195 in chips)
Seat 3: /F5e5TKT/1B9kgJVuQttsg ($312.75 in chips)
Seat 4: efhcaDPhNqQ/H48kMHLa8w ($1168 in chips)
Seat 5: C515ewji10HLkUifdjurhw ($203.50 in chips)
Seat 6: 3mTlg4g0FJN2bo939h/0Wg ($343.55 in chips)
/F5e5TKT/1B9kgJVuQttsg: posts small blind $5
efhcaDPhNqQ/H48kMHLa8w: posts big blind $10
*** HOLE CARDS ***
C515ewji10HLkUifdjurhw: folds
3mTlg4g0FJN2bo939h/0Wg: raises $10 to $20
nCI/286bRXONuVN/6Bn49Q: folds
1ScqYmNf7/uWx1XSBgPTBw: folds
/F5e5TKT/1B9kgJVuQttsg: folds
efhcaDPhNqQ/H48kMHLa8w: folds
3mTlg4g0FJN2bo939h/0Wg collected $25 from pot
*** SUMMARY ***
Total pot $25 | Rake $0
Seat 1: nCI/286bRXONuVN/6Bn49Q folded before Flop (didn't bet)
Seat 2: 1ScqYmNf7/uWx1XSBgPTBw (button) folded before Flop (didn't bet)
Seat 3: /F5e5TKT/1B9kgJVuQttsg (small blind) folded before Flop
Seat 4: efhcaDPhNqQ/H48kMHLa8w (big blind) folded before Flop
Seat 5: C515ewji10HLkUifdjurhw folded before Flop (didn't bet)
Seat 6: 3mTlg4g0FJN2bo939h/0Wg collected ($25)



PokerStars Game #59963935644:  Hold'em No Limit ($5/$10) - 2009/07/01 12:02:08 ET
Table '2a86NK3xhs21kwGZmbj0QA' 6-max Seat #4 is the button
Seat 1: nCI/286bRXONuVN/6Bn49Q ($200 in chips)
Seat 2: Xl+I49lxCJwPGRuegiaHoA ($3511 in chips)
Seat 3: voSAIKXtXUUbJnds83sYfQ ($1094 in chips)
Seat 4: 1ScqYmNf7/uWx1XSBgPTBw ($180 in chips)
Seat 5: efhcaDPhNqQ/H48kMHLa8w ($1067 in chips)
Seat 6: 0OfLwED3kKs3FwY+JlHC0g ($1242 in chips)
efhcaDPhNqQ/H48kMHLa8w: posts small blind $5
0OfLwED3kKs3FwY+JlHC0g: posts big blind $10
*** HOLE CARDS ***
nCI/286bRXONuVN/6Bn49Q: raises $15 to $25
Xl+I49lxCJwPGRuegiaHoA: folds
voSAIKXtXUUbJnds83sYfQ: folds
1ScqYmNf7/uWx1XSBgPTBw: folds
efhcaDPhNqQ/H48kMHLa8w: raises $55 to $80
0OfLwED3kKs3FwY+JlHC0g: folds
nCI/286bRXONuVN/6Bn49Q: calls $55
*** FLOP *** [3h 7c 4h]
efhcaDPhNqQ/H48kMHLa8w: checks
nCI/286bRXONuVN/6Bn49Q: checks
*** TURN *** [3h 7c 4h] [8s]
efhcaDPhNqQ/H48kMHLa8w: checks
nCI/286bRXONuVN/6Bn49Q: checks
*** RIVER *** [3h 7c 4h 8s] [9c]
efhcaDPhNqQ/H48kMHLa8w: checks
nCI/286bRXONuVN/6Bn49Q: checks
*** SHOW DOWN ***
efhcaDPhNqQ/H48kMHLa8w: shows [Qc Ac] (high card Ace)
nCI/286bRXONuVN/6Bn49Q: mucks hand
efhcaDPhNqQ/H48kMHLa8w collected $167 from pot
*** SUMMARY ***
Total pot $170 | Rake $3
Board [3h 7c 4h 8s 9c]
Seat 1: nCI/286bRXONuVN/6Bn49Q mucked
Seat 2: Xl+I49lxCJwPGRuegiaHoA folded before Flop (didn't bet)
Seat 3: voSAIKXtXUUbJnds83sYfQ folded before Flop (didn't bet)
Seat 4: 1ScqYmNf7/uWx1XSBgPTBw (button) folded before Flop (didn't bet)
Seat 5: efhcaDPhNqQ/H48kMHLa8w (small blind) showed [Qc Ac] and won ($167) with high card Ace
Seat 6: 0OfLwED3kKs3FwY+JlHC0g (big blind) folded before Flop



PokerStars Game #59963940012:  Hold'em No Limit ($5/$10) - 2009/07/01 12:02:13 ET
Table 'AiNa6yyp/njJVRYl/Lz1KQ' 6-max Seat #3 is the button
Seat 1: C515ewji10HLkUifdjurhw ($247.25 in chips)
Seat 2: 7SUIdtQak1SCtldWHjwnFA ($240 in chips)
Seat 3: 3mTlg4g0FJN2bo939h/0Wg ($274 in chips)
Seat 4: /F5e5TKT/1B9kgJVuQttsg ($320 in chips)
Seat 5: 2PHCSXghjbGk2qR6jDFe2g ($336 in chips)
Seat 6: kem0o3a/3AcDZBJg3cdvpQ ($200 in chips)
/F5e5TKT/1B9kgJVuQttsg: posts small blind $5
2PHCSXghjbGk2qR6jDFe2g: posts big blind $10
*** HOLE CARDS ***
kem0o3a/3AcDZBJg3cdvpQ: folds
C515ewji10HLkUifdjurhw: folds
7SUIdtQak1SCtldWHjwnFA: raises $12 to $22
3mTlg4g0FJN2bo939h/0Wg: folds
/F5e5TKT/1B9kgJVuQttsg: folds
2PHCSXghjbGk2qR6jDFe2g: folds
7SUIdtQak1SCtldWHjwnFA collected $25 from pot
7SUIdtQak1SCtldWHjwnFA: doesn't show hand
*** SUMMARY ***
Total pot $25 | Rake $0
Seat 1: C515ewji10HLkUifdjurhw folded before Flop (didn't bet)
Seat 2: 7SUIdtQak1SCtldWHjwnFA collected ($25)
Seat 3: 3mTlg4g0FJN2bo939h/0Wg (button) folded before Flop (didn't bet)
Seat 4: /F5e5TKT/1B9kgJVuQttsg (small blind) folded before Flop
Seat 5: 2PHCSXghjbGk2qR6jDFe2g (big blind) folded before Flop
Seat 6: kem0o3a/3AcDZBJg3cdvpQ folded before Flop (didn't bet)



PokerStars Game #59963946942:  Hold'em No Limit ($5/$10) - 2009/07/01 12:02:21 ET
Table 'AI1fZ7Tsbf9DI8mC4EWoQQ' 9-max Seat #6 is the button
Seat 2: voSAIKXtXUUbJnds83sYfQ ($1149 in chips)
Seat 3: ZaYCGtNHUeItoUEheoYDMw ($357 in chips)
Seat 4: efhcaDPhNqQ/H48kMHLa8w ($1000 in chips)
Seat 5: 2PHCSXghjbGk2qR6jDFe2g ($997 in chips)
Seat 6: l9mDFuns/ycIDiFx40BMVw ($805 in chips)
Seat 7: ettgJAblGnistIlqNz4Jww ($1000 in chips)
Seat 8: UgBUE0pOJDwUdQ53XJt8MQ ($120 in chips)
Seat 9: 1s1h7qXmZxmowl9P1VNe2Q ($224.75 in chips)
ettgJAblGnistIlqNz4Jww: posts small blind $5
UgBUE0pOJDwUdQ53XJt8MQ: posts big blind $10
*** HOLE CARDS ***
1s1h7qXmZxmowl9P1VNe2Q: folds
voSAIKXtXUUbJnds83sYfQ: folds
ZaYCGtNHUeItoUEheoYDMw: folds
efhcaDPhNqQ/H48kMHLa8w: folds
2PHCSXghjbGk2qR6jDFe2g: folds
l9mDFuns/ycIDiFx40BMVw: raises $20 to $30
ettgJAblGnistIlqNz4Jww: folds
UgBUE0pOJDwUdQ53XJt8MQ: folds
l9mDFuns/ycIDiFx40BMVw collected $25 from pot
l9mDFuns/ycIDiFx40BMVw: doesn't show hand
*** SUMMARY ***
Total pot $25 | Rake $0
Seat 2: voSAIKXtXUUbJnds83sYfQ folded before Flop (didn't bet)
Seat 3: ZaYCGtNHUeItoUEheoYDMw folded before Flop (didn't bet)
Seat 4: efhcaDPhNqQ/H48kMHLa8w folded before Flop (didn't bet)
Seat 5: 2PHCSXghjbGk2qR6jDFe2g folded before Flop (didn't bet)
Seat 6: l9mDFuns/ycIDiFx40BMVw (button) collected ($25)
Seat 7: ettgJAblGnistIlqNz4Jww (small blind) folded before Flop
Seat 8: UgBUE0pOJDwUdQ53XJt8MQ (big blind) folded before Flop
Seat 9: 1s1h7qXmZxmowl9P1VNe2Q folded before Flop (didn't bet)



PokerStars Game #59963949436:  Hold'em No Limit ($5/$10) - 2009/07/01 12:02:23 ET
Table 'dwLGEw3aoH/cOAI7JsLdmw' 6-max Seat #3 is the button
Seat 1: nCI/286bRXONuVN/6Bn49Q ($329 in chips)
Seat 2: 1ScqYmNf7/uWx1XSBgPTBw ($195 in chips)
Seat 3: /F5e5TKT/1B9kgJVuQttsg ($307.75 in chips)
Seat 4: efhcaDPhNqQ/H48kMHLa8w ($1158 in chips)
Seat 5: C515ewji10HLkUifdjurhw ($203.50 in chips)
Seat 6: 3mTlg4g0FJN2bo939h/0Wg ($358.55 in chips)
efhcaDPhNqQ/H48kMHLa8w: posts small blind $5
C515ewji10HLkUifdjurhw: posts big blind $10
*** HOLE CARDS ***
3mTlg4g0FJN2bo939h/0Wg: folds
nCI/286bRXONuVN/6Bn49Q: folds
1ScqYmNf7/uWx1XSBgPTBw: folds
/F5e5TKT/1B9kgJVuQttsg: raises $10 to $20
efhcaDPhNqQ/H48kMHLa8w: folds
C515ewji10HLkUifdjurhw: calls $10
*** FLOP *** [5s Ts Td]
C515ewji10HLkUifdjurhw: checks
/F5e5TKT/1B9kgJVuQttsg: bets $20
C515ewji10HLkUifdjurhw: raises $25 to $45
/F5e5TKT/1B9kgJVuQttsg: folds
C515ewji10HLkUifdjurhw collected $82 from pot
*** SUMMARY ***
Total pot $85 | Rake $3
Board [5s Ts Td]
Seat 1: nCI/286bRXONuVN/6Bn49Q folded before Flop (didn't bet)
Seat 2: 1ScqYmNf7/uWx1XSBgPTBw folded before Flop (didn't bet)
Seat 3: /F5e5TKT/1B9kgJVuQttsg (button) folded on the Flop
Seat 4: efhcaDPhNqQ/H48kMHLa8w (small blind) folded before Flop
Seat 5: C515ewji10HLkUifdjurhw (big blind) collected ($82)
Seat 6: 3mTlg4g0FJN2bo939h/0Wg folded before Flop (didn't bet)



PokerStars Game #59963958926:  Hold'em No Limit ($5/$10) - 2009/07/01 12:02:34 ET
Table 'AiNa6yyp/njJVRYl/Lz1KQ' 6-max Seat #4 is the button
Seat 1: C515ewji10HLkUifdjurhw ($247.25 in chips)
Seat 2: 7SUIdtQak1SCtldWHjwnFA ($255 in chips)
Seat 3: 3mTlg4g0FJN2bo939h/0Wg ($274 in chips)
Seat 4: /F5e5TKT/1B9kgJVuQttsg ($315 in chips)
Seat 5: 2PHCSXghjbGk2qR6jDFe2g ($326 in chips)
Seat 6: kem0o3a/3AcDZBJg3cdvpQ ($200 in chips)
2PHCSXghjbGk2qR6jDFe2g: posts small blind $5
kem0o3a/3AcDZBJg3cdvpQ: posts big blind $10
*** HOLE CARDS ***
C515ewji10HLkUifdjurhw: folds
7SUIdtQak1SCtldWHjwnFA: raises $12 to $22
3mTlg4g0FJN2bo939h/0Wg: folds
/F5e5TKT/1B9kgJVuQttsg: folds
2PHCSXghjbGk2qR6jDFe2g: folds
kem0o3a/3AcDZBJg3cdvpQ: folds
7SUIdtQak1SCtldWHjwnFA collected $25 from pot
7SUIdtQak1SCtldWHjwnFA: doesn't show hand
*** SUMMARY ***
Total pot $25 | Rake $0
Seat 1: C515ewji10HLkUifdjurhw folded before Flop (didn't bet)
Seat 2: 7SUIdtQak1SCtldWHjwnFA collected ($25)
Seat 3: 3mTlg4g0FJN2bo939h/0Wg folded before Flop (didn't bet)
Seat 4: /F5e5TKT/1B9kgJVuQttsg (button) folded before Flop (didn't bet)
Seat 5: 2PHCSXghjbGk2qR6jDFe2g (small blind) folded before Flop
Seat 6: kem0o3a/3AcDZBJg3cdvpQ (big blind) folded before Flop



PokerStars Game #59963980122:  Hold'em No Limit ($5/$10) - 2009/07/01 12:02:57 ET
Table 'AiNa6yyp/njJVRYl/Lz1KQ' 6-max Seat #5 is the button
Seat 1: C515ewji10HLkUifdjurhw ($247.25 in chips)
Seat 2: 7SUIdtQak1SCtldWHjwnFA ($270 in chips)
Seat 3: 3mTlg4g0FJN2bo939h/0Wg ($274 in chips)
Seat 4: /F5e5TKT/1B9kgJVuQttsg ($315 in chips)
Seat 5: 2PHCSXghjbGk2qR6jDFe2g ($321 in chips)
Seat 6: kem0o3a/3AcDZBJg3cdvpQ ($190 in chips)
kem0o3a/3AcDZBJg3cdvpQ: posts small blind $5
C515ewji10HLkUifdjurhw: posts big blind $10
*** HOLE CARDS ***
7SUIdtQak1SCtldWHjwnFA: raises $12 to $22
3mTlg4g0FJN2bo939h/0Wg: folds
/F5e5TKT/1B9kgJVuQttsg: folds
2PHCSXghjbGk2qR6jDFe2g: folds
kem0o3a/3AcDZBJg3cdvpQ: raises $168 to $190 and is all-in
C515ewji10HLkUifdjurhw: folds
7SUIdtQak1SCtldWHjwnFA: folds
kem0o3a/3AcDZBJg3cdvpQ collected $54 from pot
kem0o3a/3AcDZBJg3cdvpQ: doesn't show hand
*** SUMMARY ***
Total pot $54 | Rake $0
Seat 1: C515ewji10HLkUifdjurhw (big blind) folded before Flop
Seat 2: 7SUIdtQak1SCtldWHjwnFA folded before Flop
Seat 3: 3mTlg4g0FJN2bo939h/0Wg folded before Flop (didn't bet)
Seat 4: /F5e5TKT/1B9kgJVuQttsg folded before Flop (didn't bet)
Seat 5: 2PHCSXghjbGk2qR6jDFe2g (button) folded before Flop (didn't bet)
Seat 6: kem0o3a/3AcDZBJg3cdvpQ (small blind) collected ($54)



PokerStars Game #59963979714:  Hold'em No Limit ($5/$10) - 2009/07/01 12:02:57 ET
Table 'AI1fZ7Tsbf9DI8mC4EWoQQ' 9-max Seat #7 is the button
Seat 2: voSAIKXtXUUbJnds83sYfQ ($1149 in chips)
Seat 3: ZaYCGtNHUeItoUEheoYDMw ($357 in chips)
Seat 4: efhcaDPhNqQ/H48kMHLa8w ($1000 in chips)
Seat 5: 2PHCSXghjbGk2qR6jDFe2g ($997 in chips)
Seat 6: l9mDFuns/ycIDiFx40BMVw ($820 in chips)
Seat 7: ettgJAblGnistIlqNz4Jww ($1000 in chips)
Seat 8: UgBUE0pOJDwUdQ53XJt8MQ ($110 in chips)
Seat 9: 1s1h7qXmZxmowl9P1VNe2Q ($224.75 in chips)
UgBUE0pOJDwUdQ53XJt8MQ: posts small blind $5
1s1h7qXmZxmowl9P1VNe2Q: posts big blind $10
*** HOLE CARDS ***
voSAIKXtXUUbJnds83sYfQ: folds
ZaYCGtNHUeItoUEheoYDMw: folds
efhcaDPhNqQ/H48kMHLa8w: folds
2PHCSXghjbGk2qR6jDFe2g: folds
l9mDFuns/ycIDiFx40BMVw: folds
ettgJAblGnistIlqNz4Jww: folds
UgBUE0pOJDwUdQ53XJt8MQ: raises $100 to $110 and is all-in
1s1h7qXmZxmowl9P1VNe2Q: folds
UgBUE0pOJDwUdQ53XJt8MQ collected $20 from pot
*** SUMMARY ***
Total pot $20 | Rake $0
Seat 2: voSAIKXtXUUbJnds83sYfQ folded before Flop (didn't bet)
Seat 3: ZaYCGtNHUeItoUEheoYDMw folded before Flop (didn't bet)
Seat 4: efhcaDPhNqQ/H48kMHLa8w folded before Flop (didn't bet)
Seat 5: 2PHCSXghjbGk2qR6jDFe2g folded before Flop (didn't bet)
Seat 6: l9mDFuns/ycIDiFx40BMVw folded before Flop (didn't bet)
Seat 7: ettgJAblGnistIlqNz4Jww (button) folded before Flop (didn't bet)
Seat 8: UgBUE0pOJDwUdQ53XJt8MQ (small blind) collected ($20)
Seat 9: 1s1h7qXmZxmowl9P1VNe2Q (big blind) folded before Flop



PokerStars Game #59963993232:  Hold'em No Limit ($5/$10) - 2009/07/01 12:03:12 ET
Table '2a86NK3xhs21kwGZmbj0QA' 6-max Seat #5 is the button
Seat 1: nCI/286bRXONuVN/6Bn49Q ($120 in chips)
Seat 2: Xl+I49lxCJwPGRuegiaHoA ($3511 in chips)
Seat 3: voSAIKXtXUUbJnds83sYfQ ($1094 in chips)
Seat 4: 1ScqYmNf7/uWx1XSBgPTBw ($180 in chips)
Seat 5: efhcaDPhNqQ/H48kMHLa8w ($1154 in chips)
Seat 6: 0OfLwED3kKs3FwY+JlHC0g ($1232 in chips)
0OfLwED3kKs3FwY+JlHC0g: posts small blind $5
nCI/286bRXONuVN/6Bn49Q: posts big blind $10
*** HOLE CARDS ***
Xl+I49lxCJwPGRuegiaHoA: folds
voSAIKXtXUUbJnds83sYfQ: folds
1ScqYmNf7/uWx1XSBgPTBw: raises $10 to $20
efhcaDPhNqQ/H48kMHLa8w: folds
0OfLwED3kKs3FwY+JlHC0g: folds
nCI/286bRXONuVN/6Bn49Q: calls $10
*** FLOP *** [Qh 2c 4h]
nCI/286bRXONuVN/6Bn49Q: checks
1ScqYmNf7/uWx1XSBgPTBw: checks
*** TURN *** [Qh 2c 4h] [Ad]
nCI/286bRXONuVN/6Bn49Q: checks
1ScqYmNf7/uWx1XSBgPTBw: checks
*** RIVER *** [Qh 2c 4h Ad] [2s]
nCI/286bRXONuVN/6Bn49Q: checks
1ScqYmNf7/uWx1XSBgPTBw: checks
*** SHOW DOWN ***
nCI/286bRXONuVN/6Bn49Q: shows [7h 8c] (a pair of Deuces)
1ScqYmNf7/uWx1XSBgPTBw: shows [Kd Ts] (a pair of Deuces - Ace+King kicker)
1ScqYmNf7/uWx1XSBgPTBw collected $42.75 from pot
*** SUMMARY ***
Total pot $45 | Rake $2.25
Board [Qh 2c 4h Ad 2s]
Seat 1: nCI/286bRXONuVN/6Bn49Q (big blind) showed [7h 8c] and lost with a pair of Deuces
Seat 2: Xl+I49lxCJwPGRuegiaHoA folded before Flop (didn't bet)
Seat 3: voSAIKXtXUUbJnds83sYfQ folded before Flop (didn't bet)
Seat 4: 1ScqYmNf7/uWx1XSBgPTBw showed [Kd Ts] and won ($42.75) with a pair of Deuces
Seat 5: efhcaDPhNqQ/H48kMHLa8w (button) folded before Flop (didn't bet)
Seat 6: 0OfLwED3kKs3FwY+JlHC0g (small blind) folded before Flop



PokerStars Game #59964000634:  Hold'em No Limit ($5/$10) - 2009/07/01 12:03:19 ET
Table 'AiNa6yyp/njJVRYl/Lz1KQ' 6-max Seat #6 is the button
Seat 1: C515ewji10HLkUifdjurhw ($237.25 in chips)
Seat 2: 7SUIdtQak1SCtldWHjwnFA ($248 in chips)
Seat 3: 3mTlg4g0FJN2bo939h/0Wg ($274 in chips)
Seat 4: /F5e5TKT/1B9kgJVuQttsg ($315 in chips)
Seat 5: 2PHCSXghjbGk2qR6jDFe2g ($321 in chips)
Seat 6: kem0o3a/3AcDZBJg3cdvpQ ($222 in chips)
C515ewji10HLkUifdjurhw: posts small blind $5
7SUIdtQak1SCtldWHjwnFA: posts big blind $10
*** HOLE CARDS ***
3mTlg4g0FJN2bo939h/0Wg: folds
/F5e5TKT/1B9kgJVuQttsg: folds
2PHCSXghjbGk2qR6jDFe2g: folds
kem0o3a/3AcDZBJg3cdvpQ: folds
C515ewji10HLkUifdjurhw: folds
7SUIdtQak1SCtldWHjwnFA collected $10 from pot
7SUIdtQak1SCtldWHjwnFA: doesn't show hand
*** SUMMARY ***
Total pot $10 | Rake $0
Seat 1: C515ewji10HLkUifdjurhw (small blind) folded before Flop
Seat 2: 7SUIdtQak1SCtldWHjwnFA (big blind) collected ($10)
Seat 3: 3mTlg4g0FJN2bo939h/0Wg folded before Flop (didn't bet)
Seat 4: /F5e5TKT/1B9kgJVuQttsg folded before Flop (didn't bet)
Seat 5: 2PHCSXghjbGk2qR6jDFe2g folded before Flop (didn't bet)
Seat 6: kem0o3a/3AcDZBJg3cdvpQ (button) folded before Flop (didn't bet)



PokerStars Game #59964008296:  Hold'em No Limit ($5/$10) - 2009/07/01 12:03:27 ET
Table 'dwLGEw3aoH/cOAI7JsLdmw' 6-max Seat #4 is the button
Seat 1: nCI/286bRXONuVN/6Bn49Q ($329 in chips)
Seat 2: 1ScqYmNf7/uWx1XSBgPTBw ($195 in chips)
Seat 3: /F5e5TKT/1B9kgJVuQttsg ($300 in chips)
Seat 4: efhcaDPhNqQ/H48kMHLa8w ($1153 in chips)
Seat 5: C515ewji10HLkUifdjurhw ($245.50 in chips)
Seat 6: 3mTlg4g0FJN2bo939h/0Wg ($358.55 in chips)
C515ewji10HLkUifdjurhw: posts small blind $5
3mTlg4g0FJN2bo939h/0Wg: posts big blind $10
*** HOLE CARDS ***
nCI/286bRXONuVN/6Bn49Q: folds
1ScqYmNf7/uWx1XSBgPTBw: folds
/F5e5TKT/1B9kgJVuQttsg: folds
efhcaDPhNqQ/H48kMHLa8w: folds
C515ewji10HLkUifdjurhw: folds
3mTlg4g0FJN2bo939h/0Wg collected $10 from pot
*** SUMMARY ***
Total pot $10 | Rake $0
Seat 1: nCI/286bRXONuVN/6Bn49Q folded before Flop (didn't bet)
Seat 2: 1ScqYmNf7/uWx1XSBgPTBw folded before Flop (didn't bet)
Seat 3: /F5e5TKT/1B9kgJVuQttsg folded before Flop (didn't bet)
Seat 4: efhcaDPhNqQ/H48kMHLa8w (button) folded before Flop (didn't bet)
Seat 5: C515ewji10HLkUifdjurhw (small blind) folded before Flop
Seat 6: 3mTlg4g0FJN2bo939h/0Wg (big blind) collected ($10)



PokerStars Game #59964019002:  Hold'em No Limit ($5/$10) - 2009/07/01 12:03:39 ET
Table '1Dt9cpcLUVE6HYkx5dUEdQ' 6-max Seat #2 is the button
Seat 1: Xl+I49lxCJwPGRuegiaHoA ($1166 in chips)
Seat 2: zdS2zKkZYSRe8p+GVcXMgg ($2227.10 in chips)
Seat 3: Lne9leXjEzXWbU3BGFWsxQ ($1086 in chips)
Seat 4: voSAIKXtXUUbJnds83sYfQ ($1738.75 in chips)
Seat 5: 1ScqYmNf7/uWx1XSBgPTBw ($170 in chips)
Seat 6: efhcaDPhNqQ/H48kMHLa8w ($1832 in chips)
Lne9leXjEzXWbU3BGFWsxQ: posts small blind $5
voSAIKXtXUUbJnds83sYfQ: posts big blind $10
*** HOLE CARDS ***
1ScqYmNf7/uWx1XSBgPTBw: folds
efhcaDPhNqQ/H48kMHLa8w: folds
Xl+I49lxCJwPGRuegiaHoA: raises $20 to $30
zdS2zKkZYSRe8p+GVcXMgg: folds
Lne9leXjEzXWbU3BGFWsxQ: folds
voSAIKXtXUUbJnds83sYfQ: raises $80 to $110
Xl+I49lxCJwPGRuegiaHoA: calls $80
*** FLOP *** [2c 3s Qs]
voSAIKXtXUUbJnds83sYfQ: bets $140
Xl+I49lxCJwPGRuegiaHoA: calls $140
*** TURN *** [2c 3s Qs] [Kc]
voSAIKXtXUUbJnds83sYfQ: bets $250
Xl+I49lxCJwPGRuegiaHoA: folds
voSAIKXtXUUbJnds83sYfQ collected $502 from pot
*** SUMMARY ***
Total pot $505 | Rake $3
Board [2c 3s Qs Kc]
Seat 1: Xl+I49lxCJwPGRuegiaHoA folded on the Turn
Seat 2: zdS2zKkZYSRe8p+GVcXMgg (button) folded before Flop (didn't bet)
Seat 3: Lne9leXjEzXWbU3BGFWsxQ (small blind) folded before Flop
Seat 4: voSAIKXtXUUbJnds83sYfQ (big blind) collected ($502)
Seat 5: 1ScqYmNf7/uWx1XSBgPTBw folded before Flop (didn't bet)
Seat 6: efhcaDPhNqQ/H48kMHLa8w folded before Flop (didn't bet)



PokerStars Game #59964019360:  Hold'em No Limit ($5/$10) - 2009/07/01 12:03:40 ET
Table 'AiNa6yyp/njJVRYl/Lz1KQ' 6-max Seat #1 is the button
Seat 1: C515ewji10HLkUifdjurhw ($232.25 in chips)
Seat 2: 7SUIdtQak1SCtldWHjwnFA ($253 in chips)
Seat 3: 3mTlg4g0FJN2bo939h/0Wg ($274 in chips)
Seat 4: /F5e5TKT/1B9kgJVuQttsg ($315 in chips)
Seat 5: 2PHCSXghjbGk2qR6jDFe2g ($321 in chips)
Seat 6: kem0o3a/3AcDZBJg3cdvpQ ($222 in chips)
7SUIdtQak1SCtldWHjwnFA: posts small blind $5
3mTlg4g0FJN2bo939h/0Wg: posts big blind $10
*** HOLE CARDS ***
/F5e5TKT/1B9kgJVuQttsg: folds
2PHCSXghjbGk2qR6jDFe2g: raises $20 to $30
kem0o3a/3AcDZBJg3cdvpQ: folds
C515ewji10HLkUifdjurhw: folds
7SUIdtQak1SCtldWHjwnFA: folds
3mTlg4g0FJN2bo939h/0Wg: folds
2PHCSXghjbGk2qR6jDFe2g collected $25 from pot
2PHCSXghjbGk2qR6jDFe2g: doesn't show hand
*** SUMMARY ***
Total pot $25 | Rake $0
Seat 1: C515ewji10HLkUifdjurhw (button) folded before Flop (didn't bet)
Seat 2: 7SUIdtQak1SCtldWHjwnFA (small blind) folded before Flop
Seat 3: 3mTlg4g0FJN2bo939h/0Wg (big blind) folded before Flop
Seat 4: /F5e5TKT/1B9kgJVuQttsg folded before Flop (didn't bet)
Seat 5: 2PHCSXghjbGk2qR6jDFe2g collected ($25)
Seat 6: kem0o3a/3AcDZBJg3cdvpQ folded before Flop (didn't bet)



PokerStars Game #59964033894:  Hold'em No Limit ($5/$10) - 2009/07/01 12:03:55 ET
Table 'AiNa6yyp/njJVRYl/Lz1KQ' 6-max Seat #2 is the button
Seat 1: C515ewji10HLkUifdjurhw ($232.25 in chips)
Seat 2: 7SUIdtQak1SCtldWHjwnFA ($248 in chips)
Seat 3: 3mTlg4g0FJN2bo939h/0Wg ($264 in chips)
Seat 4: /F5e5TKT/1B9kgJVuQttsg ($315 in chips)
Seat 5: 2PHCSXghjbGk2qR6jDFe2g ($336 in chips)
Seat 6: kem0o3a/3AcDZBJg3cdvpQ ($222 in chips)
3mTlg4g0FJN2bo939h/0Wg: posts small blind $5
/F5e5TKT/1B9kgJVuQttsg: posts big blind $10
*** HOLE CARDS ***
2PHCSXghjbGk2qR6jDFe2g: folds
kem0o3a/3AcDZBJg3cdvpQ: folds
C515ewji10HLkUifdjurhw: folds
7SUIdtQak1SCtldWHjwnFA: raises $12 to $22
3mTlg4g0FJN2bo939h/0Wg: calls $17
/F5e5TKT/1B9kgJVuQttsg: raises $278 to $300
7SUIdtQak1SCtldWHjwnFA: folds
3mTlg4g0FJN2bo939h/0Wg: folds
/F5e5TKT/1B9kgJVuQttsg collected $66 from pot
/F5e5TKT/1B9kgJVuQttsg: doesn't show hand
*** SUMMARY ***
Total pot $66 | Rake $0
Seat 1: C515ewji10HLkUifdjurhw folded before Flop (didn't bet)
Seat 2: 7SUIdtQak1SCtldWHjwnFA (button) folded before Flop
Seat 3: 3mTlg4g0FJN2bo939h/0Wg (small blind) folded before Flop
Seat 4: /F5e5TKT/1B9kgJVuQttsg (big blind) collected ($66)
Seat 5: 2PHCSXghjbGk2qR6jDFe2g folded before Flop (didn't bet)
Seat 6: kem0o3a/3AcDZBJg3cdvpQ folded before Flop (didn't bet)



PokerStars Game #59964033586:  Hold'em No Limit ($5/$10) - 2009/07/01 12:03:55 ET
Table 'dwLGEw3aoH/cOAI7JsLdmw' 6-max Seat #5 is the button
Seat 2: 1ScqYmNf7/uWx1XSBgPTBw ($195 in chips)
Seat 3: /F5e5TKT/1B9kgJVuQttsg ($300 in chips)
Seat 4: efhcaDPhNqQ/H48kMHLa8w ($1153 in chips)
Seat 5: C515ewji10HLkUifdjurhw ($240.50 in chips)
Seat 6: 3mTlg4g0FJN2bo939h/0Wg ($363.55 in chips)
3mTlg4g0FJN2bo939h/0Wg: posts small blind $5
nCI/286bRXONuVN/6Bn49Q: is sitting out
1ScqYmNf7/uWx1XSBgPTBw: posts big blind $10
*** HOLE CARDS ***
nCI/286bRXONuVN/6Bn49Q leaves the table
/F5e5TKT/1B9kgJVuQttsg: folds
efhcaDPhNqQ/H48kMHLa8w: folds
C515ewji10HLkUifdjurhw: raises $10 to $20
3mTlg4g0FJN2bo939h/0Wg: calls $15
1ScqYmNf7/uWx1XSBgPTBw: folds
*** FLOP *** [7h As 9c]
3mTlg4g0FJN2bo939h/0Wg: checks
C515ewji10HLkUifdjurhw: bets $20
3mTlg4g0FJN2bo939h/0Wg: calls $20
*** TURN *** [7h As 9c] [Kh]
3mTlg4g0FJN2bo939h/0Wg: checks
C515ewji10HLkUifdjurhw: bets $50
3mTlg4g0FJN2bo939h/0Wg: folds
ZaYCGtNHUeItoUEheoYDMw joins the table at seat #1
C515ewji10HLkUifdjurhw collected $88 from pot
*** SUMMARY ***
Total pot $90 | Rake $2
Board [7h As 9c Kh]
Seat 2: 1ScqYmNf7/uWx1XSBgPTBw (big blind) folded before Flop
Seat 3: /F5e5TKT/1B9kgJVuQttsg folded before Flop (didn't bet)
Seat 4: efhcaDPhNqQ/H48kMHLa8w folded before Flop (didn't bet)
Seat 5: C515ewji10HLkUifdjurhw (button) collected ($88)
Seat 6: 3mTlg4g0FJN2bo939h/0Wg (small blind) folded on the Turn



PokerStars Game #59964033646:  Hold'em No Limit ($5/$10) - 2009/07/01 12:03:55 ET
Table 'AI1fZ7Tsbf9DI8mC4EWoQQ' 9-max Seat #8 is the button
Seat 2: voSAIKXtXUUbJnds83sYfQ ($1149 in chips)
Seat 3: ZaYCGtNHUeItoUEheoYDMw ($357 in chips)
Seat 4: efhcaDPhNqQ/H48kMHLa8w ($1000 in chips)
Seat 5: 2PHCSXghjbGk2qR6jDFe2g ($997 in chips)
Seat 6: l9mDFuns/ycIDiFx40BMVw ($820 in chips)
Seat 7: ettgJAblGnistIlqNz4Jww ($1000 in chips)
Seat 8: UgBUE0pOJDwUdQ53XJt8MQ ($120 in chips)
Seat 9: 1s1h7qXmZxmowl9P1VNe2Q ($214.75 in chips)
1s1h7qXmZxmowl9P1VNe2Q: posts small blind $5
voSAIKXtXUUbJnds83sYfQ: posts big blind $10
*** HOLE CARDS ***
ZaYCGtNHUeItoUEheoYDMw: folds
efhcaDPhNqQ/H48kMHLa8w: folds
2PHCSXghjbGk2qR6jDFe2g: folds
l9mDFuns/ycIDiFx40BMVw: folds
ettgJAblGnistIlqNz4Jww: folds
UgBUE0pOJDwUdQ53XJt8MQ: folds
1s1h7qXmZxmowl9P1VNe2Q: raises $10 to $20
voSAIKXtXUUbJnds83sYfQ: folds
1s1h7qXmZxmowl9P1VNe2Q collected $20 from pot
*** SUMMARY ***
Total pot $20 | Rake $0
Seat 2: voSAIKXtXUUbJnds83sYfQ (big blind) folded before Flop
Seat 3: ZaYCGtNHUeItoUEheoYDMw folded before Flop (didn't bet)
Seat 4: efhcaDPhNqQ/H48kMHLa8w folded before Flop (didn't bet)
Seat 5: 2PHCSXghjbGk2qR6jDFe2g folded before Flop (didn't bet)
Seat 6: l9mDFuns/ycIDiFx40BMVw folded before Flop (didn't bet)
Seat 7: ettgJAblGnistIlqNz4Jww folded before Flop (didn't bet)
Seat 8: UgBUE0pOJDwUdQ53XJt8MQ (button) folded before Flop (didn't bet)
Seat 9: 1s1h7qXmZxmowl9P1VNe2Q (small blind) collected ($20)



PokerStars Game #59964045216:  Hold'em No Limit ($5/$10) - 2009/07/01 12:04:08 ET
Table '2a86NK3xhs21kwGZmbj0QA' 6-max Seat #6 is the button
Seat 1: nCI/286bRXONuVN/6Bn49Q ($100 in chips)
Seat 2: Xl+I49lxCJwPGRuegiaHoA ($3511 in chips)
Seat 3: voSAIKXtXUUbJnds83sYfQ ($1094 in chips)
Seat 4: 1ScqYmNf7/uWx1XSBgPTBw ($202.75 in chips)
Seat 5: efhcaDPhNqQ/H48kMHLa8w ($1154 in chips)
Seat 6: 0OfLwED3kKs3FwY+JlHC0g ($1227 in chips)
nCI/286bRXONuVN/6Bn49Q: posts small blind $5
Xl+I49lxCJwPGRuegiaHoA: posts big blind $10
*** HOLE CARDS ***
voSAIKXtXUUbJnds83sYfQ: folds
1ScqYmNf7/uWx1XSBgPTBw: folds
efhcaDPhNqQ/H48kMHLa8w: folds
0OfLwED3kKs3FwY+JlHC0g: folds
nCI/286bRXONuVN/6Bn49Q: raises $90 to $100 and is all-in
Xl+I49lxCJwPGRuegiaHoA: folds
nCI/286bRXONuVN/6Bn49Q collected $20 from pot
nCI/286bRXONuVN/6Bn49Q: doesn't show hand
*** SUMMARY ***
Total pot $20 | Rake $0
Seat 1: nCI/286bRXONuVN/6Bn49Q (small blind) collected ($20)
Seat 2: Xl+I49lxCJwPGRuegiaHoA (big blind) folded before Flop
Seat 3: voSAIKXtXUUbJnds83sYfQ folded before Flop (didn't bet)
Seat 4: 1ScqYmNf7/uWx1XSBgPTBw folded before Flop (didn't bet)
Seat 5: efhcaDPhNqQ/H48kMHLa8w folded before Flop (didn't bet)
Seat 6: 0OfLwED3kKs3FwY+JlHC0g (button) folded before Flop (didn't bet)



PokerStars Game #59964047180:  Hold'em No Limit ($5/$10) - 2009/07/01 12:04:10 ET
Table 'r10wRkUZaNZLcIr0K/VDlg' 6-max Seat #2 is the button
Seat 1: bjInvXcoSxLjVXWB9UWLBQ ($354 in chips)
Seat 2: 1ScqYmNf7/uWx1XSBgPTBw ($185 in chips)
Seat 3: kem0o3a/3AcDZBJg3cdvpQ ($214 in chips)
Seat 4: lu4P1Unn4wHCS7lPOOr9gA ($467 in chips)
Seat 5: q/hE9bQrjr91gfn84QYixQ ($440 in chips)
Seat 6: 3mTlg4g0FJN2bo939h/0Wg ($113 in chips)
kem0o3a/3AcDZBJg3cdvpQ: posts small blind $5
lu4P1Unn4wHCS7lPOOr9gA: posts big blind $10
*** HOLE CARDS ***
q/hE9bQrjr91gfn84QYixQ: folds
3mTlg4g0FJN2bo939h/0Wg: calls $10
bjInvXcoSxLjVXWB9UWLBQ: folds
1ScqYmNf7/uWx1XSBgPTBw: folds
kem0o3a/3AcDZBJg3cdvpQ: calls $5
lu4P1Unn4wHCS7lPOOr9gA: checks
*** FLOP *** [4s Th 7s]
kem0o3a/3AcDZBJg3cdvpQ: checks
lu4P1Unn4wHCS7lPOOr9gA: checks
3mTlg4g0FJN2bo939h/0Wg: checks
*** TURN *** [4s Th 7s] [2s]
kem0o3a/3AcDZBJg3cdvpQ: bets $15
lu4P1Unn4wHCS7lPOOr9gA: folds
3mTlg4g0FJN2bo939h/0Wg: folds
kem0o3a/3AcDZBJg3cdvpQ collected $28.50 from pot
kem0o3a/3AcDZBJg3cdvpQ: doesn't show hand
*** SUMMARY ***
Total pot $30 | Rake $1.50
Board [4s Th 7s 2s]
Seat 1: bjInvXcoSxLjVXWB9UWLBQ folded before Flop (didn't bet)
Seat 2: 1ScqYmNf7/uWx1XSBgPTBw (button) folded before Flop (didn't bet)
Seat 3: kem0o3a/3AcDZBJg3cdvpQ (small blind) collected ($28.50)
Seat 4: lu4P1Unn4wHCS7lPOOr9gA (big blind) folded on the Turn
Seat 5: q/hE9bQrjr91gfn84QYixQ folded before Flop (didn't bet)
Seat 6: 3mTlg4g0FJN2bo939h/0Wg folded on the Turn



PokerStars Game #59964063002:  Hold'em No Limit ($5/$10) - 2009/07/01 12:04:27 ET
Table 'AiNa6yyp/njJVRYl/Lz1KQ' 6-max Seat #3 is the button
Seat 1: C515ewji10HLkUifdjurhw ($232.25 in chips)
Seat 2: 7SUIdtQak1SCtldWHjwnFA ($226 in chips)
Seat 3: 3mTlg4g0FJN2bo939h/0Wg ($242 in chips)
Seat 4: /F5e5TKT/1B9kgJVuQttsg ($359 in chips)
Seat 5: 2PHCSXghjbGk2qR6jDFe2g ($336 in chips)
Seat 6: kem0o3a/3AcDZBJg3cdvpQ ($222 in chips)
/F5e5TKT/1B9kgJVuQttsg: posts small blind $5
2PHCSXghjbGk2qR6jDFe2g: posts big blind $10
*** HOLE CARDS ***
kem0o3a/3AcDZBJg3cdvpQ: folds
C515ewji10HLkUifdjurhw: folds
7SUIdtQak1SCtldWHjwnFA: folds
3mTlg4g0FJN2bo939h/0Wg: raises $10 to $20
/F5e5TKT/1B9kgJVuQttsg: folds
2PHCSXghjbGk2qR6jDFe2g: calls $10
*** FLOP *** [3d 8s 5d]
2PHCSXghjbGk2qR6jDFe2g: checks
3mTlg4g0FJN2bo939h/0Wg: checks
*** TURN *** [3d 8s 5d] [9h]
2PHCSXghjbGk2qR6jDFe2g: checks
3mTlg4g0FJN2bo939h/0Wg: bets $20
2PHCSXghjbGk2qR6jDFe2g: folds
3mTlg4g0FJN2bo939h/0Wg collected $42.75 from pot
*** SUMMARY ***
Total pot $45 | Rake $2.25
Board [3d 8s 5d 9h]
Seat 1: C515ewji10HLkUifdjurhw folded before Flop (didn't bet)
Seat 2: 7SUIdtQak1SCtldWHjwnFA folded before Flop (didn't bet)
Seat 3: 3mTlg4g0FJN2bo939h/0Wg (button) collected ($42.75)
Seat 4: /F5e5TKT/1B9kgJVuQttsg (small blind) folded before Flop
Seat 5: 2PHCSXghjbGk2qR6jDFe2g (big blind) folded on the Turn
Seat 6: kem0o3a/3AcDZBJg3cdvpQ folded before Flop (didn't bet)



PokerStars Game #59964066148:  Hold'em No Limit ($5/$10) - 2009/07/01 12:04:30 ET
Table '2a86NK3xhs21kwGZmbj0QA' 6-max Seat #1 is the button
Seat 1: nCI/286bRXONuVN/6Bn49Q ($110 in chips)
Seat 2: Xl+I49lxCJwPGRuegiaHoA ($3501 in chips)
Seat 3: voSAIKXtXUUbJnds83sYfQ ($1094 in chips)
Seat 4: 1ScqYmNf7/uWx1XSBgPTBw ($202.75 in chips)
Seat 5: efhcaDPhNqQ/H48kMHLa8w ($1154 in chips)
Seat 6: 0OfLwED3kKs3FwY+JlHC0g ($1227 in chips)
Xl+I49lxCJwPGRuegiaHoA: posts small blind $5
voSAIKXtXUUbJnds83sYfQ: posts big blind $10
*** HOLE CARDS ***
1ScqYmNf7/uWx1XSBgPTBw: folds
efhcaDPhNqQ/H48kMHLa8w: folds
0OfLwED3kKs3FwY+JlHC0g: raises $20 to $30
nCI/286bRXONuVN/6Bn49Q: raises $80 to $110 and is all-in
Xl+I49lxCJwPGRuegiaHoA: folds
voSAIKXtXUUbJnds83sYfQ: folds
0OfLwED3kKs3FwY+JlHC0g: calls $80
*** FLOP *** [Td 6c 2d]
*** TURN *** [Td 6c 2d] [4s]
*** RIVER *** [Td 6c 2d 4s] [3d]
*** SHOW DOWN ***
0OfLwED3kKs3FwY+JlHC0g: shows [Jh Kc] (high card King)
nCI/286bRXONuVN/6Bn49Q: shows [Ad Jd] (a flush, Ace high)
nCI/286bRXONuVN/6Bn49Q collected $232 from pot
*** SUMMARY ***
Total pot $235 | Rake $3
Board [Td 6c 2d 4s 3d]
Seat 1: nCI/286bRXONuVN/6Bn49Q (button) showed [Ad Jd] and won ($232) with a flush, Ace high
Seat 2: Xl+I49lxCJwPGRuegiaHoA (small blind) folded before Flop
Seat 3: voSAIKXtXUUbJnds83sYfQ (big blind) folded before Flop
Seat 4: 1ScqYmNf7/uWx1XSBgPTBw folded before Flop (didn't bet)
Seat 5: efhcaDPhNqQ/H48kMHLa8w folded before Flop (didn't bet)
Seat 6: 0OfLwED3kKs3FwY+JlHC0g showed [Jh Kc] and lost with high card King



PokerStars Game #59964084856:  Hold'em No Limit ($5/$10) - 2009/07/01 12:04:50 ET
Table 'AI1fZ7Tsbf9DI8mC4EWoQQ' 9-max Seat #9 is the button
Seat 2: voSAIKXtXUUbJnds83sYfQ ($1139 in chips)
Seat 4: efhcaDPhNqQ/H48kMHLa8w ($1000 in chips)
Seat 5: 2PHCSXghjbGk2qR6jDFe2g ($997 in chips)
Seat 6: l9mDFuns/ycIDiFx40BMVw ($820 in chips)
Seat 7: ettgJAblGnistIlqNz4Jww ($1000 in chips)
Seat 8: UgBUE0pOJDwUdQ53XJt8MQ ($120 in chips)
Seat 9: 1s1h7qXmZxmowl9P1VNe2Q ($224.75 in chips)
voSAIKXtXUUbJnds83sYfQ: posts small blind $5
ZaYCGtNHUeItoUEheoYDMw: is sitting out
efhcaDPhNqQ/H48kMHLa8w: posts big blind $10
*** HOLE CARDS ***
ZaYCGtNHUeItoUEheoYDMw leaves the table
2PHCSXghjbGk2qR6jDFe2g: folds
QjU8cx/IlcsbRKufwbiKow joins the table at seat #3
QjU8cx/IlcsbRKufwbiKow is sitting out
l9mDFuns/ycIDiFx40BMVw: calls $10
ettgJAblGnistIlqNz4Jww: folds
UgBUE0pOJDwUdQ53XJt8MQ: folds
1s1h7qXmZxmowl9P1VNe2Q: folds
voSAIKXtXUUbJnds83sYfQ: calls $5
efhcaDPhNqQ/H48kMHLa8w: raises $30 to $40
l9mDFuns/ycIDiFx40BMVw: calls $30
voSAIKXtXUUbJnds83sYfQ: folds
*** FLOP *** [Kh 3c 6c]
efhcaDPhNqQ/H48kMHLa8w: bets $60
l9mDFuns/ycIDiFx40BMVw: folds
efhcaDPhNqQ/H48kMHLa8w collected $87 from pot
*** SUMMARY ***
Total pot $90 | Rake $3
Board [Kh 3c 6c]
Seat 2: voSAIKXtXUUbJnds83sYfQ (small blind) folded before Flop
Seat 4: efhcaDPhNqQ/H48kMHLa8w (big blind) collected ($87)
Seat 5: 2PHCSXghjbGk2qR6jDFe2g folded before Flop (didn't bet)
Seat 6: l9mDFuns/ycIDiFx40BMVw folded on the Flop
Seat 7: ettgJAblGnistIlqNz4Jww folded before Flop (didn't bet)
Seat 8: UgBUE0pOJDwUdQ53XJt8MQ folded before Flop (didn't bet)
Seat 9: 1s1h7qXmZxmowl9P1VNe2Q (button) folded before Flop (didn't bet)



PokerStars Game #59964093352:  Hold'em No Limit ($5/$10) - 2009/07/01 12:05:00 ET
Table 'dwLGEw3aoH/cOAI7JsLdmw' 6-max Seat #6 is the button
Seat 2: 1ScqYmNf7/uWx1XSBgPTBw ($185 in chips)
Seat 3: /F5e5TKT/1B9kgJVuQttsg ($300 in chips)
Seat 4: efhcaDPhNqQ/H48kMHLa8w ($1153 in chips)
Seat 5: C515ewji10HLkUifdjurhw ($288.50 in chips)
Seat 6: 3mTlg4g0FJN2bo939h/0Wg ($323.55 in chips)
ZaYCGtNHUeItoUEheoYDMw will be allowed to play after the button
1ScqYmNf7/uWx1XSBgPTBw: posts small blind $5
/F5e5TKT/1B9kgJVuQttsg: posts big blind $10
*** HOLE CARDS ***
efhcaDPhNqQ/H48kMHLa8w: folds
C515ewji10HLkUifdjurhw: folds
3mTlg4g0FJN2bo939h/0Wg: raises $10 to $20
1ScqYmNf7/uWx1XSBgPTBw: raises $40 to $60
/F5e5TKT/1B9kgJVuQttsg: folds
3mTlg4g0FJN2bo939h/0Wg: calls $40
*** FLOP *** [2s 2h 7s]
1ScqYmNf7/uWx1XSBgPTBw: bets $60
3mTlg4g0FJN2bo939h/0Wg: calls $60
*** TURN *** [2s 2h 7s] [Ah]
1ScqYmNf7/uWx1XSBgPTBw: bets $65 and is all-in
3mTlg4g0FJN2bo939h/0Wg: folds
1ScqYmNf7/uWx1XSBgPTBw collected $248 from pot
*** SUMMARY ***
Total pot $250 | Rake $2
Board [2s 2h 7s Ah]
Seat 2: 1ScqYmNf7/uWx1XSBgPTBw (small blind) collected ($248)
Seat 3: /F5e5TKT/1B9kgJVuQttsg (big blind) folded before Flop
Seat 4: efhcaDPhNqQ/H48kMHLa8w folded before Flop (didn't bet)
Seat 5: C515ewji10HLkUifdjurhw folded before Flop (didn't bet)
Seat 6: 3mTlg4g0FJN2bo939h/0Wg (button) folded on the Turn



PokerStars Game #59964094598:  Hold'em No Limit ($5/$10) - 2009/07/01 12:05:01 ET
Table 'r10wRkUZaNZLcIr0K/VDlg' 6-max Seat #3 is the button
Seat 1: bjInvXcoSxLjVXWB9UWLBQ ($354 in chips)
Seat 2: 1ScqYmNf7/uWx1XSBgPTBw ($185 in chips)
Seat 3: kem0o3a/3AcDZBJg3cdvpQ ($232.50 in chips)
Seat 4: lu4P1Unn4wHCS7lPOOr9gA ($457 in chips)
Seat 5: q/hE9bQrjr91gfn84QYixQ ($440 in chips)
Seat 6: 3mTlg4g0FJN2bo939h/0Wg ($103 in chips)
lu4P1Unn4wHCS7lPOOr9gA: posts small blind $5
q/hE9bQrjr91gfn84QYixQ: posts big blind $10
*** HOLE CARDS ***
3mTlg4g0FJN2bo939h/0Wg: folds
bjInvXcoSxLjVXWB9UWLBQ: folds
1ScqYmNf7/uWx1XSBgPTBw: folds
kem0o3a/3AcDZBJg3cdvpQ: raises $15 to $25
lu4P1Unn4wHCS7lPOOr9gA: calls $20
q/hE9bQrjr91gfn84QYixQ: calls $15
*** FLOP *** [Qc 7c Ah]
lu4P1Unn4wHCS7lPOOr9gA: checks
q/hE9bQrjr91gfn84QYixQ: checks
kem0o3a/3AcDZBJg3cdvpQ: bets $35
lu4P1Unn4wHCS7lPOOr9gA: folds
q/hE9bQrjr91gfn84QYixQ: calls $35
*** TURN *** [Qc 7c Ah] [3s]
q/hE9bQrjr91gfn84QYixQ: checks
kem0o3a/3AcDZBJg3cdvpQ: checks
*** RIVER *** [Qc 7c Ah 3s] [5s]
q/hE9bQrjr91gfn84QYixQ: bets $30
kem0o3a/3AcDZBJg3cdvpQ: calls $30
*** SHOW DOWN ***
q/hE9bQrjr91gfn84QYixQ: shows [Ks Qh] (a pair of Queens)
kem0o3a/3AcDZBJg3cdvpQ: shows [6h Ad] (a pair of Aces)
kem0o3a/3AcDZBJg3cdvpQ collected $202 from pot
*** SUMMARY ***
Total pot $205 | Rake $3
Board [Qc 7c Ah 3s 5s]
Seat 1: bjInvXcoSxLjVXWB9UWLBQ folded before Flop (didn't bet)
Seat 2: 1ScqYmNf7/uWx1XSBgPTBw folded before Flop (didn't bet)
Seat 3: kem0o3a/3AcDZBJg3cdvpQ (button) showed [6h Ad] and won ($202) with a pair of Aces
Seat 4: lu4P1Unn4wHCS7lPOOr9gA (small blind) folded on the Flop
Seat 5: q/hE9bQrjr91gfn84QYixQ (big blind) showed [Ks Qh] and lost with a pair of Queens
Seat 6: 3mTlg4g0FJN2bo939h/0Wg folded before Flop (didn't bet)



PokerStars Game #59964097708:  Hold'em No Limit ($5/$10) - 2009/07/01 12:05:04 ET
Table 'AiNa6yyp/njJVRYl/Lz1KQ' 6-max Seat #4 is the button
Seat 1: C515ewji10HLkUifdjurhw ($232.25 in chips)
Seat 2: 7SUIdtQak1SCtldWHjwnFA ($226 in chips)
Seat 3: 3mTlg4g0FJN2bo939h/0Wg ($264.75 in chips)
Seat 4: /F5e5TKT/1B9kgJVuQttsg ($354 in chips)
Seat 5: 2PHCSXghjbGk2qR6jDFe2g ($316 in chips)
Seat 6: kem0o3a/3AcDZBJg3cdvpQ ($222 in chips)
2PHCSXghjbGk2qR6jDFe2g: posts small blind $5
kem0o3a/3AcDZBJg3cdvpQ: posts big blind $10
*** HOLE CARDS ***
C515ewji10HLkUifdjurhw: folds
7SUIdtQak1SCtldWHjwnFA: folds
3mTlg4g0FJN2bo939h/0Wg: raises $10 to $20
/F5e5TKT/1B9kgJVuQttsg: folds
2PHCSXghjbGk2qR6jDFe2g: folds
kem0o3a/3AcDZBJg3cdvpQ: folds
3mTlg4g0FJN2bo939h/0Wg collected $25 from pot
*** SUMMARY ***
Total pot $25 | Rake $0
Seat 1: C515ewji10HLkUifdjurhw folded before Flop (didn't bet)
Seat 2: 7SUIdtQak1SCtldWHjwnFA folded before Flop (didn't bet)
Seat 3: 3mTlg4g0FJN2bo939h/0Wg collected ($25)
Seat 4: /F5e5TKT/1B9kgJVuQttsg (button) folded before Flop (didn't bet)
Seat 5: 2PHCSXghjbGk2qR6jDFe2g (small blind) folded before Flop
Seat 6: kem0o3a/3AcDZBJg3cdvpQ (big blind) folded before Flop



PokerStars Game #59964099348:  Hold'em No Limit ($5/$10) - 2009/07/01 12:05:06 ET
Table '1Dt9cpcLUVE6HYkx5dUEdQ' 6-max Seat #3 is the button
Seat 1: Xl+I49lxCJwPGRuegiaHoA ($1000 in chips)
Seat 2: zdS2zKkZYSRe8p+GVcXMgg ($2227.10 in chips)
Seat 3: Lne9leXjEzXWbU3BGFWsxQ ($1081 in chips)
Seat 4: voSAIKXtXUUbJnds83sYfQ ($1990.75 in chips)
Seat 5: 1ScqYmNf7/uWx1XSBgPTBw ($170 in chips)
Seat 6: efhcaDPhNqQ/H48kMHLa8w ($1832 in chips)
voSAIKXtXUUbJnds83sYfQ: posts small blind $5
1ScqYmNf7/uWx1XSBgPTBw: posts big blind $10
*** HOLE CARDS ***
efhcaDPhNqQ/H48kMHLa8w: folds
Xl+I49lxCJwPGRuegiaHoA: raises $20 to $30
zdS2zKkZYSRe8p+GVcXMgg: calls $30
Lne9leXjEzXWbU3BGFWsxQ: calls $30
voSAIKXtXUUbJnds83sYfQ: folds
1ScqYmNf7/uWx1XSBgPTBw: folds
*** FLOP *** [2c 8h 6h]
Xl+I49lxCJwPGRuegiaHoA: checks
zdS2zKkZYSRe8p+GVcXMgg: bets $102
Lne9leXjEzXWbU3BGFWsxQ: folds
Xl+I49lxCJwPGRuegiaHoA: folds
zdS2zKkZYSRe8p+GVcXMgg collected $102 from pot
*** SUMMARY ***
Total pot $105 | Rake $3
Board [2c 8h 6h]
Seat 1: Xl+I49lxCJwPGRuegiaHoA folded on the Flop
Seat 2: zdS2zKkZYSRe8p+GVcXMgg collected ($102)
Seat 3: Lne9leXjEzXWbU3BGFWsxQ (button) folded on the Flop
Seat 4: voSAIKXtXUUbJnds83sYfQ (small blind) folded before Flop
Seat 5: 1ScqYmNf7/uWx1XSBgPTBw (big blind) folded before Flop
Seat 6: efhcaDPhNqQ/H48kMHLa8w folded before Flop (didn't bet)



PokerStars Game #59964110180:  Hold'em No Limit ($5/$10) - 2009/07/01 12:05:18 ET
Table '2a86NK3xhs21kwGZmbj0QA' 6-max Seat #2 is the button
Seat 1: nCI/286bRXONuVN/6Bn49Q ($232 in chips)
Seat 2: Xl+I49lxCJwPGRuegiaHoA ($3496 in chips)
Seat 3: voSAIKXtXUUbJnds83sYfQ ($1084 in chips)
Seat 4: 1ScqYmNf7/uWx1XSBgPTBw ($202.75 in chips)
Seat 5: efhcaDPhNqQ/H48kMHLa8w ($1154 in chips)
Seat 6: 0OfLwED3kKs3FwY+JlHC0g ($1117 in chips)
voSAIKXtXUUbJnds83sYfQ: posts small blind $5
1ScqYmNf7/uWx1XSBgPTBw: posts big blind $10
*** HOLE CARDS ***
efhcaDPhNqQ/H48kMHLa8w: folds
0OfLwED3kKs3FwY+JlHC0g: folds
nCI/286bRXONuVN/6Bn49Q: folds
Xl+I49lxCJwPGRuegiaHoA: folds
voSAIKXtXUUbJnds83sYfQ: raises $14 to $24
1ScqYmNf7/uWx1XSBgPTBw: raises $178.75 to $202.75 and is all-in
voSAIKXtXUUbJnds83sYfQ: folds
1ScqYmNf7/uWx1XSBgPTBw collected $48 from pot
1ScqYmNf7/uWx1XSBgPTBw: doesn't show hand
*** SUMMARY ***
Total pot $48 | Rake $0
Seat 1: nCI/286bRXONuVN/6Bn49Q folded before Flop (didn't bet)
Seat 2: Xl+I49lxCJwPGRuegiaHoA (button) folded before Flop (didn't bet)
Seat 3: voSAIKXtXUUbJnds83sYfQ (small blind) folded before Flop
Seat 4: 1ScqYmNf7/uWx1XSBgPTBw (big blind) collected ($48)
Seat 5: efhcaDPhNqQ/H48kMHLa8w folded before Flop (didn't bet)
Seat 6: 0OfLwED3kKs3FwY+JlHC0g folded before Flop (didn't bet)



PokerStars Game #59964125074:  Hold'em No Limit ($5/$10) - 2009/07/01 12:05:34 ET
Table 'AiNa6yyp/njJVRYl/Lz1KQ' 6-max Seat #5 is the button
Seat 1: C515ewji10HLkUifdjurhw ($232.25 in chips)
Seat 2: 7SUIdtQak1SCtldWHjwnFA ($226 in chips)
Seat 3: 3mTlg4g0FJN2bo939h/0Wg ($279.75 in chips)
Seat 4: /F5e5TKT/1B9kgJVuQttsg ($354 in chips)
Seat 5: 2PHCSXghjbGk2qR6jDFe2g ($311 in chips)
Seat 6: kem0o3a/3AcDZBJg3cdvpQ ($212 in chips)
kem0o3a/3AcDZBJg3cdvpQ: posts small blind $5
C515ewji10HLkUifdjurhw: posts big blind $10
*** HOLE CARDS ***
7SUIdtQak1SCtldWHjwnFA: folds
3mTlg4g0FJN2bo939h/0Wg: folds
/F5e5TKT/1B9kgJVuQttsg: folds
2PHCSXghjbGk2qR6jDFe2g: raises $10 to $20
kem0o3a/3AcDZBJg3cdvpQ: raises $192 to $212 and is all-in
C515ewji10HLkUifdjurhw: folds
2PHCSXghjbGk2qR6jDFe2g: folds
kem0o3a/3AcDZBJg3cdvpQ collected $50 from pot
kem0o3a/3AcDZBJg3cdvpQ: doesn't show hand
*** SUMMARY ***
Total pot $50 | Rake $0
Seat 1: C515ewji10HLkUifdjurhw (big blind) folded before Flop
Seat 2: 7SUIdtQak1SCtldWHjwnFA folded before Flop (didn't bet)
Seat 3: 3mTlg4g0FJN2bo939h/0Wg folded before Flop (didn't bet)
Seat 4: /F5e5TKT/1B9kgJVuQttsg folded before Flop (didn't bet)
Seat 5: 2PHCSXghjbGk2qR6jDFe2g (button) folded before Flop
Seat 6: kem0o3a/3AcDZBJg3cdvpQ (small blind) collected ($50)



PokerStars Game #59964138714:  Hold'em No Limit ($5/$10) - 2009/07/01 12:05:49 ET
Table '2a86NK3xhs21kwGZmbj0QA' 6-max Seat #3 is the button
Seat 1: nCI/286bRXONuVN/6Bn49Q ($232 in chips)
Seat 2: Xl+I49lxCJwPGRuegiaHoA ($3496 in chips)
Seat 3: voSAIKXtXUUbJnds83sYfQ ($1060 in chips)
Seat 4: 1ScqYmNf7/uWx1XSBgPTBw ($226.75 in chips)
Seat 5: efhcaDPhNqQ/H48kMHLa8w ($1154 in chips)
Seat 6: 0OfLwED3kKs3FwY+JlHC0g ($1117 in chips)
1ScqYmNf7/uWx1XSBgPTBw: posts small blind $5
efhcaDPhNqQ/H48kMHLa8w: posts big blind $10
*** HOLE CARDS ***
0OfLwED3kKs3FwY+JlHC0g: folds
nCI/286bRXONuVN/6Bn49Q: folds
Xl+I49lxCJwPGRuegiaHoA: raises $20 to $30
voSAIKXtXUUbJnds83sYfQ: folds
1ScqYmNf7/uWx1XSBgPTBw: folds
efhcaDPhNqQ/H48kMHLa8w: folds
Xl+I49lxCJwPGRuegiaHoA collected $25 from pot
Xl+I49lxCJwPGRuegiaHoA: doesn't show hand
*** SUMMARY ***
Total pot $25 | Rake $0
Seat 1: nCI/286bRXONuVN/6Bn49Q folded before Flop (didn't bet)
Seat 2: Xl+I49lxCJwPGRuegiaHoA collected ($25)
Seat 3: voSAIKXtXUUbJnds83sYfQ (button) folded before Flop (didn't bet)
Seat 4: 1ScqYmNf7/uWx1XSBgPTBw (small blind) folded before Flop
Seat 5: efhcaDPhNqQ/H48kMHLa8w (big blind) folded before Flop
Seat 6: 0OfLwED3kKs3FwY+JlHC0g folded before Flop (didn't bet)



PokerStars Game #59964144482:  Hold'em No Limit ($5/$10) - 2009/07/01 12:05:55 ET
Table '1Dt9cpcLUVE6HYkx5dUEdQ' 6-max Seat #4 is the button
Seat 1: Xl+I49lxCJwPGRuegiaHoA ($1000 in chips)
Seat 2: zdS2zKkZYSRe8p+GVcXMgg ($2299.10 in chips)
Seat 3: Lne9leXjEzXWbU3BGFWsxQ ($1051 in chips)
Seat 4: voSAIKXtXUUbJnds83sYfQ ($1985.75 in chips)
Seat 5: 1ScqYmNf7/uWx1XSBgPTBw ($160 in chips)
Seat 6: efhcaDPhNqQ/H48kMHLa8w ($1832 in chips)
1ScqYmNf7/uWx1XSBgPTBw: posts small blind $5
efhcaDPhNqQ/H48kMHLa8w: posts big blind $10
*** HOLE CARDS ***
Xl+I49lxCJwPGRuegiaHoA: folds
zdS2zKkZYSRe8p+GVcXMgg: folds
Lne9leXjEzXWbU3BGFWsxQ: folds
voSAIKXtXUUbJnds83sYfQ: folds
1ScqYmNf7/uWx1XSBgPTBw: folds
efhcaDPhNqQ/H48kMHLa8w collected $10 from pot
*** SUMMARY ***
Total pot $10 | Rake $0
Seat 1: Xl+I49lxCJwPGRuegiaHoA folded before Flop (didn't bet)
Seat 2: zdS2zKkZYSRe8p+GVcXMgg folded before Flop (didn't bet)
Seat 3: Lne9leXjEzXWbU3BGFWsxQ folded before Flop (didn't bet)
Seat 4: voSAIKXtXUUbJnds83sYfQ (button) folded before Flop (didn't bet)
Seat 5: 1ScqYmNf7/uWx1XSBgPTBw (small blind) folded before Flop
Seat 6: efhcaDPhNqQ/H48kMHLa8w (big blind) collected ($10)



PokerStars Game #59964145488:  Hold'em No Limit ($5/$10) - 2009/07/01 12:05:56 ET
Table 'AiNa6yyp/njJVRYl/Lz1KQ' 6-max Seat #6 is the button
Seat 1: C515ewji10HLkUifdjurhw ($222.25 in chips)
Seat 2: 7SUIdtQak1SCtldWHjwnFA ($226 in chips)
Seat 3: 3mTlg4g0FJN2bo939h/0Wg ($279.75 in chips)
Seat 4: /F5e5TKT/1B9kgJVuQttsg ($354 in chips)
Seat 5: 2PHCSXghjbGk2qR6jDFe2g ($291 in chips)
Seat 6: kem0o3a/3AcDZBJg3cdvpQ ($242 in chips)
C515ewji10HLkUifdjurhw: posts small blind $5
7SUIdtQak1SCtldWHjwnFA: posts big blind $10
*** HOLE CARDS ***
3mTlg4g0FJN2bo939h/0Wg: raises $20 to $30
/F5e5TKT/1B9kgJVuQttsg: folds
2PHCSXghjbGk2qR6jDFe2g: folds
kem0o3a/3AcDZBJg3cdvpQ: folds
C515ewji10HLkUifdjurhw: folds
7SUIdtQak1SCtldWHjwnFA: folds
3mTlg4g0FJN2bo939h/0Wg collected $25 from pot
*** SUMMARY ***
Total pot $25 | Rake $0
Seat 1: C515ewji10HLkUifdjurhw (small blind) folded before Flop
Seat 2: 7SUIdtQak1SCtldWHjwnFA (big blind) folded before Flop
Seat 3: 3mTlg4g0FJN2bo939h/0Wg collected ($25)
Seat 4: /F5e5TKT/1B9kgJVuQttsg folded before Flop (didn't bet)
Seat 5: 2PHCSXghjbGk2qR6jDFe2g folded before Flop (didn't bet)
Seat 6: kem0o3a/3AcDZBJg3cdvpQ (button) folded before Flop (didn't bet)



PokerStars Game #59964146722:  Hold'em No Limit ($5/$10) - 2009/07/01 12:05:57 ET
Table 'dwLGEw3aoH/cOAI7JsLdmw' 6-max Seat #2 is the button
Seat 2: 1ScqYmNf7/uWx1XSBgPTBw ($313 in chips)
Seat 3: /F5e5TKT/1B9kgJVuQttsg ($300 in chips)
Seat 4: efhcaDPhNqQ/H48kMHLa8w ($1153 in chips)
Seat 5: C515ewji10HLkUifdjurhw ($288.50 in chips)
Seat 6: 3mTlg4g0FJN2bo939h/0Wg ($203.55 in chips)
/F5e5TKT/1B9kgJVuQttsg: posts small blind $5
efhcaDPhNqQ/H48kMHLa8w: posts big blind $10
ZaYCGtNHUeItoUEheoYDMw: sits out
*** HOLE CARDS ***
C515ewji10HLkUifdjurhw: folds
3mTlg4g0FJN2bo939h/0Wg: raises $10 to $20
1ScqYmNf7/uWx1XSBgPTBw: raises $40 to $60
/F5e5TKT/1B9kgJVuQttsg: folds
efhcaDPhNqQ/H48kMHLa8w: folds
3mTlg4g0FJN2bo939h/0Wg: calls $40
*** FLOP *** [Kc 3s 2s]
3mTlg4g0FJN2bo939h/0Wg: checks
1ScqYmNf7/uWx1XSBgPTBw: bets $253 and is all-in
3mTlg4g0FJN2bo939h/0Wg: folds
1ScqYmNf7/uWx1XSBgPTBw collected $133 from pot
*** SUMMARY ***
Total pot $135 | Rake $2
Board [Kc 3s 2s]
Seat 2: 1ScqYmNf7/uWx1XSBgPTBw (button) collected ($133)
Seat 3: /F5e5TKT/1B9kgJVuQttsg (small blind) folded before Flop
Seat 4: efhcaDPhNqQ/H48kMHLa8w (big blind) folded before Flop
Seat 5: C515ewji10HLkUifdjurhw folded before Flop (didn't bet)
Seat 6: 3mTlg4g0FJN2bo939h/0Wg folded on the Flop



PokerStars Game #59964156022:  Hold'em No Limit ($5/$10) - 2009/07/01 12:06:08 ET
Table '2a86NK3xhs21kwGZmbj0QA' 6-max Seat #4 is the button
Seat 1: nCI/286bRXONuVN/6Bn49Q ($232 in chips)
Seat 2: Xl+I49lxCJwPGRuegiaHoA ($3511 in chips)
Seat 3: voSAIKXtXUUbJnds83sYfQ ($1060 in chips)
Seat 4: 1ScqYmNf7/uWx1XSBgPTBw ($221.75 in chips)
Seat 5: efhcaDPhNqQ/H48kMHLa8w ($1144 in chips)
Seat 6: 0OfLwED3kKs3FwY+JlHC0g ($1117 in chips)
efhcaDPhNqQ/H48kMHLa8w: posts small blind $5
0OfLwED3kKs3FwY+JlHC0g: posts big blind $10
*** HOLE CARDS ***
nCI/286bRXONuVN/6Bn49Q: folds
Xl+I49lxCJwPGRuegiaHoA: folds
voSAIKXtXUUbJnds83sYfQ: folds
1ScqYmNf7/uWx1XSBgPTBw: folds
efhcaDPhNqQ/H48kMHLa8w: folds
0OfLwED3kKs3FwY+JlHC0g collected $10 from pot
0OfLwED3kKs3FwY+JlHC0g: doesn't show hand
*** SUMMARY ***
Total pot $10 | Rake $0
Seat 1: nCI/286bRXONuVN/6Bn49Q folded before Flop (didn't bet)
Seat 2: Xl+I49lxCJwPGRuegiaHoA folded before Flop (didn't bet)
Seat 3: voSAIKXtXUUbJnds83sYfQ folded before Flop (didn't bet)
Seat 4: 1ScqYmNf7/uWx1XSBgPTBw (button) folded before Flop (didn't bet)
Seat 5: efhcaDPhNqQ/H48kMHLa8w (small blind) folded before Flop
Seat 6: 0OfLwED3kKs3FwY+JlHC0g (big blind) collected ($10)



PokerStars Game #59964160608:  Hold'em No Limit ($5/$10) - 2009/07/01 12:06:13 ET
Table 'r10wRkUZaNZLcIr0K/VDlg' 6-max Seat #4 is the button
Seat 1: bjInvXcoSxLjVXWB9UWLBQ ($354 in chips)
Seat 2: 1ScqYmNf7/uWx1XSBgPTBw ($185 in chips)
Seat 3: kem0o3a/3AcDZBJg3cdvpQ ($344.50 in chips)
Seat 4: lu4P1Unn4wHCS7lPOOr9gA ($432 in chips)
Seat 5: q/hE9bQrjr91gfn84QYixQ ($350 in chips)
Seat 6: 3mTlg4g0FJN2bo939h/0Wg ($103 in chips)
q/hE9bQrjr91gfn84QYixQ: posts small blind $5
3mTlg4g0FJN2bo939h/0Wg: posts big blind $10
*** HOLE CARDS ***
bjInvXcoSxLjVXWB9UWLBQ: folds
1ScqYmNf7/uWx1XSBgPTBw: folds
kem0o3a/3AcDZBJg3cdvpQ: folds
lu4P1Unn4wHCS7lPOOr9gA: folds
q/hE9bQrjr91gfn84QYixQ: folds
3mTlg4g0FJN2bo939h/0Wg collected $10 from pot
*** SUMMARY ***
Total pot $10 | Rake $0
Seat 1: bjInvXcoSxLjVXWB9UWLBQ folded before Flop (didn't bet)
Seat 2: 1ScqYmNf7/uWx1XSBgPTBw folded before Flop (didn't bet)
Seat 3: kem0o3a/3AcDZBJg3cdvpQ folded before Flop (didn't bet)
Seat 4: lu4P1Unn4wHCS7lPOOr9gA (button) folded before Flop (didn't bet)
Seat 5: q/hE9bQrjr91gfn84QYixQ (small blind) folded before Flop
Seat 6: 3mTlg4g0FJN2bo939h/0Wg (big blind) collected ($10)



PokerStars Game #59964164420:  Hold'em No Limit ($5/$10) - 2009/07/01 12:06:17 ET
Table 'AI1fZ7Tsbf9DI8mC4EWoQQ' 9-max Seat #2 is the button
Seat 2: voSAIKXtXUUbJnds83sYfQ ($1129 in chips)
Seat 4: efhcaDPhNqQ/H48kMHLa8w ($1047 in chips)
Seat 5: 2PHCSXghjbGk2qR6jDFe2g ($997 in chips)
Seat 6: l9mDFuns/ycIDiFx40BMVw ($780 in chips)
Seat 7: ettgJAblGnistIlqNz4Jww ($1000 in chips)
Seat 8: UgBUE0pOJDwUdQ53XJt8MQ ($120 in chips)
Seat 9: 1s1h7qXmZxmowl9P1VNe2Q ($224.75 in chips)
efhcaDPhNqQ/H48kMHLa8w: posts small blind $5
2PHCSXghjbGk2qR6jDFe2g: posts big blind $10
*** HOLE CARDS ***
l9mDFuns/ycIDiFx40BMVw: folds
ettgJAblGnistIlqNz4Jww: raises $20 to $30
UgBUE0pOJDwUdQ53XJt8MQ: folds
1s1h7qXmZxmowl9P1VNe2Q: folds
voSAIKXtXUUbJnds83sYfQ: folds
efhcaDPhNqQ/H48kMHLa8w: folds
2PHCSXghjbGk2qR6jDFe2g: folds
ettgJAblGnistIlqNz4Jww collected $25 from pot
*** SUMMARY ***
Total pot $25 | Rake $0
Seat 2: voSAIKXtXUUbJnds83sYfQ (button) folded before Flop (didn't bet)
Seat 4: efhcaDPhNqQ/H48kMHLa8w (small blind) folded before Flop
Seat 5: 2PHCSXghjbGk2qR6jDFe2g (big blind) folded before Flop
Seat 6: l9mDFuns/ycIDiFx40BMVw folded before Flop (didn't bet)
Seat 7: ettgJAblGnistIlqNz4Jww collected ($25)
Seat 8: UgBUE0pOJDwUdQ53XJt8MQ folded before Flop (didn't bet)
Seat 9: 1s1h7qXmZxmowl9P1VNe2Q folded before Flop (didn't bet)



PokerStars Game #59964166584:  Hold'em No Limit ($5/$10) - 2009/07/01 12:06:19 ET
Table '2a86NK3xhs21kwGZmbj0QA' 6-max Seat #5 is the button
Seat 2: Xl+I49lxCJwPGRuegiaHoA ($3511 in chips)
Seat 3: voSAIKXtXUUbJnds83sYfQ ($1060 in chips)
Seat 4: 1ScqYmNf7/uWx1XSBgPTBw ($221.75 in chips)
Seat 5: efhcaDPhNqQ/H48kMHLa8w ($1139 in chips)
Seat 6: 0OfLwED3kKs3FwY+JlHC0g ($1122 in chips)
0OfLwED3kKs3FwY+JlHC0g: posts small blind $5
nCI/286bRXONuVN/6Bn49Q: is sitting out
Xl+I49lxCJwPGRuegiaHoA: posts big blind $10
*** HOLE CARDS ***
voSAIKXtXUUbJnds83sYfQ: folds
1ScqYmNf7/uWx1XSBgPTBw: raises $10 to $20
nCI/286bRXONuVN/6Bn49Q leaves the table
efhcaDPhNqQ/H48kMHLa8w: folds
0OfLwED3kKs3FwY+JlHC0g: folds
Xl+I49lxCJwPGRuegiaHoA: folds
1ScqYmNf7/uWx1XSBgPTBw collected $25 from pot
1ScqYmNf7/uWx1XSBgPTBw: doesn't show hand
*** SUMMARY ***
Total pot $25 | Rake $0
Seat 2: Xl+I49lxCJwPGRuegiaHoA (big blind) folded before Flop
Seat 3: voSAIKXtXUUbJnds83sYfQ folded before Flop (didn't bet)
Seat 4: 1ScqYmNf7/uWx1XSBgPTBw collected ($25)
Seat 5: efhcaDPhNqQ/H48kMHLa8w (button) folded before Flop (didn't bet)
Seat 6: 0OfLwED3kKs3FwY+JlHC0g (small blind) folded before Flop



PokerStars Game #59964166156:  Hold'em No Limit ($5/$10) - 2009/07/01 12:06:19 ET
Table 'AiNa6yyp/njJVRYl/Lz1KQ' 6-max Seat #1 is the button
Seat 1: C515ewji10HLkUifdjurhw ($217.25 in chips)
Seat 2: 7SUIdtQak1SCtldWHjwnFA ($216 in chips)
Seat 3: 3mTlg4g0FJN2bo939h/0Wg ($294.75 in chips)
Seat 4: /F5e5TKT/1B9kgJVuQttsg ($354 in chips)
Seat 5: 2PHCSXghjbGk2qR6jDFe2g ($291 in chips)
Seat 6: kem0o3a/3AcDZBJg3cdvpQ ($242 in chips)
7SUIdtQak1SCtldWHjwnFA: posts small blind $5
3mTlg4g0FJN2bo939h/0Wg: posts big blind $10
*** HOLE CARDS ***
/F5e5TKT/1B9kgJVuQttsg: folds
2PHCSXghjbGk2qR6jDFe2g: folds
kem0o3a/3AcDZBJg3cdvpQ: folds
C515ewji10HLkUifdjurhw: folds
7SUIdtQak1SCtldWHjwnFA: calls $5
3mTlg4g0FJN2bo939h/0Wg: checks
*** FLOP *** [As 2d 2c]
7SUIdtQak1SCtldWHjwnFA: bets $20
3mTlg4g0FJN2bo939h/0Wg: folds
7SUIdtQak1SCtldWHjwnFA collected $19 from pot
7SUIdtQak1SCtldWHjwnFA: doesn't show hand
*** SUMMARY ***
Total pot $20 | Rake $1
Board [As 2d 2c]
Seat 1: C515ewji10HLkUifdjurhw (button) folded before Flop (didn't bet)
Seat 2: 7SUIdtQak1SCtldWHjwnFA (small blind) collected ($19)
Seat 3: 3mTlg4g0FJN2bo939h/0Wg (big blind) folded on the Flop
Seat 4: /F5e5TKT/1B9kgJVuQttsg folded before Flop (didn't bet)
Seat 5: 2PHCSXghjbGk2qR6jDFe2g folded before Flop (didn't bet)
Seat 6: kem0o3a/3AcDZBJg3cdvpQ folded before Flop (didn't bet)



PokerStars Game #59964165980:  Hold'em No Limit ($5/$10) - 2009/07/01 12:06:19 ET
Table 'Q/w/Js5qqrmjD3PYvaqoBg' 2-max Seat #2 is the button
Seat 1: o680fZMaQtqAfYOL5g4iSA ($212.60 in chips)
Seat 2: lhkk4tvkAIWjBBrsHuNe/A ($1372 in chips)
lhkk4tvkAIWjBBrsHuNe/A: posts small blind $5
o680fZMaQtqAfYOL5g4iSA: posts big blind $10
*** HOLE CARDS ***
lhkk4tvkAIWjBBrsHuNe/A: folds
lhkk4tvkAIWjBBrsHuNe/A is sitting out
o680fZMaQtqAfYOL5g4iSA collected $10 from pot
o680fZMaQtqAfYOL5g4iSA: doesn't show hand
*** SUMMARY ***
Total pot $10 | Rake $0
Seat 1: o680fZMaQtqAfYOL5g4iSA (big blind) collected ($10)
Seat 2: lhkk4tvkAIWjBBrsHuNe/A (button) (small blind) folded before Flop



PokerStars Game #59964167970:  Hold'em No Limit ($5/$10) - 2009/07/01 12:06:21 ET
Table '1Dt9cpcLUVE6HYkx5dUEdQ' 6-max Seat #5 is the button
Seat 1: Xl+I49lxCJwPGRuegiaHoA ($1000 in chips)
Seat 2: zdS2zKkZYSRe8p+GVcXMgg ($2299.10 in chips)
Seat 3: Lne9leXjEzXWbU3BGFWsxQ ($1051 in chips)
Seat 4: voSAIKXtXUUbJnds83sYfQ ($1985.75 in chips)
Seat 5: 1ScqYmNf7/uWx1XSBgPTBw ($155 in chips)
Seat 6: efhcaDPhNqQ/H48kMHLa8w ($1837 in chips)
efhcaDPhNqQ/H48kMHLa8w: posts small blind $5
Xl+I49lxCJwPGRuegiaHoA: posts big blind $10
*** HOLE CARDS ***
zdS2zKkZYSRe8p+GVcXMgg: calls $10
Lne9leXjEzXWbU3BGFWsxQ: raises $20 to $30
voSAIKXtXUUbJnds83sYfQ: folds
1ScqYmNf7/uWx1XSBgPTBw: folds
efhcaDPhNqQ/H48kMHLa8w: folds
Xl+I49lxCJwPGRuegiaHoA: folds
zdS2zKkZYSRe8p+GVcXMgg: calls $20
*** FLOP *** [Kh Qh 8h]
zdS2zKkZYSRe8p+GVcXMgg: checks
Lne9leXjEzXWbU3BGFWsxQ: bets $50
zdS2zKkZYSRe8p+GVcXMgg: calls $50
*** TURN *** [Kh Qh 8h] [Th]
zdS2zKkZYSRe8p+GVcXMgg: checks
Lne9leXjEzXWbU3BGFWsxQ: checks
*** RIVER *** [Kh Qh 8h Th] [5s]
zdS2zKkZYSRe8p+GVcXMgg: bets $40
Lne9leXjEzXWbU3BGFWsxQ: calls $40
*** SHOW DOWN ***
zdS2zKkZYSRe8p+GVcXMgg: shows [8d 7h] (a flush, King high)
Lne9leXjEzXWbU3BGFWsxQ: mucks hand
zdS2zKkZYSRe8p+GVcXMgg collected $252 from pot
zdS2zKkZYSRe8p+GVcXMgg is sitting out
*** SUMMARY ***
Total pot $255 | Rake $3
Board [Kh Qh 8h Th 5s]
Seat 1: Xl+I49lxCJwPGRuegiaHoA (big blind) folded before Flop
Seat 2: zdS2zKkZYSRe8p+GVcXMgg showed [8d 7h] and won ($252) with a flush, King high
Seat 3: Lne9leXjEzXWbU3BGFWsxQ mucked
Seat 4: voSAIKXtXUUbJnds83sYfQ folded before Flop (didn't bet)
Seat 5: 1ScqYmNf7/uWx1XSBgPTBw (button) folded before Flop (didn't bet)
Seat 6: efhcaDPhNqQ/H48kMHLa8w (small blind) folded before Flop



PokerStars Game #59964172460:  Hold'em No Limit ($5/$10) - 2009/07/01 12:06:26 ET
Table 'r10wRkUZaNZLcIr0K/VDlg' 6-max Seat #5 is the button
Seat 1: bjInvXcoSxLjVXWB9UWLBQ ($354 in chips)
Seat 2: 1ScqYmNf7/uWx1XSBgPTBw ($185 in chips)
Seat 3: kem0o3a/3AcDZBJg3cdvpQ ($344.50 in chips)
Seat 4: lu4P1Unn4wHCS7lPOOr9gA ($432 in chips)
Seat 5: q/hE9bQrjr91gfn84QYixQ ($345 in chips)
Seat 6: 3mTlg4g0FJN2bo939h/0Wg ($108 in chips)
3mTlg4g0FJN2bo939h/0Wg: posts small blind $5
bjInvXcoSxLjVXWB9UWLBQ: posts big blind $10
*** HOLE CARDS ***
1ScqYmNf7/uWx1XSBgPTBw: raises $10 to $20
kem0o3a/3AcDZBJg3cdvpQ: folds
lu4P1Unn4wHCS7lPOOr9gA: folds
q/hE9bQrjr91gfn84QYixQ: calls $20
3mTlg4g0FJN2bo939h/0Wg: folds
bjInvXcoSxLjVXWB9UWLBQ: calls $10
*** FLOP *** [3d Qd 5c]
bjInvXcoSxLjVXWB9UWLBQ: checks
1ScqYmNf7/uWx1XSBgPTBw: bets $40
q/hE9bQrjr91gfn84QYixQ: calls $40
bjInvXcoSxLjVXWB9UWLBQ: raises $294 to $334 and is all-in
1ScqYmNf7/uWx1XSBgPTBw: calls $125 and is all-in
q/hE9bQrjr91gfn84QYixQ: calls $285 and is all-in
*** TURN *** [3d Qd 5c] [Kd]
*** RIVER *** [3d Qd 5c Kd] [7s]
*** SHOW DOWN ***
bjInvXcoSxLjVXWB9UWLBQ: shows [3s 5d] (two pair, Fives and Threes)
q/hE9bQrjr91gfn84QYixQ: shows [Ad 8d] (a flush, Ace high)
q/hE9bQrjr91gfn84QYixQ collected $320 from side pot
1ScqYmNf7/uWx1XSBgPTBw: mucks hand
q/hE9bQrjr91gfn84QYixQ collected $557 from main pot
*** SUMMARY ***
Total pot $880 Main pot $557. Side pot $320. | Rake $3
Board [3d Qd 5c Kd 7s]
Seat 1: bjInvXcoSxLjVXWB9UWLBQ (big blind) showed [3s 5d] and lost with two pair, Fives and Threes
Seat 2: 1ScqYmNf7/uWx1XSBgPTBw mucked
Seat 3: kem0o3a/3AcDZBJg3cdvpQ folded before Flop (didn't bet)
Seat 4: lu4P1Unn4wHCS7lPOOr9gA folded before Flop (didn't bet)
Seat 5: q/hE9bQrjr91gfn84QYixQ (button) showed [Ad 8d] and won ($877) with a flush, Ace high
Seat 6: 3mTlg4g0FJN2bo939h/0Wg (small blind) folded before Flop



PokerStars Game #59964188134:  Hold'em No Limit ($5/$10) - 2009/07/01 12:06:43 ET
Table '2a86NK3xhs21kwGZmbj0QA' 6-max Seat #6 is the button
Seat 2: Xl+I49lxCJwPGRuegiaHoA ($3501 in chips)
Seat 3: voSAIKXtXUUbJnds83sYfQ ($1060 in chips)
Seat 4: 1ScqYmNf7/uWx1XSBgPTBw ($236.75 in chips)
Seat 5: efhcaDPhNqQ/H48kMHLa8w ($1139 in chips)
Seat 6: 0OfLwED3kKs3FwY+JlHC0g ($1117 in chips)
Xl+I49lxCJwPGRuegiaHoA: posts small blind $5
voSAIKXtXUUbJnds83sYfQ: posts big blind $10
*** HOLE CARDS ***
1ScqYmNf7/uWx1XSBgPTBw: folds
efhcaDPhNqQ/H48kMHLa8w: folds
0OfLwED3kKs3FwY+JlHC0g: folds
Xl+I49lxCJwPGRuegiaHoA: folds
voSAIKXtXUUbJnds83sYfQ collected $10 from pot
voSAIKXtXUUbJnds83sYfQ: doesn't show hand
*** SUMMARY ***
Total pot $10 | Rake $0
Seat 2: Xl+I49lxCJwPGRuegiaHoA (small blind) folded before Flop
Seat 3: voSAIKXtXUUbJnds83sYfQ (big blind) collected ($10)
Seat 4: 1ScqYmNf7/uWx1XSBgPTBw folded before Flop (didn't bet)
Seat 5: efhcaDPhNqQ/H48kMHLa8w folded before Flop (didn't bet)
Seat 6: 0OfLwED3kKs3FwY+JlHC0g (button) folded before Flop (didn't bet)



PokerStars Game #59964190170:  Hold'em No Limit ($5/$10) - 2009/07/01 12:06:45 ET
Table 'AI1fZ7Tsbf9DI8mC4EWoQQ' 9-max Seat #4 is the button
Seat 2: voSAIKXtXUUbJnds83sYfQ ($1129 in chips)
Seat 4: efhcaDPhNqQ/H48kMHLa8w ($1042 in chips)
Seat 5: 2PHCSXghjbGk2qR6jDFe2g ($987 in chips)
Seat 6: l9mDFuns/ycIDiFx40BMVw ($780 in chips)
Seat 7: ettgJAblGnistIlqNz4Jww ($1015 in chips)
Seat 8: UgBUE0pOJDwUdQ53XJt8MQ ($120 in chips)
Seat 9: 1s1h7qXmZxmowl9P1VNe2Q ($224.75 in chips)
2PHCSXghjbGk2qR6jDFe2g: posts small blind $5
l9mDFuns/ycIDiFx40BMVw: posts big blind $10
*** HOLE CARDS ***
ettgJAblGnistIlqNz4Jww: folds
UgBUE0pOJDwUdQ53XJt8MQ: folds
1s1h7qXmZxmowl9P1VNe2Q: folds
voSAIKXtXUUbJnds83sYfQ: folds
efhcaDPhNqQ/H48kMHLa8w: raises $10 to $20
2PHCSXghjbGk2qR6jDFe2g: folds
l9mDFuns/ycIDiFx40BMVw: folds
efhcaDPhNqQ/H48kMHLa8w collected $25 from pot
*** SUMMARY ***
Total pot $25 | Rake $0
Seat 2: voSAIKXtXUUbJnds83sYfQ folded before Flop (didn't bet)
Seat 4: efhcaDPhNqQ/H48kMHLa8w (button) collected ($25)
Seat 5: 2PHCSXghjbGk2qR6jDFe2g (small blind) folded before Flop
Seat 6: l9mDFuns/ycIDiFx40BMVw (big blind) folded before Flop
Seat 7: ettgJAblGnistIlqNz4Jww folded before Flop (didn't bet)
Seat 8: UgBUE0pOJDwUdQ53XJt8MQ folded before Flop (didn't bet)
Seat 9: 1s1h7qXmZxmowl9P1VNe2Q folded before Flop (didn't bet)



PokerStars Game #59964192684:  Hold'em No Limit ($5/$10) - 2009/07/01 12:06:48 ET
Table 'dwLGEw3aoH/cOAI7JsLdmw' 6-max Seat #3 is the button
Seat 2: 1ScqYmNf7/uWx1XSBgPTBw ($386 in chips)
Seat 3: /F5e5TKT/1B9kgJVuQttsg ($300 in chips)
Seat 4: efhcaDPhNqQ/H48kMHLa8w ($1143 in chips)
Seat 5: C515ewji10HLkUifdjurhw ($288.50 in chips)
Seat 6: 3mTlg4g0FJN2bo939h/0Wg ($143.55 in chips)
efhcaDPhNqQ/H48kMHLa8w: posts small blind $5
C515ewji10HLkUifdjurhw: posts big blind $10
ZaYCGtNHUeItoUEheoYDMw: sits out
*** HOLE CARDS ***
3mTlg4g0FJN2bo939h/0Wg: folds
1ScqYmNf7/uWx1XSBgPTBw: raises $10 to $20
/F5e5TKT/1B9kgJVuQttsg: folds
efhcaDPhNqQ/H48kMHLa8w: folds
C515ewji10HLkUifdjurhw: folds
1ScqYmNf7/uWx1XSBgPTBw collected $25 from pot
1ScqYmNf7/uWx1XSBgPTBw: doesn't show hand
*** SUMMARY ***
Total pot $25 | Rake $0
Seat 2: 1ScqYmNf7/uWx1XSBgPTBw collected ($25)
Seat 3: /F5e5TKT/1B9kgJVuQttsg (button) folded before Flop (didn't bet)
Seat 4: efhcaDPhNqQ/H48kMHLa8w (small blind) folded before Flop
Seat 5: C515ewji10HLkUifdjurhw (big blind) folded before Flop
Seat 6: 3mTlg4g0FJN2bo939h/0Wg folded before Flop (didn't bet)



PokerStars Game #59964193570:  Hold'em No Limit ($5/$10) - 2009/07/01 12:06:49 ET
Table 'AiNa6yyp/njJVRYl/Lz1KQ' 6-max Seat #2 is the button
Seat 1: C515ewji10HLkUifdjurhw ($217.25 in chips)
Seat 2: 7SUIdtQak1SCtldWHjwnFA ($225 in chips)
Seat 3: 3mTlg4g0FJN2bo939h/0Wg ($284.75 in chips)
Seat 4: /F5e5TKT/1B9kgJVuQttsg ($354 in chips)
Seat 5: 2PHCSXghjbGk2qR6jDFe2g ($291 in chips)
Seat 6: kem0o3a/3AcDZBJg3cdvpQ ($242 in chips)
3mTlg4g0FJN2bo939h/0Wg: posts small blind $5
/F5e5TKT/1B9kgJVuQttsg: posts big blind $10
*** HOLE CARDS ***
2PHCSXghjbGk2qR6jDFe2g: folds
kem0o3a/3AcDZBJg3cdvpQ: folds
C515ewji10HLkUifdjurhw: raises $10 to $20
7SUIdtQak1SCtldWHjwnFA: folds
3mTlg4g0FJN2bo939h/0Wg: calls $15
/F5e5TKT/1B9kgJVuQttsg: raises $180 to $200
C515ewji10HLkUifdjurhw: folds
3mTlg4g0FJN2bo939h/0Wg: folds
/F5e5TKT/1B9kgJVuQttsg collected $60 from pot
/F5e5TKT/1B9kgJVuQttsg: doesn't show hand
*** SUMMARY ***
Total pot $60 | Rake $0
Seat 1: C515ewji10HLkUifdjurhw folded before Flop
Seat 2: 7SUIdtQak1SCtldWHjwnFA (button) folded before Flop (didn't bet)
Seat 3: 3mTlg4g0FJN2bo939h/0Wg (small blind) folded before Flop
Seat 4: /F5e5TKT/1B9kgJVuQttsg (big blind) collected ($60)
Seat 5: 2PHCSXghjbGk2qR6jDFe2g folded before Flop (didn't bet)
Seat 6: kem0o3a/3AcDZBJg3cdvpQ folded before Flop (didn't bet)



PokerStars Game #59964210090:  Hold'em No Limit ($5/$10) - 2009/07/01 12:07:07 ET
Table 'dwLGEw3aoH/cOAI7JsLdmw' 6-max Seat #4 is the button
Seat 2: 1ScqYmNf7/uWx1XSBgPTBw ($401 in chips)
Seat 3: /F5e5TKT/1B9kgJVuQttsg ($300 in chips)
Seat 4: efhcaDPhNqQ/H48kMHLa8w ($1138 in chips)
Seat 5: C515ewji10HLkUifdjurhw ($278.50 in chips)
Seat 6: 3mTlg4g0FJN2bo939h/0Wg ($143.55 in chips)
C515ewji10HLkUifdjurhw: posts small blind $5
3mTlg4g0FJN2bo939h/0Wg: posts big blind $10
ZaYCGtNHUeItoUEheoYDMw: sits out
*** HOLE CARDS ***
1ScqYmNf7/uWx1XSBgPTBw: folds
/F5e5TKT/1B9kgJVuQttsg: folds
efhcaDPhNqQ/H48kMHLa8w: raises $10 to $20
C515ewji10HLkUifdjurhw: folds
3mTlg4g0FJN2bo939h/0Wg: calls $10
*** FLOP *** [Kd 7d 6d]
3mTlg4g0FJN2bo939h/0Wg: bets $20
efhcaDPhNqQ/H48kMHLa8w: calls $20
*** TURN *** [Kd 7d 6d] [Js]
3mTlg4g0FJN2bo939h/0Wg: bets $103.55 and is all-in
efhcaDPhNqQ/H48kMHLa8w: folds
3mTlg4g0FJN2bo939h/0Wg collected $83 from pot
*** SUMMARY ***
Total pot $85 | Rake $2
Board [Kd 7d 6d Js]
Seat 2: 1ScqYmNf7/uWx1XSBgPTBw folded before Flop (didn't bet)
Seat 3: /F5e5TKT/1B9kgJVuQttsg folded before Flop (didn't bet)
Seat 4: efhcaDPhNqQ/H48kMHLa8w (button) folded on the Turn
Seat 5: C515ewji10HLkUifdjurhw (small blind) folded before Flop
Seat 6: 3mTlg4g0FJN2bo939h/0Wg (big blind) collected ($83)



PokerStars Game #59964220582:  Hold'em No Limit ($5/$10) - 2009/07/01 12:07:18 ET
Table 'AI1fZ7Tsbf9DI8mC4EWoQQ' 9-max Seat #5 is the button
Seat 2: voSAIKXtXUUbJnds83sYfQ ($1129 in chips)
Seat 4: efhcaDPhNqQ/H48kMHLa8w ($1057 in chips)
Seat 5: 2PHCSXghjbGk2qR6jDFe2g ($982 in chips)
Seat 6: l9mDFuns/ycIDiFx40BMVw ($770 in chips)
Seat 7: ettgJAblGnistIlqNz4Jww ($1015 in chips)
Seat 8: UgBUE0pOJDwUdQ53XJt8MQ ($120 in chips)
Seat 9: 1s1h7qXmZxmowl9P1VNe2Q ($224.75 in chips)
l9mDFuns/ycIDiFx40BMVw: posts small blind $5
ettgJAblGnistIlqNz4Jww: posts big blind $10
*** HOLE CARDS ***
UgBUE0pOJDwUdQ53XJt8MQ: folds
1s1h7qXmZxmowl9P1VNe2Q: folds
voSAIKXtXUUbJnds83sYfQ: folds
efhcaDPhNqQ/H48kMHLa8w: folds
2PHCSXghjbGk2qR6jDFe2g: raises $20 to $30
l9mDFuns/ycIDiFx40BMVw: raises $80 to $110
ettgJAblGnistIlqNz4Jww: folds
2PHCSXghjbGk2qR6jDFe2g: folds
l9mDFuns/ycIDiFx40BMVw collected $70 from pot
*** SUMMARY ***
Total pot $70 | Rake $0
Seat 2: voSAIKXtXUUbJnds83sYfQ folded before Flop (didn't bet)
Seat 4: efhcaDPhNqQ/H48kMHLa8w folded before Flop (didn't bet)
Seat 5: 2PHCSXghjbGk2qR6jDFe2g (button) folded before Flop
Seat 6: l9mDFuns/ycIDiFx40BMVw (small blind) collected ($70)
Seat 7: ettgJAblGnistIlqNz4Jww (big blind) folded before Flop
Seat 8: UgBUE0pOJDwUdQ53XJt8MQ folded before Flop (didn't bet)
Seat 9: 1s1h7qXmZxmowl9P1VNe2Q folded before Flop (didn't bet)



PokerStars Game #59964227046:  Hold'em No Limit ($5/$10) - 2009/07/01 12:07:25 ET
Table 'AiNa6yyp/njJVRYl/Lz1KQ' 6-max Seat #3 is the button
Seat 1: C515ewji10HLkUifdjurhw ($197.25 in chips)
Seat 2: 7SUIdtQak1SCtldWHjwnFA ($225 in chips)
Seat 3: 3mTlg4g0FJN2bo939h/0Wg ($264.75 in chips)
Seat 4: /F5e5TKT/1B9kgJVuQttsg ($394 in chips)
Seat 5: 2PHCSXghjbGk2qR6jDFe2g ($291 in chips)
Seat 6: kem0o3a/3AcDZBJg3cdvpQ ($242 in chips)
/F5e5TKT/1B9kgJVuQttsg: posts small blind $5
2PHCSXghjbGk2qR6jDFe2g: posts big blind $10
*** HOLE CARDS ***
kem0o3a/3AcDZBJg3cdvpQ: folds
C515ewji10HLkUifdjurhw: folds
7SUIdtQak1SCtldWHjwnFA: folds
3mTlg4g0FJN2bo939h/0Wg: raises $10 to $20
/F5e5TKT/1B9kgJVuQttsg: raises $160 to $180
2PHCSXghjbGk2qR6jDFe2g: folds
3mTlg4g0FJN2bo939h/0Wg: folds
/F5e5TKT/1B9kgJVuQttsg collected $50 from pot
/F5e5TKT/1B9kgJVuQttsg: doesn't show hand
*** SUMMARY ***
Total pot $50 | Rake $0
Seat 1: C515ewji10HLkUifdjurhw folded before Flop (didn't bet)
Seat 2: 7SUIdtQak1SCtldWHjwnFA folded before Flop (didn't bet)
Seat 3: 3mTlg4g0FJN2bo939h/0Wg (button) folded before Flop
Seat 4: /F5e5TKT/1B9kgJVuQttsg (small blind) collected ($50)
Seat 5: 2PHCSXghjbGk2qR6jDFe2g (big blind) folded before Flop
Seat 6: kem0o3a/3AcDZBJg3cdvpQ folded before Flop (didn't bet)



PokerStars Game #59964227672:  Hold'em No Limit ($5/$10) - 2009/07/01 12:07:26 ET
Table '1Dt9cpcLUVE6HYkx5dUEdQ' 6-max Seat #6 is the button
Seat 1: Xl+I49lxCJwPGRuegiaHoA ($1000 in chips)
Seat 3: Lne9leXjEzXWbU3BGFWsxQ ($1000 in chips)
Seat 4: voSAIKXtXUUbJnds83sYfQ ($1985.75 in chips)
Seat 5: 1ScqYmNf7/uWx1XSBgPTBw ($155 in chips)
Seat 6: efhcaDPhNqQ/H48kMHLa8w ($1832 in chips)
Xl+I49lxCJwPGRuegiaHoA: posts small blind $5
Lne9leXjEzXWbU3BGFWsxQ: posts big blind $10
*** HOLE CARDS ***
voSAIKXtXUUbJnds83sYfQ: folds
1ScqYmNf7/uWx1XSBgPTBw: folds
zdS2zKkZYSRe8p+GVcXMgg leaves the table
nCI/286bRXONuVN/6Bn49Q joins the table at seat #2
efhcaDPhNqQ/H48kMHLa8w: folds
Xl+I49lxCJwPGRuegiaHoA: raises $20 to $30
Lne9leXjEzXWbU3BGFWsxQ: folds
Xl+I49lxCJwPGRuegiaHoA collected $20 from pot
*** SUMMARY ***
Total pot $20 | Rake $0
Seat 1: Xl+I49lxCJwPGRuegiaHoA (small blind) collected ($20)
Seat 3: Lne9leXjEzXWbU3BGFWsxQ (big blind) folded before Flop
Seat 4: voSAIKXtXUUbJnds83sYfQ folded before Flop (didn't bet)
Seat 5: 1ScqYmNf7/uWx1XSBgPTBw folded before Flop (didn't bet)
Seat 6: efhcaDPhNqQ/H48kMHLa8w (button) folded before Flop (didn't bet)



PokerStars Game #59964240578:  Hold'em No Limit ($5/$10) - 2009/07/01 12:07:40 ET
Table 'r10wRkUZaNZLcIr0K/VDlg' 6-max Seat #6 is the button
Seat 2: 1ScqYmNf7/uWx1XSBgPTBw ($200 in chips)
Seat 4: lu4P1Unn4wHCS7lPOOr9gA ($432 in chips)
Seat 5: q/hE9bQrjr91gfn84QYixQ ($877 in chips)
Seat 6: 3mTlg4g0FJN2bo939h/0Wg ($103 in chips)
1ScqYmNf7/uWx1XSBgPTBw: posts small blind $5
kem0o3a/3AcDZBJg3cdvpQ: is sitting out
lu4P1Unn4wHCS7lPOOr9gA: posts big blind $10
*** HOLE CARDS ***
kem0o3a/3AcDZBJg3cdvpQ leaves the table
q/hE9bQrjr91gfn84QYixQ: folds
bjInvXcoSxLjVXWB9UWLBQ has returned
3mTlg4g0FJN2bo939h/0Wg: raises $10 to $20
1ScqYmNf7/uWx1XSBgPTBw: folds
lu4P1Unn4wHCS7lPOOr9gA: calls $10
*** FLOP *** [Kh Qs 4c]
lu4P1Unn4wHCS7lPOOr9gA: checks
3mTlg4g0FJN2bo939h/0Wg: bets $20
lu4P1Unn4wHCS7lPOOr9gA: folds
3mTlg4g0FJN2bo939h/0Wg collected $43 from pot
*** SUMMARY ***
Total pot $45 | Rake $2
Board [Kh Qs 4c]
Seat 2: 1ScqYmNf7/uWx1XSBgPTBw (small blind) folded before Flop
Seat 4: lu4P1Unn4wHCS7lPOOr9gA (big blind) folded on the Flop
Seat 5: q/hE9bQrjr91gfn84QYixQ folded before Flop (didn't bet)
Seat 6: 3mTlg4g0FJN2bo939h/0Wg (button) collected ($43)



PokerStars Game #59964248472:  Hold'em No Limit ($5/$10) - 2009/07/01 12:07:49 ET
Table 'AiNa6yyp/njJVRYl/Lz1KQ' 6-max Seat #4 is the button
Seat 1: C515ewji10HLkUifdjurhw ($197.25 in chips)
Seat 2: 7SUIdtQak1SCtldWHjwnFA ($225 in chips)
Seat 3: 3mTlg4g0FJN2bo939h/0Wg ($244.75 in chips)
Seat 4: /F5e5TKT/1B9kgJVuQttsg ($424 in chips)
Seat 5: 2PHCSXghjbGk2qR6jDFe2g ($281 in chips)
Seat 6: kem0o3a/3AcDZBJg3cdvpQ ($242 in chips)
2PHCSXghjbGk2qR6jDFe2g: posts small blind $5
kem0o3a/3AcDZBJg3cdvpQ: posts big blind $10
*** HOLE CARDS ***
C515ewji10HLkUifdjurhw: folds
7SUIdtQak1SCtldWHjwnFA: folds
3mTlg4g0FJN2bo939h/0Wg: raises $10 to $20
/F5e5TKT/1B9kgJVuQttsg: folds
2PHCSXghjbGk2qR6jDFe2g: folds
kem0o3a/3AcDZBJg3cdvpQ: raises $222 to $242 and is all-in
3mTlg4g0FJN2bo939h/0Wg: folds
kem0o3a/3AcDZBJg3cdvpQ collected $45 from pot
kem0o3a/3AcDZBJg3cdvpQ: doesn't show hand
*** SUMMARY ***
Total pot $45 | Rake $0
Seat 1: C515ewji10HLkUifdjurhw folded before Flop (didn't bet)
Seat 2: 7SUIdtQak1SCtldWHjwnFA folded before Flop (didn't bet)
Seat 3: 3mTlg4g0FJN2bo939h/0Wg folded before Flop
Seat 4: /F5e5TKT/1B9kgJVuQttsg (button) folded before Flop (didn't bet)
Seat 5: 2PHCSXghjbGk2qR6jDFe2g (small blind) folded before Flop
Seat 6: kem0o3a/3AcDZBJg3cdvpQ (big blind) collected ($45)



PokerStars Game #59964261084:  Hold'em No Limit ($5/$10) - 2009/07/01 12:08:02 ET
Table 'AI1fZ7Tsbf9DI8mC4EWoQQ' 9-max Seat #6 is the button
Seat 2: voSAIKXtXUUbJnds83sYfQ ($1129 in chips)
Seat 4: efhcaDPhNqQ/H48kMHLa8w ($1057 in chips)
Seat 5: 2PHCSXghjbGk2qR6jDFe2g ($952 in chips)
Seat 6: l9mDFuns/ycIDiFx40BMVw ($810 in chips)
Seat 7: ettgJAblGnistIlqNz4Jww ($1005 in chips)
Seat 8: UgBUE0pOJDwUdQ53XJt8MQ ($120 in chips)
Seat 9: 1s1h7qXmZxmowl9P1VNe2Q ($224.75 in chips)
ettgJAblGnistIlqNz4Jww: posts small blind $5
UgBUE0pOJDwUdQ53XJt8MQ: posts big blind $10
*** HOLE CARDS ***
1s1h7qXmZxmowl9P1VNe2Q: folds
voSAIKXtXUUbJnds83sYfQ: folds
efhcaDPhNqQ/H48kMHLa8w: raises $20 to $30
2PHCSXghjbGk2qR6jDFe2g: folds
l9mDFuns/ycIDiFx40BMVw: folds
ettgJAblGnistIlqNz4Jww: folds
UgBUE0pOJDwUdQ53XJt8MQ: folds
efhcaDPhNqQ/H48kMHLa8w collected $25 from pot
*** SUMMARY ***
Total pot $25 | Rake $0
Seat 2: voSAIKXtXUUbJnds83sYfQ folded before Flop (didn't bet)
Seat 4: efhcaDPhNqQ/H48kMHLa8w collected ($25)
Seat 5: 2PHCSXghjbGk2qR6jDFe2g folded before Flop (didn't bet)
Seat 6: l9mDFuns/ycIDiFx40BMVw (button) folded before Flop (didn't bet)
Seat 7: ettgJAblGnistIlqNz4Jww (small blind) folded before Flop
Seat 8: UgBUE0pOJDwUdQ53XJt8MQ (big blind) folded before Flop
Seat 9: 1s1h7qXmZxmowl9P1VNe2Q folded before Flop (didn't bet)



PokerStars Game #59964264770:  Hold'em No Limit ($5/$10) - 2009/07/01 12:08:06 ET
Table '1Dt9cpcLUVE6HYkx5dUEdQ' 6-max Seat #1 is the button
Seat 1: Xl+I49lxCJwPGRuegiaHoA ($1010 in chips)
Seat 3: Lne9leXjEzXWbU3BGFWsxQ ($1000 in chips)
Seat 4: voSAIKXtXUUbJnds83sYfQ ($1985.75 in chips)
Seat 5: 1ScqYmNf7/uWx1XSBgPTBw ($155 in chips)
Seat 6: efhcaDPhNqQ/H48kMHLa8w ($1832 in chips)
nCI/286bRXONuVN/6Bn49Q will be allowed to play after the button
Lne9leXjEzXWbU3BGFWsxQ: posts small blind $5
voSAIKXtXUUbJnds83sYfQ: posts big blind $10
*** HOLE CARDS ***
1ScqYmNf7/uWx1XSBgPTBw: folds
efhcaDPhNqQ/H48kMHLa8w: folds
Xl+I49lxCJwPGRuegiaHoA: folds
Lne9leXjEzXWbU3BGFWsxQ: folds
voSAIKXtXUUbJnds83sYfQ collected $10 from pot
*** SUMMARY ***
Total pot $10 | Rake $0
Seat 1: Xl+I49lxCJwPGRuegiaHoA (button) folded before Flop (didn't bet)
Seat 3: Lne9leXjEzXWbU3BGFWsxQ (small blind) folded before Flop
Seat 4: voSAIKXtXUUbJnds83sYfQ (big blind) collected ($10)
Seat 5: 1ScqYmNf7/uWx1XSBgPTBw folded before Flop (didn't bet)
Seat 6: efhcaDPhNqQ/H48kMHLa8w folded before Flop (didn't bet)



PokerStars Game #59964265130:  Hold'em No Limit ($5/$10) - 2009/07/01 12:08:07 ET
Table 'r10wRkUZaNZLcIr0K/VDlg' 6-max Seat #2 is the button
Seat 1: bjInvXcoSxLjVXWB9UWLBQ ($309 in chips)
Seat 2: 1ScqYmNf7/uWx1XSBgPTBw ($195 in chips)
Seat 4: lu4P1Unn4wHCS7lPOOr9gA ($412 in chips)
Seat 5: q/hE9bQrjr91gfn84QYixQ ($877 in chips)
Seat 6: 3mTlg4g0FJN2bo939h/0Wg ($126 in chips)
lu4P1Unn4wHCS7lPOOr9gA: posts small blind $5
q/hE9bQrjr91gfn84QYixQ: posts big blind $10
bjInvXcoSxLjVXWB9UWLBQ: posts small blind $5
*** HOLE CARDS ***
3mTlg4g0FJN2bo939h/0Wg: folds
bjInvXcoSxLjVXWB9UWLBQ: folds
1ScqYmNf7/uWx1XSBgPTBw: folds
lu4P1Unn4wHCS7lPOOr9gA: folds
q/hE9bQrjr91gfn84QYixQ collected $15 from pot
q/hE9bQrjr91gfn84QYixQ: doesn't show hand
*** SUMMARY ***
Total pot $15 | Rake $0
Seat 1: bjInvXcoSxLjVXWB9UWLBQ folded before Flop
Seat 2: 1ScqYmNf7/uWx1XSBgPTBw (button) folded before Flop (didn't bet)
Seat 4: lu4P1Unn4wHCS7lPOOr9gA (small blind) folded before Flop
Seat 5: q/hE9bQrjr91gfn84QYixQ (big blind) collected ($15)
Seat 6: 3mTlg4g0FJN2bo939h/0Wg folded before Flop (didn't bet)



PokerStars Game #59964275436:  Hold'em No Limit ($5/$10) - 2009/07/01 12:08:18 ET
Table 'AiNa6yyp/njJVRYl/Lz1KQ' 6-max Seat #5 is the button
Seat 1: C515ewji10HLkUifdjurhw ($197.25 in chips)
Seat 2: 7SUIdtQak1SCtldWHjwnFA ($225 in chips)
Seat 3: 3mTlg4g0FJN2bo939h/0Wg ($224.75 in chips)
Seat 4: /F5e5TKT/1B9kgJVuQttsg ($424 in chips)
Seat 5: 2PHCSXghjbGk2qR6jDFe2g ($276 in chips)
Seat 6: kem0o3a/3AcDZBJg3cdvpQ ($267 in chips)
kem0o3a/3AcDZBJg3cdvpQ: posts small blind $5
C515ewji10HLkUifdjurhw: posts big blind $10
*** HOLE CARDS ***
7SUIdtQak1SCtldWHjwnFA: folds
3mTlg4g0FJN2bo939h/0Wg: folds
/F5e5TKT/1B9kgJVuQttsg: folds
2PHCSXghjbGk2qR6jDFe2g: raises $10 to $20
kem0o3a/3AcDZBJg3cdvpQ: folds
C515ewji10HLkUifdjurhw: folds
2PHCSXghjbGk2qR6jDFe2g collected $25 from pot
2PHCSXghjbGk2qR6jDFe2g: doesn't show hand
*** SUMMARY ***
Total pot $25 | Rake $0
Seat 1: C515ewji10HLkUifdjurhw (big blind) folded before Flop
Seat 2: 7SUIdtQak1SCtldWHjwnFA folded before Flop (didn't bet)
Seat 3: 3mTlg4g0FJN2bo939h/0Wg folded before Flop (didn't bet)
Seat 4: /F5e5TKT/1B9kgJVuQttsg folded before Flop (didn't bet)
Seat 5: 2PHCSXghjbGk2qR6jDFe2g (button) collected ($25)
Seat 6: kem0o3a/3AcDZBJg3cdvpQ (small blind) folded before Flop



PokerStars Game #59964277938:  Hold'em No Limit ($5/$10) - 2009/07/01 12:08:20 ET
Table 'r10wRkUZaNZLcIr0K/VDlg' 6-max Seat #4 is the button
Seat 1: bjInvXcoSxLjVXWB9UWLBQ ($304 in chips)
Seat 2: 1ScqYmNf7/uWx1XSBgPTBw ($195 in chips)
Seat 4: lu4P1Unn4wHCS7lPOOr9gA ($407 in chips)
Seat 5: q/hE9bQrjr91gfn84QYixQ ($887 in chips)
Seat 6: 3mTlg4g0FJN2bo939h/0Wg ($126 in chips)
q/hE9bQrjr91gfn84QYixQ: posts small blind $5
3mTlg4g0FJN2bo939h/0Wg: posts big blind $10
*** HOLE CARDS ***
bjInvXcoSxLjVXWB9UWLBQ: folds
1ScqYmNf7/uWx1XSBgPTBw: folds
lu4P1Unn4wHCS7lPOOr9gA: folds
q/hE9bQrjr91gfn84QYixQ: folds
3mTlg4g0FJN2bo939h/0Wg collected $10 from pot
*** SUMMARY ***
Total pot $10 | Rake $0
Seat 1: bjInvXcoSxLjVXWB9UWLBQ folded before Flop (didn't bet)
Seat 2: 1ScqYmNf7/uWx1XSBgPTBw folded before Flop (didn't bet)
Seat 4: lu4P1Unn4wHCS7lPOOr9gA (button) folded before Flop (didn't bet)
Seat 5: q/hE9bQrjr91gfn84QYixQ (small blind) folded before Flop
Seat 6: 3mTlg4g0FJN2bo939h/0Wg (big blind) collected ($10)



PokerStars Game #59964283134:  Hold'em No Limit ($5/$10) - 2009/07/01 12:08:26 ET
Table 'AI1fZ7Tsbf9DI8mC4EWoQQ' 9-max Seat #7 is the button
Seat 2: voSAIKXtXUUbJnds83sYfQ ($1129 in chips)
Seat 4: efhcaDPhNqQ/H48kMHLa8w ($1072 in chips)
Seat 5: 2PHCSXghjbGk2qR6jDFe2g ($952 in chips)
Seat 6: l9mDFuns/ycIDiFx40BMVw ($810 in chips)
Seat 7: ettgJAblGnistIlqNz4Jww ($1000 in chips)
Seat 8: UgBUE0pOJDwUdQ53XJt8MQ ($110 in chips)
Seat 9: 1s1h7qXmZxmowl9P1VNe2Q ($224.75 in chips)
UgBUE0pOJDwUdQ53XJt8MQ: posts small blind $5
1s1h7qXmZxmowl9P1VNe2Q: posts big blind $10
*** HOLE CARDS ***
voSAIKXtXUUbJnds83sYfQ: raises $20 to $30
efhcaDPhNqQ/H48kMHLa8w: folds
2PHCSXghjbGk2qR6jDFe2g: folds
l9mDFuns/ycIDiFx40BMVw: folds
ettgJAblGnistIlqNz4Jww: folds
UgBUE0pOJDwUdQ53XJt8MQ: folds
1s1h7qXmZxmowl9P1VNe2Q: folds
voSAIKXtXUUbJnds83sYfQ collected $25 from pot
voSAIKXtXUUbJnds83sYfQ: doesn't show hand
*** SUMMARY ***
Total pot $25 | Rake $0
Seat 2: voSAIKXtXUUbJnds83sYfQ collected ($25)
Seat 4: efhcaDPhNqQ/H48kMHLa8w folded before Flop (didn't bet)
Seat 5: 2PHCSXghjbGk2qR6jDFe2g folded before Flop (didn't bet)
Seat 6: l9mDFuns/ycIDiFx40BMVw folded before Flop (didn't bet)
Seat 7: ettgJAblGnistIlqNz4Jww (button) folded before Flop (didn't bet)
Seat 8: UgBUE0pOJDwUdQ53XJt8MQ (small blind) folded before Flop
Seat 9: 1s1h7qXmZxmowl9P1VNe2Q (big blind) folded before Flop



PokerStars Game #59964284220:  Hold'em No Limit ($5/$10) - 2009/07/01 12:08:27 ET
Table 'dwLGEw3aoH/cOAI7JsLdmw' 6-max Seat #5 is the button
Seat 1: ZaYCGtNHUeItoUEheoYDMw ($200 in chips)
Seat 2: 1ScqYmNf7/uWx1XSBgPTBw ($401 in chips)
Seat 3: /F5e5TKT/1B9kgJVuQttsg ($300 in chips)
Seat 4: efhcaDPhNqQ/H48kMHLa8w ($1098 in chips)
Seat 5: C515ewji10HLkUifdjurhw ($273.50 in chips)
Seat 6: 3mTlg4g0FJN2bo939h/0Wg ($186.55 in chips)
3mTlg4g0FJN2bo939h/0Wg: posts small blind $5
ZaYCGtNHUeItoUEheoYDMw: posts big blind $10
*** HOLE CARDS ***
1ScqYmNf7/uWx1XSBgPTBw: folds
/F5e5TKT/1B9kgJVuQttsg: raises $10 to $20
efhcaDPhNqQ/H48kMHLa8w: folds
C515ewji10HLkUifdjurhw: folds
3mTlg4g0FJN2bo939h/0Wg: folds
ZaYCGtNHUeItoUEheoYDMw: folds
/F5e5TKT/1B9kgJVuQttsg collected $25 from pot
*** SUMMARY ***
Total pot $25 | Rake $0
Seat 1: ZaYCGtNHUeItoUEheoYDMw (big blind) folded before Flop
Seat 2: 1ScqYmNf7/uWx1XSBgPTBw folded before Flop (didn't bet)
Seat 3: /F5e5TKT/1B9kgJVuQttsg collected ($25)
Seat 4: efhcaDPhNqQ/H48kMHLa8w folded before Flop (didn't bet)
Seat 5: C515ewji10HLkUifdjurhw (button) folded before Flop (didn't bet)
Seat 6: 3mTlg4g0FJN2bo939h/0Wg (small blind) folded before Flop



PokerStars Game #59964286288:  Hold'em No Limit ($5/$10) - 2009/07/01 12:08:30 ET
Table '1Dt9cpcLUVE6HYkx5dUEdQ' 6-max Seat #3 is the button
Seat 1: Xl+I49lxCJwPGRuegiaHoA ($1010 in chips)
Seat 3: Lne9leXjEzXWbU3BGFWsxQ ($1000 in chips)
Seat 4: voSAIKXtXUUbJnds83sYfQ ($1990.75 in chips)
Seat 5: 1ScqYmNf7/uWx1XSBgPTBw ($155 in chips)
Seat 6: efhcaDPhNqQ/H48kMHLa8w ($1832 in chips)
voSAIKXtXUUbJnds83sYfQ: posts small blind $5
1ScqYmNf7/uWx1XSBgPTBw: posts big blind $10
nCI/286bRXONuVN/6Bn49Q: sits out
*** HOLE CARDS ***
efhcaDPhNqQ/H48kMHLa8w: folds
Xl+I49lxCJwPGRuegiaHoA: raises $20 to $30
Lne9leXjEzXWbU3BGFWsxQ: folds
voSAIKXtXUUbJnds83sYfQ: folds
1ScqYmNf7/uWx1XSBgPTBw: raises $125 to $155 and is all-in
Xl+I49lxCJwPGRuegiaHoA: folds
1ScqYmNf7/uWx1XSBgPTBw collected $65 from pot
*** SUMMARY ***
Total pot $65 | Rake $0
Seat 1: Xl+I49lxCJwPGRuegiaHoA folded before Flop
Seat 3: Lne9leXjEzXWbU3BGFWsxQ (button) folded before Flop (didn't bet)
Seat 4: voSAIKXtXUUbJnds83sYfQ (small blind) folded before Flop
Seat 5: 1ScqYmNf7/uWx1XSBgPTBw (big blind) collected ($65)
Seat 6: efhcaDPhNqQ/H48kMHLa8w folded before Flop (didn't bet)



PokerStars Game #59964288654:  Hold'em No Limit ($5/$10) - 2009/07/01 12:08:32 ET
Table 'r10wRkUZaNZLcIr0K/VDlg' 6-max Seat #5 is the button
Seat 1: bjInvXcoSxLjVXWB9UWLBQ ($304 in chips)
Seat 2: 1ScqYmNf7/uWx1XSBgPTBw ($195 in chips)
Seat 4: lu4P1Unn4wHCS7lPOOr9gA ($407 in chips)
Seat 5: q/hE9bQrjr91gfn84QYixQ ($882 in chips)
Seat 6: 3mTlg4g0FJN2bo939h/0Wg ($131 in chips)
3mTlg4g0FJN2bo939h/0Wg: posts small blind $5
bjInvXcoSxLjVXWB9UWLBQ: posts big blind $10
*** HOLE CARDS ***
1ScqYmNf7/uWx1XSBgPTBw: raises $10 to $20
lu4P1Unn4wHCS7lPOOr9gA: folds
q/hE9bQrjr91gfn84QYixQ: calls $20
3mTlg4g0FJN2bo939h/0Wg: calls $15
bjInvXcoSxLjVXWB9UWLBQ: calls $10
*** FLOP *** [Tc Qd Ts]
3mTlg4g0FJN2bo939h/0Wg: checks
bjInvXcoSxLjVXWB9UWLBQ: checks
1ScqYmNf7/uWx1XSBgPTBw: checks
q/hE9bQrjr91gfn84QYixQ: checks
*** TURN *** [Tc Qd Ts] [5d]
3mTlg4g0FJN2bo939h/0Wg: checks
bjInvXcoSxLjVXWB9UWLBQ: checks
1ScqYmNf7/uWx1XSBgPTBw: checks
q/hE9bQrjr91gfn84QYixQ: checks
*** RIVER *** [Tc Qd Ts 5d] [5s]
3mTlg4g0FJN2bo939h/0Wg: checks
bjInvXcoSxLjVXWB9UWLBQ: checks
1ScqYmNf7/uWx1XSBgPTBw: bets $20
q/hE9bQrjr91gfn84QYixQ: calls $20
3mTlg4g0FJN2bo939h/0Wg: folds
bjInvXcoSxLjVXWB9UWLBQ: folds
*** SHOW DOWN ***
1ScqYmNf7/uWx1XSBgPTBw: shows [As Kd] (two pair, Tens and Fives)
q/hE9bQrjr91gfn84QYixQ: shows [5c Ac] (a full house, Fives full of Tens)
q/hE9bQrjr91gfn84QYixQ collected $118 from pot
*** SUMMARY ***
Total pot $120 | Rake $2
Board [Tc Qd Ts 5d 5s]
Seat 1: bjInvXcoSxLjVXWB9UWLBQ (big blind) folded on the River
Seat 2: 1ScqYmNf7/uWx1XSBgPTBw showed [As Kd] and lost with two pair, Tens and Fives
Seat 4: lu4P1Unn4wHCS7lPOOr9gA folded before Flop (didn't bet)
Seat 5: q/hE9bQrjr91gfn84QYixQ (button) showed [5c Ac] and won ($118) with a full house, Fives full of Tens
Seat 6: 3mTlg4g0FJN2bo939h/0Wg (small blind) folded on the River



PokerStars Game #59964295886:  Hold'em No Limit ($5/$10) - 2009/07/01 12:08:41 ET
Table 'AiNa6yyp/njJVRYl/Lz1KQ' 6-max Seat #6 is the button
Seat 1: C515ewji10HLkUifdjurhw ($187.25 in chips)
Seat 2: 7SUIdtQak1SCtldWHjwnFA ($225 in chips)
Seat 3: 3mTlg4g0FJN2bo939h/0Wg ($224.75 in chips)
Seat 4: /F5e5TKT/1B9kgJVuQttsg ($424 in chips)
Seat 5: 2PHCSXghjbGk2qR6jDFe2g ($291 in chips)
Seat 6: kem0o3a/3AcDZBJg3cdvpQ ($262 in chips)
C515ewji10HLkUifdjurhw: posts small blind $5
7SUIdtQak1SCtldWHjwnFA: posts big blind $10
*** HOLE CARDS ***
3mTlg4g0FJN2bo939h/0Wg: folds
/F5e5TKT/1B9kgJVuQttsg: folds
2PHCSXghjbGk2qR6jDFe2g: folds
kem0o3a/3AcDZBJg3cdvpQ: folds
C515ewji10HLkUifdjurhw: folds
7SUIdtQak1SCtldWHjwnFA collected $10 from pot
7SUIdtQak1SCtldWHjwnFA: doesn't show hand
*** SUMMARY ***
Total pot $10 | Rake $0
Seat 1: C515ewji10HLkUifdjurhw (small blind) folded before Flop
Seat 2: 7SUIdtQak1SCtldWHjwnFA (big blind) collected ($10)
Seat 3: 3mTlg4g0FJN2bo939h/0Wg folded before Flop (didn't bet)
Seat 4: /F5e5TKT/1B9kgJVuQttsg folded before Flop (didn't bet)
Seat 5: 2PHCSXghjbGk2qR6jDFe2g folded before Flop (didn't bet)
Seat 6: kem0o3a/3AcDZBJg3cdvpQ (button) folded before Flop (didn't bet)



PokerStars Game #59964310228:  Hold'em No Limit ($5/$10) - 2009/07/01 12:08:56 ET
Table 'AiNa6yyp/njJVRYl/Lz1KQ' 6-max Seat #1 is the button
Seat 1: C515ewji10HLkUifdjurhw ($182.25 in chips)
Seat 2: 7SUIdtQak1SCtldWHjwnFA ($230 in chips)
Seat 3: 3mTlg4g0FJN2bo939h/0Wg ($224.75 in chips)
Seat 4: /F5e5TKT/1B9kgJVuQttsg ($424 in chips)
Seat 5: 2PHCSXghjbGk2qR6jDFe2g ($291 in chips)
Seat 6: kem0o3a/3AcDZBJg3cdvpQ ($262 in chips)
7SUIdtQak1SCtldWHjwnFA: posts small blind $5
3mTlg4g0FJN2bo939h/0Wg: posts big blind $10
*** HOLE CARDS ***
/F5e5TKT/1B9kgJVuQttsg: folds
/F5e5TKT/1B9kgJVuQttsg leaves the table
2PHCSXghjbGk2qR6jDFe2g: folds
kem0o3a/3AcDZBJg3cdvpQ: folds
C515ewji10HLkUifdjurhw: raises $10 to $20
7SUIdtQak1SCtldWHjwnFA: folds
3mTlg4g0FJN2bo939h/0Wg: calls $10
*** FLOP *** [9h 6s 3d]
3mTlg4g0FJN2bo939h/0Wg: bets $20
C515ewji10HLkUifdjurhw: calls $20
*** TURN *** [9h 6s 3d] [7s]
3mTlg4g0FJN2bo939h/0Wg: checks
C515ewji10HLkUifdjurhw: bets $50
1ScqYmNf7/uWx1XSBgPTBw joins the table at seat #4
3mTlg4g0FJN2bo939h/0Wg: raises $134.75 to $184.75 and is all-in
C515ewji10HLkUifdjurhw: folds
3mTlg4g0FJN2bo939h/0Wg collected $182 from pot
*** SUMMARY ***
Total pot $185 | Rake $3
Board [9h 6s 3d 7s]
Seat 1: C515ewji10HLkUifdjurhw (button) folded on the Turn
Seat 2: 7SUIdtQak1SCtldWHjwnFA (small blind) folded before Flop
Seat 3: 3mTlg4g0FJN2bo939h/0Wg (big blind) collected ($182)
Seat 4: /F5e5TKT/1B9kgJVuQttsg folded before Flop (didn't bet)
Seat 5: 2PHCSXghjbGk2qR6jDFe2g folded before Flop (didn't bet)
Seat 6: kem0o3a/3AcDZBJg3cdvpQ folded before Flop (didn't bet)



PokerStars Game #59964318120:  Hold'em No Limit ($5/$10) - 2009/07/01 12:09:04 ET
Table 'AI1fZ7Tsbf9DI8mC4EWoQQ' 9-max Seat #8 is the button
Seat 2: voSAIKXtXUUbJnds83sYfQ ($1144 in chips)
Seat 4: efhcaDPhNqQ/H48kMHLa8w ($1072 in chips)
Seat 5: 2PHCSXghjbGk2qR6jDFe2g ($952 in chips)
Seat 6: l9mDFuns/ycIDiFx40BMVw ($810 in chips)
Seat 7: ettgJAblGnistIlqNz4Jww ($1000 in chips)
Seat 8: UgBUE0pOJDwUdQ53XJt8MQ ($105 in chips)
Seat 9: 1s1h7qXmZxmowl9P1VNe2Q ($214.75 in chips)
1s1h7qXmZxmowl9P1VNe2Q: posts small blind $5
voSAIKXtXUUbJnds83sYfQ: posts big blind $10
*** HOLE CARDS ***
QjU8cx/IlcsbRKufwbiKow has returned
efhcaDPhNqQ/H48kMHLa8w: raises $20 to $30
2PHCSXghjbGk2qR6jDFe2g: folds
l9mDFuns/ycIDiFx40BMVw: folds
ettgJAblGnistIlqNz4Jww: folds
UgBUE0pOJDwUdQ53XJt8MQ: folds
1s1h7qXmZxmowl9P1VNe2Q: folds
voSAIKXtXUUbJnds83sYfQ: folds
efhcaDPhNqQ/H48kMHLa8w collected $25 from pot
efhcaDPhNqQ/H48kMHLa8w: doesn't show hand
*** SUMMARY ***
Total pot $25 | Rake $0
Seat 2: voSAIKXtXUUbJnds83sYfQ (big blind) folded before Flop
Seat 4: efhcaDPhNqQ/H48kMHLa8w collected ($25)
Seat 5: 2PHCSXghjbGk2qR6jDFe2g folded before Flop (didn't bet)
Seat 6: l9mDFuns/ycIDiFx40BMVw folded before Flop (didn't bet)
Seat 7: ettgJAblGnistIlqNz4Jww folded before Flop (didn't bet)
Seat 8: UgBUE0pOJDwUdQ53XJt8MQ (button) folded before Flop (didn't bet)
Seat 9: 1s1h7qXmZxmowl9P1VNe2Q (small blind) folded before Flop



PokerStars Game #59964324122:  Hold'em No Limit ($5/$10) - 2009/07/01 12:09:11 ET
Table 'dwLGEw3aoH/cOAI7JsLdmw' 6-max Seat #6 is the button
Seat 1: ZaYCGtNHUeItoUEheoYDMw ($190 in chips)
Seat 3: /F5e5TKT/1B9kgJVuQttsg ($315 in chips)
Seat 4: efhcaDPhNqQ/H48kMHLa8w ($1098 in chips)
Seat 5: C515ewji10HLkUifdjurhw ($273.50 in chips)
Seat 6: 3mTlg4g0FJN2bo939h/0Wg ($181.55 in chips)
ZaYCGtNHUeItoUEheoYDMw: posts small blind $5
1ScqYmNf7/uWx1XSBgPTBw: is sitting out
/F5e5TKT/1B9kgJVuQttsg: posts big blind $10
*** HOLE CARDS ***
1ScqYmNf7/uWx1XSBgPTBw leaves the table
efhcaDPhNqQ/H48kMHLa8w: folds
C515ewji10HLkUifdjurhw: folds
kem0o3a/3AcDZBJg3cdvpQ joins the table at seat #2
3mTlg4g0FJN2bo939h/0Wg: raises $10 to $20
ZaYCGtNHUeItoUEheoYDMw: folds
/F5e5TKT/1B9kgJVuQttsg: folds
3mTlg4g0FJN2bo939h/0Wg collected $25 from pot
*** SUMMARY ***
Total pot $25 | Rake $0
Seat 1: ZaYCGtNHUeItoUEheoYDMw (small blind) folded before Flop
Seat 3: /F5e5TKT/1B9kgJVuQttsg (big blind) folded before Flop
Seat 4: efhcaDPhNqQ/H48kMHLa8w folded before Flop (didn't bet)
Seat 5: C515ewji10HLkUifdjurhw folded before Flop (didn't bet)
Seat 6: 3mTlg4g0FJN2bo939h/0Wg (button) collected ($25)



PokerStars Game #59964325296:  Hold'em No Limit ($5/$10) - 2009/07/01 12:09:12 ET
Table '1Dt9cpcLUVE6HYkx5dUEdQ' 6-max Seat #4 is the button
Seat 1: Xl+I49lxCJwPGRuegiaHoA ($1000 in chips)
Seat 3: Lne9leXjEzXWbU3BGFWsxQ ($1000 in chips)
Seat 4: voSAIKXtXUUbJnds83sYfQ ($1985.75 in chips)
Seat 5: 1ScqYmNf7/uWx1XSBgPTBw ($190 in chips)
Seat 6: efhcaDPhNqQ/H48kMHLa8w ($1832 in chips)
1ScqYmNf7/uWx1XSBgPTBw: posts small blind $5
efhcaDPhNqQ/H48kMHLa8w: posts big blind $10
nCI/286bRXONuVN/6Bn49Q: sits out
*** HOLE CARDS ***
Xl+I49lxCJwPGRuegiaHoA: raises $20 to $30
Lne9leXjEzXWbU3BGFWsxQ: folds
voSAIKXtXUUbJnds83sYfQ: folds
1ScqYmNf7/uWx1XSBgPTBw: folds
efhcaDPhNqQ/H48kMHLa8w: folds
Xl+I49lxCJwPGRuegiaHoA collected $25 from pot
*** SUMMARY ***
Total pot $25 | Rake $0
Seat 1: Xl+I49lxCJwPGRuegiaHoA collected ($25)
Seat 3: Lne9leXjEzXWbU3BGFWsxQ folded before Flop (didn't bet)
Seat 4: voSAIKXtXUUbJnds83sYfQ (button) folded before Flop (didn't bet)
Seat 5: 1ScqYmNf7/uWx1XSBgPTBw (small blind) folded before Flop
Seat 6: efhcaDPhNqQ/H48kMHLa8w (big blind) folded before Flop



PokerStars Game #59964328198:  Hold'em No Limit ($5/$10) - 2009/07/01 12:09:16 ET
Table 'dzUWBUz1AtehXXhTI9CCwA' 2-max Seat #2 is the button
Seat 1: KK2L3ELlZFnDURuAy5bqzQ ($1015 in chips)
Seat 2: o680fZMaQtqAfYOL5g4iSA ($202.60 in chips)
o680fZMaQtqAfYOL5g4iSA: posts small blind $5
KK2L3ELlZFnDURuAy5bqzQ: posts big blind $10
*** HOLE CARDS ***
o680fZMaQtqAfYOL5g4iSA: calls $5
KK2L3ELlZFnDURuAy5bqzQ: checks
*** FLOP *** [9d 2c 3h]
KK2L3ELlZFnDURuAy5bqzQ: checks
o680fZMaQtqAfYOL5g4iSA: checks
*** TURN *** [9d 2c 3h] [8s]
KK2L3ELlZFnDURuAy5bqzQ: checks
o680fZMaQtqAfYOL5g4iSA: bets $20
KK2L3ELlZFnDURuAy5bqzQ: folds
o680fZMaQtqAfYOL5g4iSA collected $19.50 from pot
*** SUMMARY ***
Total pot $20 | Rake $0.50
Board [9d 2c 3h 8s]
Seat 1: KK2L3ELlZFnDURuAy5bqzQ (big blind) folded on the Turn
Seat 2: o680fZMaQtqAfYOL5g4iSA (button) (small blind) collected ($19.50)



PokerStars Game #59964340054:  Hold'em No Limit ($5/$10) - 2009/07/01 12:09:28 ET
Table 'AI1fZ7Tsbf9DI8mC4EWoQQ' 9-max Seat #9 is the button
Seat 2: voSAIKXtXUUbJnds83sYfQ ($1134 in chips)
Seat 3: QjU8cx/IlcsbRKufwbiKow ($1000 in chips)
Seat 4: efhcaDPhNqQ/H48kMHLa8w ($1087 in chips)
Seat 5: 2PHCSXghjbGk2qR6jDFe2g ($952 in chips)
Seat 6: l9mDFuns/ycIDiFx40BMVw ($810 in chips)
Seat 7: ettgJAblGnistIlqNz4Jww ($1000 in chips)
Seat 8: UgBUE0pOJDwUdQ53XJt8MQ ($105 in chips)
Seat 9: 1s1h7qXmZxmowl9P1VNe2Q ($209.75 in chips)
voSAIKXtXUUbJnds83sYfQ: posts small blind $5
QjU8cx/IlcsbRKufwbiKow: posts big blind $10
*** HOLE CARDS ***
efhcaDPhNqQ/H48kMHLa8w: folds
2PHCSXghjbGk2qR6jDFe2g: folds
l9mDFuns/ycIDiFx40BMVw: folds
ettgJAblGnistIlqNz4Jww: raises $20 to $30
UgBUE0pOJDwUdQ53XJt8MQ: folds
1s1h7qXmZxmowl9P1VNe2Q: folds
voSAIKXtXUUbJnds83sYfQ: folds
QjU8cx/IlcsbRKufwbiKow: folds
ettgJAblGnistIlqNz4Jww collected $25 from pot
ettgJAblGnistIlqNz4Jww: doesn't show hand
*** SUMMARY ***
Total pot $25 | Rake $0
Seat 2: voSAIKXtXUUbJnds83sYfQ (small blind) folded before Flop
Seat 3: QjU8cx/IlcsbRKufwbiKow (big blind) folded before Flop
Seat 4: efhcaDPhNqQ/H48kMHLa8w folded before Flop (didn't bet)
Seat 5: 2PHCSXghjbGk2qR6jDFe2g folded before Flop (didn't bet)
Seat 6: l9mDFuns/ycIDiFx40BMVw folded before Flop (didn't bet)
Seat 7: ettgJAblGnistIlqNz4Jww collected ($25)
Seat 8: UgBUE0pOJDwUdQ53XJt8MQ folded before Flop (didn't bet)
Seat 9: 1s1h7qXmZxmowl9P1VNe2Q (button) folded before Flop (didn't bet)



PokerStars Game #59964351184:  Hold'em No Limit ($5/$10) - 2009/07/01 12:09:40 ET
Table 'r10wRkUZaNZLcIr0K/VDlg' 6-max Seat #6 is the button
Seat 1: bjInvXcoSxLjVXWB9UWLBQ ($284 in chips)
Seat 2: 1ScqYmNf7/uWx1XSBgPTBw ($155 in chips)
Seat 4: lu4P1Unn4wHCS7lPOOr9gA ($407 in chips)
Seat 5: q/hE9bQrjr91gfn84QYixQ ($960 in chips)
Seat 6: 3mTlg4g0FJN2bo939h/0Wg ($111 in chips)
bjInvXcoSxLjVXWB9UWLBQ: posts small blind $5
1ScqYmNf7/uWx1XSBgPTBw: posts big blind $10
*** HOLE CARDS ***
lu4P1Unn4wHCS7lPOOr9gA: raises $10 to $20
q/hE9bQrjr91gfn84QYixQ: calls $20
3mTlg4g0FJN2bo939h/0Wg: calls $20
bjInvXcoSxLjVXWB9UWLBQ: folds
1ScqYmNf7/uWx1XSBgPTBw: folds
*** FLOP *** [6d 3h 7c]
lu4P1Unn4wHCS7lPOOr9gA: bets $30
q/hE9bQrjr91gfn84QYixQ: folds
3mTlg4g0FJN2bo939h/0Wg: calls $30
*** TURN *** [6d 3h 7c] [8c]
lu4P1Unn4wHCS7lPOOr9gA: checks
3mTlg4g0FJN2bo939h/0Wg: checks
*** RIVER *** [6d 3h 7c 8c] [5d]
lu4P1Unn4wHCS7lPOOr9gA: bets $200
3mTlg4g0FJN2bo939h/0Wg: folds
lu4P1Unn4wHCS7lPOOr9gA collected $133 from pot
*** SUMMARY ***
Total pot $135 | Rake $2
Board [6d 3h 7c 8c 5d]
Seat 1: bjInvXcoSxLjVXWB9UWLBQ (small blind) folded before Flop
Seat 2: 1ScqYmNf7/uWx1XSBgPTBw (big blind) folded before Flop
Seat 4: lu4P1Unn4wHCS7lPOOr9gA collected ($133)
Seat 5: q/hE9bQrjr91gfn84QYixQ folded on the Flop
Seat 6: 3mTlg4g0FJN2bo939h/0Wg (button) folded on the River



PokerStars Game #59964360200:  Hold'em No Limit ($5/$10) - 2009/07/01 12:09:50 ET
Table 'AiNa6yyp/njJVRYl/Lz1KQ' 6-max Seat #2 is the button
Seat 1: C515ewji10HLkUifdjurhw ($92.25 in chips)
Seat 2: 7SUIdtQak1SCtldWHjwnFA ($225 in chips)
Seat 3: 3mTlg4g0FJN2bo939h/0Wg ($316.75 in chips)
Seat 4: 1ScqYmNf7/uWx1XSBgPTBw ($200 in chips)
Seat 5: 2PHCSXghjbGk2qR6jDFe2g ($291 in chips)
Seat 6: kem0o3a/3AcDZBJg3cdvpQ ($262 in chips)
3mTlg4g0FJN2bo939h/0Wg: posts small blind $5
1ScqYmNf7/uWx1XSBgPTBw: posts big blind $10
*** HOLE CARDS ***
2PHCSXghjbGk2qR6jDFe2g: folds
kem0o3a/3AcDZBJg3cdvpQ: folds
C515ewji10HLkUifdjurhw: folds
7SUIdtQak1SCtldWHjwnFA: folds
3mTlg4g0FJN2bo939h/0Wg: calls $5
1ScqYmNf7/uWx1XSBgPTBw: checks
*** FLOP *** [Th Ts 2s]
3mTlg4g0FJN2bo939h/0Wg: bets $20
1ScqYmNf7/uWx1XSBgPTBw: folds
3mTlg4g0FJN2bo939h/0Wg collected $19 from pot
*** SUMMARY ***
Total pot $20 | Rake $1
Board [Th Ts 2s]
Seat 1: C515ewji10HLkUifdjurhw folded before Flop (didn't bet)
Seat 2: 7SUIdtQak1SCtldWHjwnFA (button) folded before Flop (didn't bet)
Seat 3: 3mTlg4g0FJN2bo939h/0Wg (small blind) collected ($19)
Seat 4: 1ScqYmNf7/uWx1XSBgPTBw (big blind) folded on the Flop
Seat 5: 2PHCSXghjbGk2qR6jDFe2g folded before Flop (didn't bet)
Seat 6: kem0o3a/3AcDZBJg3cdvpQ folded before Flop (didn't bet)



PokerStars Game #59964363206:  Hold'em No Limit ($5/$10) - 2009/07/01 12:09:53 ET
Table '1Dt9cpcLUVE6HYkx5dUEdQ' 6-max Seat #5 is the button
Seat 1: Xl+I49lxCJwPGRuegiaHoA ($1015 in chips)
Seat 3: Lne9leXjEzXWbU3BGFWsxQ ($1000 in chips)
Seat 4: voSAIKXtXUUbJnds83sYfQ ($1985.75 in chips)
Seat 5: 1ScqYmNf7/uWx1XSBgPTBw ($185 in chips)
Seat 6: efhcaDPhNqQ/H48kMHLa8w ($1822 in chips)
efhcaDPhNqQ/H48kMHLa8w: posts small blind $5
Xl+I49lxCJwPGRuegiaHoA: posts big blind $10
nCI/286bRXONuVN/6Bn49Q: sits out
*** HOLE CARDS ***
Lne9leXjEzXWbU3BGFWsxQ: folds
voSAIKXtXUUbJnds83sYfQ: folds
1ScqYmNf7/uWx1XSBgPTBw: folds
efhcaDPhNqQ/H48kMHLa8w: folds
Xl+I49lxCJwPGRuegiaHoA collected $10 from pot
*** SUMMARY ***
Total pot $10 | Rake $0
Seat 1: Xl+I49lxCJwPGRuegiaHoA (big blind) collected ($10)
Seat 3: Lne9leXjEzXWbU3BGFWsxQ folded before Flop (didn't bet)
Seat 4: voSAIKXtXUUbJnds83sYfQ folded before Flop (didn't bet)
Seat 5: 1ScqYmNf7/uWx1XSBgPTBw (button) folded before Flop (didn't bet)
Seat 6: efhcaDPhNqQ/H48kMHLa8w (small blind) folded before Flop



PokerStars Game #59964367666:  Hold'em No Limit ($5/$10) - 2009/07/01 12:09:58 ET
Table 'dzUWBUz1AtehXXhTI9CCwA' 2-max Seat #1 is the button
Seat 1: KK2L3ELlZFnDURuAy5bqzQ ($1005 in chips)
Seat 2: o680fZMaQtqAfYOL5g4iSA ($212.10 in chips)
KK2L3ELlZFnDURuAy5bqzQ: posts small blind $5
o680fZMaQtqAfYOL5g4iSA: posts big blind $10
*** HOLE CARDS ***
KK2L3ELlZFnDURuAy5bqzQ: raises $20 to $30
o680fZMaQtqAfYOL5g4iSA: calls $20
*** FLOP *** [Ks 8d Kd]
o680fZMaQtqAfYOL5g4iSA: bets $30
KK2L3ELlZFnDURuAy5bqzQ: raises $60 to $90
o680fZMaQtqAfYOL5g4iSA: folds
KK2L3ELlZFnDURuAy5bqzQ collected $119.50 from pot
KK2L3ELlZFnDURuAy5bqzQ: doesn't show hand
*** SUMMARY ***
Total pot $120 | Rake $0.50
Board [Ks 8d Kd]
Seat 1: KK2L3ELlZFnDURuAy5bqzQ (button) (small blind) collected ($119.50)
Seat 2: o680fZMaQtqAfYOL5g4iSA (big blind) folded on the Flop



PokerStars Game #59964372442:  Hold'em No Limit ($5/$10) - 2009/07/01 12:10:04 ET
Table 'AI1fZ7Tsbf9DI8mC4EWoQQ' 9-max Seat #2 is the button
Seat 2: voSAIKXtXUUbJnds83sYfQ ($1129 in chips)
Seat 3: QjU8cx/IlcsbRKufwbiKow ($990 in chips)
Seat 4: efhcaDPhNqQ/H48kMHLa8w ($1087 in chips)
Seat 5: 2PHCSXghjbGk2qR6jDFe2g ($952 in chips)
Seat 6: l9mDFuns/ycIDiFx40BMVw ($810 in chips)
Seat 7: ettgJAblGnistIlqNz4Jww ($1015 in chips)
Seat 8: UgBUE0pOJDwUdQ53XJt8MQ ($105 in chips)
Seat 9: 1s1h7qXmZxmowl9P1VNe2Q ($209.75 in chips)
QjU8cx/IlcsbRKufwbiKow: posts small blind $5
efhcaDPhNqQ/H48kMHLa8w: posts big blind $10
*** HOLE CARDS ***
2PHCSXghjbGk2qR6jDFe2g: folds
l9mDFuns/ycIDiFx40BMVw: folds
ettgJAblGnistIlqNz4Jww: folds
UgBUE0pOJDwUdQ53XJt8MQ: folds
1s1h7qXmZxmowl9P1VNe2Q: raises $10 to $20
voSAIKXtXUUbJnds83sYfQ: folds
QjU8cx/IlcsbRKufwbiKow: folds
efhcaDPhNqQ/H48kMHLa8w: raises $50 to $70
1s1h7qXmZxmowl9P1VNe2Q: folds
efhcaDPhNqQ/H48kMHLa8w collected $45 from pot
*** SUMMARY ***
Total pot $45 | Rake $0
Seat 2: voSAIKXtXUUbJnds83sYfQ (button) folded before Flop (didn't bet)
Seat 3: QjU8cx/IlcsbRKufwbiKow (small blind) folded before Flop
Seat 4: efhcaDPhNqQ/H48kMHLa8w (big blind) collected ($45)
Seat 5: 2PHCSXghjbGk2qR6jDFe2g folded before Flop (didn't bet)
Seat 6: l9mDFuns/ycIDiFx40BMVw folded before Flop (didn't bet)
Seat 7: ettgJAblGnistIlqNz4Jww folded before Flop (didn't bet)
Seat 8: UgBUE0pOJDwUdQ53XJt8MQ folded before Flop (didn't bet)
Seat 9: 1s1h7qXmZxmowl9P1VNe2Q folded before Flop



PokerStars Game #59964383352:  Hold'em No Limit ($5/$10) - 2009/07/01 12:10:15 ET
Table 'r10wRkUZaNZLcIr0K/VDlg' 6-max Seat #1 is the button
Seat 1: bjInvXcoSxLjVXWB9UWLBQ ($279 in chips)
Seat 2: 1ScqYmNf7/uWx1XSBgPTBw ($145 in chips)
Seat 4: lu4P1Unn4wHCS7lPOOr9gA ($490 in chips)
Seat 5: q/hE9bQrjr91gfn84QYixQ ($940 in chips)
Seat 6: 3mTlg4g0FJN2bo939h/0Wg ($61 in chips)
1ScqYmNf7/uWx1XSBgPTBw: posts small blind $5
lu4P1Unn4wHCS7lPOOr9gA: posts big blind $10
*** HOLE CARDS ***
q/hE9bQrjr91gfn84QYixQ: calls $10
3mTlg4g0FJN2bo939h/0Wg: folds
bjInvXcoSxLjVXWB9UWLBQ: folds
1ScqYmNf7/uWx1XSBgPTBw: folds
lu4P1Unn4wHCS7lPOOr9gA: checks
*** FLOP *** [6d 5h Jc]
lu4P1Unn4wHCS7lPOOr9gA: checks
q/hE9bQrjr91gfn84QYixQ: checks
*** TURN *** [6d 5h Jc] [Qd]
lu4P1Unn4wHCS7lPOOr9gA: bets $20
q/hE9bQrjr91gfn84QYixQ: folds
lu4P1Unn4wHCS7lPOOr9gA collected $23.75 from pot
*** SUMMARY ***
Total pot $25 | Rake $1.25
Board [6d 5h Jc Qd]
Seat 1: bjInvXcoSxLjVXWB9UWLBQ (button) folded before Flop (didn't bet)
Seat 2: 1ScqYmNf7/uWx1XSBgPTBw (small blind) folded before Flop
Seat 4: lu4P1Unn4wHCS7lPOOr9gA (big blind) collected ($23.75)
Seat 5: q/hE9bQrjr91gfn84QYixQ folded on the Turn
Seat 6: 3mTlg4g0FJN2bo939h/0Wg folded before Flop (didn't bet)



PokerStars Game #59964383686:  Hold'em No Limit ($5/$10) - 2009/07/01 12:10:16 ET
Table '1Dt9cpcLUVE6HYkx5dUEdQ' 6-max Seat #6 is the button
Seat 1: Xl+I49lxCJwPGRuegiaHoA ($1020 in chips)
Seat 2: nCI/286bRXONuVN/6Bn49Q ($200 in chips)
Seat 3: Lne9leXjEzXWbU3BGFWsxQ ($1000 in chips)
Seat 4: voSAIKXtXUUbJnds83sYfQ ($1985.75 in chips)
Seat 5: 1ScqYmNf7/uWx1XSBgPTBw ($185 in chips)
Seat 6: efhcaDPhNqQ/H48kMHLa8w ($1817 in chips)
Xl+I49lxCJwPGRuegiaHoA: posts small blind $5
nCI/286bRXONuVN/6Bn49Q: posts big blind $10
*** HOLE CARDS ***
Lne9leXjEzXWbU3BGFWsxQ: raises $20 to $30
voSAIKXtXUUbJnds83sYfQ: folds
1ScqYmNf7/uWx1XSBgPTBw: folds
efhcaDPhNqQ/H48kMHLa8w: folds
Xl+I49lxCJwPGRuegiaHoA: folds
nCI/286bRXONuVN/6Bn49Q: raises $170 to $200 and is all-in
Lne9leXjEzXWbU3BGFWsxQ: calls $170
*** FLOP *** [7s 7d Qh]
*** TURN *** [7s 7d Qh] [8c]
*** RIVER *** [7s 7d Qh 8c] [8h]
*** SHOW DOWN ***
nCI/286bRXONuVN/6Bn49Q: shows [9c 9d] (two pair, Nines and Eights)
Lne9leXjEzXWbU3BGFWsxQ: shows [Qd Ac] (two pair, Queens and Eights)
Lne9leXjEzXWbU3BGFWsxQ collected $402 from pot
*** SUMMARY ***
Total pot $405 | Rake $3
Board [7s 7d Qh 8c 8h]
Seat 1: Xl+I49lxCJwPGRuegiaHoA (small blind) folded before Flop
Seat 2: nCI/286bRXONuVN/6Bn49Q (big blind) showed [9c 9d] and lost with two pair, Nines and Eights
Seat 3: Lne9leXjEzXWbU3BGFWsxQ showed [Qd Ac] and won ($402) with two pair, Queens and Eights
Seat 4: voSAIKXtXUUbJnds83sYfQ folded before Flop (didn't bet)
Seat 5: 1ScqYmNf7/uWx1XSBgPTBw folded before Flop (didn't bet)
Seat 6: efhcaDPhNqQ/H48kMHLa8w (button) folded before Flop (didn't bet)



PokerStars Game #59964384666:  Hold'em No Limit ($5/$10) - 2009/07/01 12:10:17 ET
Table 'dwLGEw3aoH/cOAI7JsLdmw' 6-max Seat #1 is the button
Seat 1: ZaYCGtNHUeItoUEheoYDMw ($185 in chips)
Seat 3: /F5e5TKT/1B9kgJVuQttsg ($305 in chips)
Seat 4: efhcaDPhNqQ/H48kMHLa8w ($1098 in chips)
Seat 5: C515ewji10HLkUifdjurhw ($273.50 in chips)
Seat 6: 3mTlg4g0FJN2bo939h/0Wg ($196.55 in chips)
kem0o3a/3AcDZBJg3cdvpQ will be allowed to play after the button
/F5e5TKT/1B9kgJVuQttsg: posts small blind $5
efhcaDPhNqQ/H48kMHLa8w: posts big blind $10
*** HOLE CARDS ***
C515ewji10HLkUifdjurhw: folds
3mTlg4g0FJN2bo939h/0Wg: raises $10 to $20
ZaYCGtNHUeItoUEheoYDMw: folds
/F5e5TKT/1B9kgJVuQttsg: folds
efhcaDPhNqQ/H48kMHLa8w: folds
3mTlg4g0FJN2bo939h/0Wg collected $25 from pot
*** SUMMARY ***
Total pot $25 | Rake $0
Seat 1: ZaYCGtNHUeItoUEheoYDMw (button) folded before Flop (didn't bet)
Seat 3: /F5e5TKT/1B9kgJVuQttsg (small blind) folded before Flop
Seat 4: efhcaDPhNqQ/H48kMHLa8w (big blind) folded before Flop
Seat 5: C515ewji10HLkUifdjurhw folded before Flop (didn't bet)
Seat 6: 3mTlg4g0FJN2bo939h/0Wg collected ($25)



PokerStars Game #59964385628:  Hold'em No Limit ($5/$10) - 2009/07/01 12:10:19 ET
Table 'AiNa6yyp/njJVRYl/Lz1KQ' 6-max Seat #3 is the button
Seat 1: C515ewji10HLkUifdjurhw ($92.25 in chips)
Seat 2: 7SUIdtQak1SCtldWHjwnFA ($225 in chips)
Seat 3: 3mTlg4g0FJN2bo939h/0Wg ($325.75 in chips)
Seat 4: 1ScqYmNf7/uWx1XSBgPTBw ($190 in chips)
Seat 5: 2PHCSXghjbGk2qR6jDFe2g ($291 in chips)
Seat 6: kem0o3a/3AcDZBJg3cdvpQ ($262 in chips)
1ScqYmNf7/uWx1XSBgPTBw: posts small blind $5
2PHCSXghjbGk2qR6jDFe2g: posts big blind $10
*** HOLE CARDS ***
kem0o3a/3AcDZBJg3cdvpQ: folds
C515ewji10HLkUifdjurhw: folds
7SUIdtQak1SCtldWHjwnFA: raises $12 to $22
3mTlg4g0FJN2bo939h/0Wg: calls $22
1ScqYmNf7/uWx1XSBgPTBw: folds
2PHCSXghjbGk2qR6jDFe2g: folds
*** FLOP *** [9s 9h 6d]
7SUIdtQak1SCtldWHjwnFA: checks
3mTlg4g0FJN2bo939h/0Wg: checks
*** TURN *** [9s 9h 6d] [4h]
7SUIdtQak1SCtldWHjwnFA: checks
3mTlg4g0FJN2bo939h/0Wg: checks
*** RIVER *** [9s 9h 6d 4h] [5c]
7SUIdtQak1SCtldWHjwnFA: checks
3mTlg4g0FJN2bo939h/0Wg: bets $30
7SUIdtQak1SCtldWHjwnFA: folds
3mTlg4g0FJN2bo939h/0Wg collected $56.05 from pot
*** SUMMARY ***
Total pot $59 | Rake $2.95
Board [9s 9h 6d 4h 5c]
Seat 1: C515ewji10HLkUifdjurhw folded before Flop (didn't bet)
Seat 2: 7SUIdtQak1SCtldWHjwnFA folded on the River
Seat 3: 3mTlg4g0FJN2bo939h/0Wg (button) collected ($56.05)
Seat 4: 1ScqYmNf7/uWx1XSBgPTBw (small blind) folded before Flop
Seat 5: 2PHCSXghjbGk2qR6jDFe2g (big blind) folded before Flop
Seat 6: kem0o3a/3AcDZBJg3cdvpQ folded before Flop (didn't bet)



PokerStars Game #59964394944:  Hold'em No Limit ($5/$10) - 2009/07/01 12:10:28 ET
Table 'dzUWBUz1AtehXXhTI9CCwA' 2-max Seat #2 is the button
Seat 1: KK2L3ELlZFnDURuAy5bqzQ ($1064.50 in chips)
Seat 2: o680fZMaQtqAfYOL5g4iSA ($152.10 in chips)
o680fZMaQtqAfYOL5g4iSA: posts small blind $5
KK2L3ELlZFnDURuAy5bqzQ: posts big blind $10
*** HOLE CARDS ***
o680fZMaQtqAfYOL5g4iSA: raises $10 to $20
KK2L3ELlZFnDURuAy5bqzQ: folds
o680fZMaQtqAfYOL5g4iSA collected $20 from pot
o680fZMaQtqAfYOL5g4iSA: doesn't show hand
*** SUMMARY ***
Total pot $20 | Rake $0
Seat 1: KK2L3ELlZFnDURuAy5bqzQ (big blind) folded before Flop
Seat 2: o680fZMaQtqAfYOL5g4iSA (button) (small blind) collected ($20)



PokerStars Game #59964401508:  Hold'em No Limit ($5/$10) - 2009/07/01 12:10:35 ET
Table 'dzUWBUz1AtehXXhTI9CCwA' 2-max Seat #1 is the button
Seat 1: KK2L3ELlZFnDURuAy5bqzQ ($1054.50 in chips)
Seat 2: o680fZMaQtqAfYOL5g4iSA ($162.10 in chips)
KK2L3ELlZFnDURuAy5bqzQ: posts small blind $5
o680fZMaQtqAfYOL5g4iSA: posts big blind $10
*** HOLE CARDS ***
KK2L3ELlZFnDURuAy5bqzQ: raises $20 to $30
o680fZMaQtqAfYOL5g4iSA: raises $30 to $60
KK2L3ELlZFnDURuAy5bqzQ: calls $30
*** FLOP *** [6d 6c 8h]
o680fZMaQtqAfYOL5g4iSA: checks
KK2L3ELlZFnDURuAy5bqzQ: checks
*** TURN *** [6d 6c 8h] [7h]
o680fZMaQtqAfYOL5g4iSA: bets $102.10 and is all-in
KK2L3ELlZFnDURuAy5bqzQ: folds
o680fZMaQtqAfYOL5g4iSA collected $119.50 from pot
o680fZMaQtqAfYOL5g4iSA: doesn't show hand
*** SUMMARY ***
Total pot $120 | Rake $0.50
Board [6d 6c 8h 7h]
Seat 1: KK2L3ELlZFnDURuAy5bqzQ (button) (small blind) folded on the Turn
Seat 2: o680fZMaQtqAfYOL5g4iSA (big blind) collected ($119.50)



PokerStars Game #59964406322:  Hold'em No Limit ($5/$10) - 2009/07/01 12:10:41 ET
Table 'r10wRkUZaNZLcIr0K/VDlg' 6-max Seat #2 is the button
Seat 1: bjInvXcoSxLjVXWB9UWLBQ ($279 in chips)
Seat 2: 1ScqYmNf7/uWx1XSBgPTBw ($140 in chips)
Seat 4: lu4P1Unn4wHCS7lPOOr9gA ($503.75 in chips)
Seat 5: q/hE9bQrjr91gfn84QYixQ ($930 in chips)
Seat 6: 3mTlg4g0FJN2bo939h/0Wg ($61 in chips)
lu4P1Unn4wHCS7lPOOr9gA: posts small blind $5
q/hE9bQrjr91gfn84QYixQ: posts big blind $10
*** HOLE CARDS ***
3mTlg4g0FJN2bo939h/0Wg: folds
bjInvXcoSxLjVXWB9UWLBQ: folds
1ScqYmNf7/uWx1XSBgPTBw: raises $10 to $20
lu4P1Unn4wHCS7lPOOr9gA: calls $15
q/hE9bQrjr91gfn84QYixQ: calls $10
*** FLOP *** [Ts Jh 4d]
lu4P1Unn4wHCS7lPOOr9gA: checks
q/hE9bQrjr91gfn84QYixQ: checks
1ScqYmNf7/uWx1XSBgPTBw: checks
*** TURN *** [Ts Jh 4d] [8c]
lu4P1Unn4wHCS7lPOOr9gA: checks
q/hE9bQrjr91gfn84QYixQ: checks
1ScqYmNf7/uWx1XSBgPTBw: checks
*** RIVER *** [Ts Jh 4d 8c] [Jd]
lu4P1Unn4wHCS7lPOOr9gA: checks
q/hE9bQrjr91gfn84QYixQ: bets $40
1ScqYmNf7/uWx1XSBgPTBw: folds
lu4P1Unn4wHCS7lPOOr9gA: folds
q/hE9bQrjr91gfn84QYixQ collected $58 from pot
*** SUMMARY ***
Total pot $60 | Rake $2
Board [Ts Jh 4d 8c Jd]
Seat 1: bjInvXcoSxLjVXWB9UWLBQ folded before Flop (didn't bet)
Seat 2: 1ScqYmNf7/uWx1XSBgPTBw (button) folded on the River
Seat 4: lu4P1Unn4wHCS7lPOOr9gA (small blind) folded on the River
Seat 5: q/hE9bQrjr91gfn84QYixQ (big blind) collected ($58)
Seat 6: 3mTlg4g0FJN2bo939h/0Wg folded before Flop (didn't bet)



PokerStars Game #59964414562:  Hold'em No Limit ($5/$10) - 2009/07/01 12:10:50 ET
Table 'AI1fZ7Tsbf9DI8mC4EWoQQ' 9-max Seat #3 is the button
Seat 2: voSAIKXtXUUbJnds83sYfQ ($1129 in chips)
Seat 3: QjU8cx/IlcsbRKufwbiKow ($985 in chips)
Seat 4: efhcaDPhNqQ/H48kMHLa8w ($1112 in chips)
Seat 5: 2PHCSXghjbGk2qR6jDFe2g ($952 in chips)
Seat 6: l9mDFuns/ycIDiFx40BMVw ($810 in chips)
Seat 7: ettgJAblGnistIlqNz4Jww ($1015 in chips)
Seat 8: UgBUE0pOJDwUdQ53XJt8MQ ($105 in chips)
Seat 9: 1s1h7qXmZxmowl9P1VNe2Q ($189.75 in chips)
efhcaDPhNqQ/H48kMHLa8w: posts small blind $5
2PHCSXghjbGk2qR6jDFe2g: posts big blind $10
*** HOLE CARDS ***
l9mDFuns/ycIDiFx40BMVw: raises $20 to $30
ettgJAblGnistIlqNz4Jww: folds
UgBUE0pOJDwUdQ53XJt8MQ: folds
1s1h7qXmZxmowl9P1VNe2Q: folds
voSAIKXtXUUbJnds83sYfQ: folds
QjU8cx/IlcsbRKufwbiKow: folds
efhcaDPhNqQ/H48kMHLa8w: folds
2PHCSXghjbGk2qR6jDFe2g: folds
l9mDFuns/ycIDiFx40BMVw collected $25 from pot
*** SUMMARY ***
Total pot $25 | Rake $0
Seat 2: voSAIKXtXUUbJnds83sYfQ folded before Flop (didn't bet)
Seat 3: QjU8cx/IlcsbRKufwbiKow (button) folded before Flop (didn't bet)
Seat 4: efhcaDPhNqQ/H48kMHLa8w (small blind) folded before Flop
Seat 5: 2PHCSXghjbGk2qR6jDFe2g (big blind) folded before Flop
Seat 6: l9mDFuns/ycIDiFx40BMVw collected ($25)
Seat 7: ettgJAblGnistIlqNz4Jww folded before Flop (didn't bet)
Seat 8: UgBUE0pOJDwUdQ53XJt8MQ folded before Flop (didn't bet)
Seat 9: 1s1h7qXmZxmowl9P1VNe2Q folded before Flop (didn't bet)



PokerStars Game #59964429662:  Hold'em No Limit ($5/$10) - 2009/07/01 12:11:06 ET
Table 'dwLGEw3aoH/cOAI7JsLdmw' 6-max Seat #3 is the button
Seat 1: ZaYCGtNHUeItoUEheoYDMw ($185 in chips)
Seat 3: /F5e5TKT/1B9kgJVuQttsg ($300 in chips)
Seat 4: efhcaDPhNqQ/H48kMHLa8w ($1088 in chips)
Seat 6: 3mTlg4g0FJN2bo939h/0Wg ($211.55 in chips)
efhcaDPhNqQ/H48kMHLa8w: posts small blind $5
C515ewji10HLkUifdjurhw: is sitting out
3mTlg4g0FJN2bo939h/0Wg: posts big blind $10
kem0o3a/3AcDZBJg3cdvpQ: sits out
*** HOLE CARDS ***
C515ewji10HLkUifdjurhw leaves the table
ZaYCGtNHUeItoUEheoYDMw: raises $10 to $20
/F5e5TKT/1B9kgJVuQttsg: folds
efhcaDPhNqQ/H48kMHLa8w: folds
7SUIdtQak1SCtldWHjwnFA joins the table at seat #5
3mTlg4g0FJN2bo939h/0Wg: calls $10
*** FLOP *** [8d Kc 2c]
3mTlg4g0FJN2bo939h/0Wg: checks
ZaYCGtNHUeItoUEheoYDMw: bets $20
3mTlg4g0FJN2bo939h/0Wg: folds
ZaYCGtNHUeItoUEheoYDMw collected $43 from pot
*** SUMMARY ***
Total pot $45 | Rake $2
Board [8d Kc 2c]
Seat 1: ZaYCGtNHUeItoUEheoYDMw collected ($43)
Seat 3: /F5e5TKT/1B9kgJVuQttsg (button) folded before Flop (didn't bet)
Seat 4: efhcaDPhNqQ/H48kMHLa8w (small blind) folded before Flop
Seat 6: 3mTlg4g0FJN2bo939h/0Wg (big blind) folded on the Flop



PokerStars Game #59964435678:  Hold'em No Limit ($5/$10) - 2009/07/01 12:11:13 ET
Table '1Dt9cpcLUVE6HYkx5dUEdQ' 6-max Seat #1 is the button
Seat 1: Xl+I49lxCJwPGRuegiaHoA ($1015 in chips)
Seat 2: nCI/286bRXONuVN/6Bn49Q ($200 in chips)
Seat 4: voSAIKXtXUUbJnds83sYfQ ($1985.75 in chips)
Seat 5: 1ScqYmNf7/uWx1XSBgPTBw ($185 in chips)
Seat 6: efhcaDPhNqQ/H48kMHLa8w ($1817 in chips)
nCI/286bRXONuVN/6Bn49Q: posts small blind $5
Lne9leXjEzXWbU3BGFWsxQ: is sitting out
Lne9leXjEzXWbU3BGFWsxQ leaves the table
voSAIKXtXUUbJnds83sYfQ: posts big blind $10
*** HOLE CARDS ***
1ScqYmNf7/uWx1XSBgPTBw: raises $10 to $20
efhcaDPhNqQ/H48kMHLa8w: folds
UcFkfWngu95uR8Jhrj+HrQ joins the table at seat #3
Xl+I49lxCJwPGRuegiaHoA: folds
nCI/286bRXONuVN/6Bn49Q: folds
voSAIKXtXUUbJnds83sYfQ: folds
1ScqYmNf7/uWx1XSBgPTBw collected $25 from pot
*** SUMMARY ***
Total pot $25 | Rake $0
Seat 1: Xl+I49lxCJwPGRuegiaHoA (button) folded before Flop (didn't bet)
Seat 2: nCI/286bRXONuVN/6Bn49Q (small blind) folded before Flop
Seat 4: voSAIKXtXUUbJnds83sYfQ (big blind) folded before Flop
Seat 5: 1ScqYmNf7/uWx1XSBgPTBw collected ($25)
Seat 6: efhcaDPhNqQ/H48kMHLa8w folded before Flop (didn't bet)



PokerStars Game #59964439680:  Hold'em No Limit ($5/$10) - 2009/07/01 12:11:17 ET
Table 'dzUWBUz1AtehXXhTI9CCwA' 2-max Seat #2 is the button
Seat 1: KK2L3ELlZFnDURuAy5bqzQ ($994.50 in chips)
Seat 2: o680fZMaQtqAfYOL5g4iSA ($221.60 in chips)
o680fZMaQtqAfYOL5g4iSA: posts small blind $5
KK2L3ELlZFnDURuAy5bqzQ: posts big blind $10
*** HOLE CARDS ***
o680fZMaQtqAfYOL5g4iSA: calls $5
KK2L3ELlZFnDURuAy5bqzQ: checks
*** FLOP *** [3d 2c 4s]
KK2L3ELlZFnDURuAy5bqzQ: bets $10
o680fZMaQtqAfYOL5g4iSA: calls $10
*** TURN *** [3d 2c 4s] [2s]
KK2L3ELlZFnDURuAy5bqzQ: checks
o680fZMaQtqAfYOL5g4iSA: checks
*** RIVER *** [3d 2c 4s 2s] [4c]
KK2L3ELlZFnDURuAy5bqzQ: checks
o680fZMaQtqAfYOL5g4iSA: checks
*** SHOW DOWN ***
KK2L3ELlZFnDURuAy5bqzQ: shows [6h 8h] (two pair, Fours and Deuces)
o680fZMaQtqAfYOL5g4iSA: shows [Ac 6s] (two pair, Fours and Deuces - Ace kicker)
o680fZMaQtqAfYOL5g4iSA collected $39.50 from pot
*** SUMMARY ***
Total pot $40 | Rake $0.50
Board [3d 2c 4s 2s 4c]
Seat 1: KK2L3ELlZFnDURuAy5bqzQ (big blind) showed [6h 8h] and lost with two pair, Fours and Deuces
Seat 2: o680fZMaQtqAfYOL5g4iSA (button) (small blind) showed [Ac 6s] and won ($39.50) with two pair, Fours and Deuces



PokerStars Game #59964447216:  Hold'em No Limit ($5/$10) - 2009/07/01 12:11:25 ET
Table 'AI1fZ7Tsbf9DI8mC4EWoQQ' 9-max Seat #4 is the button
Seat 2: voSAIKXtXUUbJnds83sYfQ ($1129 in chips)
Seat 3: QjU8cx/IlcsbRKufwbiKow ($985 in chips)
Seat 4: efhcaDPhNqQ/H48kMHLa8w ($1107 in chips)
Seat 5: 2PHCSXghjbGk2qR6jDFe2g ($942 in chips)
Seat 6: l9mDFuns/ycIDiFx40BMVw ($825 in chips)
Seat 7: ettgJAblGnistIlqNz4Jww ($1015 in chips)
Seat 8: UgBUE0pOJDwUdQ53XJt8MQ ($105 in chips)
Seat 9: 1s1h7qXmZxmowl9P1VNe2Q ($189.75 in chips)
2PHCSXghjbGk2qR6jDFe2g: posts small blind $5
l9mDFuns/ycIDiFx40BMVw: posts big blind $10
*** HOLE CARDS ***
ettgJAblGnistIlqNz4Jww: raises $20 to $30
UgBUE0pOJDwUdQ53XJt8MQ: folds
1s1h7qXmZxmowl9P1VNe2Q: folds
voSAIKXtXUUbJnds83sYfQ: folds
QjU8cx/IlcsbRKufwbiKow: folds
efhcaDPhNqQ/H48kMHLa8w: folds
2PHCSXghjbGk2qR6jDFe2g: folds
l9mDFuns/ycIDiFx40BMVw: folds
ettgJAblGnistIlqNz4Jww collected $25 from pot
ettgJAblGnistIlqNz4Jww: doesn't show hand
*** SUMMARY ***
Total pot $25 | Rake $0
Seat 2: voSAIKXtXUUbJnds83sYfQ folded before Flop (didn't bet)
Seat 3: QjU8cx/IlcsbRKufwbiKow folded before Flop (didn't bet)
Seat 4: efhcaDPhNqQ/H48kMHLa8w (button) folded before Flop (didn't bet)
Seat 5: 2PHCSXghjbGk2qR6jDFe2g (small blind) folded before Flop
Seat 6: l9mDFuns/ycIDiFx40BMVw (big blind) folded before Flop
Seat 7: ettgJAblGnistIlqNz4Jww collected ($25)
Seat 8: UgBUE0pOJDwUdQ53XJt8MQ folded before Flop (didn't bet)
Seat 9: 1s1h7qXmZxmowl9P1VNe2Q folded before Flop (didn't bet)



PokerStars Game #59964449458:  Hold'em No Limit ($5/$10) - 2009/07/01 12:11:28 ET
Table 'r10wRkUZaNZLcIr0K/VDlg' 6-max Seat #4 is the button
Seat 1: bjInvXcoSxLjVXWB9UWLBQ ($279 in chips)
Seat 2: 1ScqYmNf7/uWx1XSBgPTBw ($120 in chips)
Seat 4: lu4P1Unn4wHCS7lPOOr9gA ($483.75 in chips)
Seat 5: q/hE9bQrjr91gfn84QYixQ ($968 in chips)
Seat 6: 3mTlg4g0FJN2bo939h/0Wg ($61 in chips)
q/hE9bQrjr91gfn84QYixQ: posts small blind $5
3mTlg4g0FJN2bo939h/0Wg: posts big blind $10
*** HOLE CARDS ***
bjInvXcoSxLjVXWB9UWLBQ: folds
1ScqYmNf7/uWx1XSBgPTBw: folds
lu4P1Unn4wHCS7lPOOr9gA: folds
q/hE9bQrjr91gfn84QYixQ: folds
3mTlg4g0FJN2bo939h/0Wg collected $10 from pot
*** SUMMARY ***
Total pot $10 | Rake $0
Seat 1: bjInvXcoSxLjVXWB9UWLBQ folded before Flop (didn't bet)
Seat 2: 1ScqYmNf7/uWx1XSBgPTBw folded before Flop (didn't bet)
Seat 4: lu4P1Unn4wHCS7lPOOr9gA (button) folded before Flop (didn't bet)
Seat 5: q/hE9bQrjr91gfn84QYixQ (small blind) folded before Flop
Seat 6: 3mTlg4g0FJN2bo939h/0Wg (big blind) collected ($10)



PokerStars Game #59964464106:  Hold'em No Limit ($5/$10) - 2009/07/01 12:11:44 ET
Table 'AiNa6yyp/njJVRYl/Lz1KQ' 6-max Seat #4 is the button
Seat 2: 7SUIdtQak1SCtldWHjwnFA ($203 in chips)
Seat 3: 3mTlg4g0FJN2bo939h/0Wg ($359.80 in chips)
Seat 4: 1ScqYmNf7/uWx1XSBgPTBw ($185 in chips)
Seat 5: 2PHCSXghjbGk2qR6jDFe2g ($281 in chips)
2PHCSXghjbGk2qR6jDFe2g: posts small blind $5
kem0o3a/3AcDZBJg3cdvpQ: is sitting out
C515ewji10HLkUifdjurhw: is sitting out
7SUIdtQak1SCtldWHjwnFA: posts big blind $10
*** HOLE CARDS ***
3mTlg4g0FJN2bo939h/0Wg: folds
kem0o3a/3AcDZBJg3cdvpQ leaves the table
1ScqYmNf7/uWx1XSBgPTBw: folds
C515ewji10HLkUifdjurhw leaves the table
2PHCSXghjbGk2qR6jDFe2g: calls $5
7SUIdtQak1SCtldWHjwnFA: checks
*** FLOP *** [6d Jh 9s]
2PHCSXghjbGk2qR6jDFe2g: bets $10
7SUIdtQak1SCtldWHjwnFA: calls $10
*** TURN *** [6d Jh 9s] [Kh]
2PHCSXghjbGk2qR6jDFe2g: bets $10
7SUIdtQak1SCtldWHjwnFA: raises $10 to $20
2PHCSXghjbGk2qR6jDFe2g: calls $10
*** RIVER *** [6d Jh 9s Kh] [6s]
2PHCSXghjbGk2qR6jDFe2g: checks
7SUIdtQak1SCtldWHjwnFA: bets $30
2PHCSXghjbGk2qR6jDFe2g: folds
UcFkfWngu95uR8Jhrj+HrQ joins the table at seat #6
7SUIdtQak1SCtldWHjwnFA collected $78 from pot
7SUIdtQak1SCtldWHjwnFA: doesn't show hand
*** SUMMARY ***
Total pot $80 | Rake $2
Board [6d Jh 9s Kh 6s]
Seat 2: 7SUIdtQak1SCtldWHjwnFA (big blind) collected ($78)
Seat 3: 3mTlg4g0FJN2bo939h/0Wg folded before Flop (didn't bet)
Seat 4: 1ScqYmNf7/uWx1XSBgPTBw (button) folded before Flop (didn't bet)
Seat 5: 2PHCSXghjbGk2qR6jDFe2g (small blind) folded on the River



PokerStars Game #59964465312:  Hold'em No Limit ($5/$10) - 2009/07/01 12:11:45 ET
Table 'r10wRkUZaNZLcIr0K/VDlg' 6-max Seat #5 is the button
Seat 1: bjInvXcoSxLjVXWB9UWLBQ ($279 in chips)
Seat 2: 1ScqYmNf7/uWx1XSBgPTBw ($120 in chips)
Seat 4: lu4P1Unn4wHCS7lPOOr9gA ($483.75 in chips)
Seat 5: q/hE9bQrjr91gfn84QYixQ ($963 in chips)
Seat 6: 3mTlg4g0FJN2bo939h/0Wg ($66 in chips)
3mTlg4g0FJN2bo939h/0Wg: posts small blind $5
bjInvXcoSxLjVXWB9UWLBQ: posts big blind $10
*** HOLE CARDS ***
1ScqYmNf7/uWx1XSBgPTBw: folds
lu4P1Unn4wHCS7lPOOr9gA: raises $30 to $40
q/hE9bQrjr91gfn84QYixQ: folds
3mTlg4g0FJN2bo939h/0Wg: folds
bjInvXcoSxLjVXWB9UWLBQ: folds
lu4P1Unn4wHCS7lPOOr9gA collected $25 from pot
*** SUMMARY ***
Total pot $25 | Rake $0
Seat 1: bjInvXcoSxLjVXWB9UWLBQ (big blind) folded before Flop
Seat 2: 1ScqYmNf7/uWx1XSBgPTBw folded before Flop (didn't bet)
Seat 4: lu4P1Unn4wHCS7lPOOr9gA collected ($25)
Seat 5: q/hE9bQrjr91gfn84QYixQ (button) folded before Flop (didn't bet)
Seat 6: 3mTlg4g0FJN2bo939h/0Wg (small blind) folded before Flop



PokerStars Game #59964470958:  Hold'em No Limit ($5/$10) - 2009/07/01 12:11:51 ET
Table 'dzUWBUz1AtehXXhTI9CCwA' 2-max Seat #1 is the button
Seat 1: KK2L3ELlZFnDURuAy5bqzQ ($974.50 in chips)
Seat 2: o680fZMaQtqAfYOL5g4iSA ($241.10 in chips)
KK2L3ELlZFnDURuAy5bqzQ: posts small blind $5
o680fZMaQtqAfYOL5g4iSA: posts big blind $10
*** HOLE CARDS ***
KK2L3ELlZFnDURuAy5bqzQ: folds
o680fZMaQtqAfYOL5g4iSA collected $10 from pot
o680fZMaQtqAfYOL5g4iSA: doesn't show hand
*** SUMMARY ***
Total pot $10 | Rake $0
Seat 1: KK2L3ELlZFnDURuAy5bqzQ (button) (small blind) folded before Flop
Seat 2: o680fZMaQtqAfYOL5g4iSA (big blind) collected ($10)



PokerStars Game #59964472130:  Hold'em No Limit ($5/$10) - 2009/07/01 12:11:52 ET
Table '1Dt9cpcLUVE6HYkx5dUEdQ' 6-max Seat #2 is the button
Seat 1: Xl+I49lxCJwPGRuegiaHoA ($1015 in chips)
Seat 2: nCI/286bRXONuVN/6Bn49Q ($195 in chips)
Seat 4: voSAIKXtXUUbJnds83sYfQ ($1975.75 in chips)
Seat 5: 1ScqYmNf7/uWx1XSBgPTBw ($200 in chips)
Seat 6: efhcaDPhNqQ/H48kMHLa8w ($1817 in chips)
UcFkfWngu95uR8Jhrj+HrQ will be allowed to play after the button
voSAIKXtXUUbJnds83sYfQ: posts small blind $5
1ScqYmNf7/uWx1XSBgPTBw: posts big blind $10
*** HOLE CARDS ***
efhcaDPhNqQ/H48kMHLa8w: folds
Xl+I49lxCJwPGRuegiaHoA: folds
nCI/286bRXONuVN/6Bn49Q: folds
voSAIKXtXUUbJnds83sYfQ: folds
1ScqYmNf7/uWx1XSBgPTBw collected $10 from pot
*** SUMMARY ***
Total pot $10 | Rake $0
Seat 1: Xl+I49lxCJwPGRuegiaHoA folded before Flop (didn't bet)
Seat 2: nCI/286bRXONuVN/6Bn49Q (button) folded before Flop (didn't bet)
Seat 4: voSAIKXtXUUbJnds83sYfQ (small blind) folded before Flop
Seat 5: 1ScqYmNf7/uWx1XSBgPTBw (big blind) collected ($10)
Seat 6: efhcaDPhNqQ/H48kMHLa8w folded before Flop (didn't bet)



PokerStars Game #59964473058:  Hold'em No Limit ($5/$10) - 2009/07/01 12:11:53 ET
Table 'dwLGEw3aoH/cOAI7JsLdmw' 6-max Seat #4 is the button
Seat 1: ZaYCGtNHUeItoUEheoYDMw ($208 in chips)
Seat 3: /F5e5TKT/1B9kgJVuQttsg ($300 in chips)
Seat 4: efhcaDPhNqQ/H48kMHLa8w ($1083 in chips)
Seat 6: 3mTlg4g0FJN2bo939h/0Wg ($191.55 in chips)
7SUIdtQak1SCtldWHjwnFA will be allowed to play after the button
3mTlg4g0FJN2bo939h/0Wg: posts small blind $5
ZaYCGtNHUeItoUEheoYDMw: posts big blind $10
kem0o3a/3AcDZBJg3cdvpQ: sits out
*** HOLE CARDS ***
/F5e5TKT/1B9kgJVuQttsg: raises $10 to $20
efhcaDPhNqQ/H48kMHLa8w: folds
3mTlg4g0FJN2bo939h/0Wg: calls $15
ZaYCGtNHUeItoUEheoYDMw: folds
*** FLOP *** [9c Jd 7c]
3mTlg4g0FJN2bo939h/0Wg: bets $30
/F5e5TKT/1B9kgJVuQttsg: folds
3mTlg4g0FJN2bo939h/0Wg collected $48 from pot
*** SUMMARY ***
Total pot $50 | Rake $2
Board [9c Jd 7c]
Seat 1: ZaYCGtNHUeItoUEheoYDMw (big blind) folded before Flop
Seat 3: /F5e5TKT/1B9kgJVuQttsg folded on the Flop
Seat 4: efhcaDPhNqQ/H48kMHLa8w (button) folded before Flop (didn't bet)
Seat 6: 3mTlg4g0FJN2bo939h/0Wg (small blind) collected ($48)



PokerStars Game #59964478628:  Hold'em No Limit ($5/$10) - 2009/07/01 12:11:59 ET
Table 'dzUWBUz1AtehXXhTI9CCwA' 2-max Seat #2 is the button
Seat 1: KK2L3ELlZFnDURuAy5bqzQ ($969.50 in chips)
Seat 2: o680fZMaQtqAfYOL5g4iSA ($246.10 in chips)
o680fZMaQtqAfYOL5g4iSA: posts small blind $5
KK2L3ELlZFnDURuAy5bqzQ: posts big blind $10
*** HOLE CARDS ***
o680fZMaQtqAfYOL5g4iSA: folds
KK2L3ELlZFnDURuAy5bqzQ collected $10 from pot
KK2L3ELlZFnDURuAy5bqzQ: doesn't show hand
*** SUMMARY ***
Total pot $10 | Rake $0
Seat 1: KK2L3ELlZFnDURuAy5bqzQ (big blind) collected ($10)
Seat 2: o680fZMaQtqAfYOL5g4iSA (button) (small blind) folded before Flop



PokerStars Game #59964477904:  Hold'em No Limit ($5/$10) - 2009/07/01 12:11:59 ET
Table 'AI1fZ7Tsbf9DI8mC4EWoQQ' 9-max Seat #5 is the button
Seat 2: voSAIKXtXUUbJnds83sYfQ ($1129 in chips)
Seat 3: QjU8cx/IlcsbRKufwbiKow ($985 in chips)
Seat 4: efhcaDPhNqQ/H48kMHLa8w ($1107 in chips)
Seat 5: 2PHCSXghjbGk2qR6jDFe2g ($937 in chips)
Seat 6: l9mDFuns/ycIDiFx40BMVw ($815 in chips)
Seat 7: ettgJAblGnistIlqNz4Jww ($1030 in chips)
Seat 8: UgBUE0pOJDwUdQ53XJt8MQ ($105 in chips)
Seat 9: 1s1h7qXmZxmowl9P1VNe2Q ($189.75 in chips)
l9mDFuns/ycIDiFx40BMVw: posts small blind $5
ettgJAblGnistIlqNz4Jww: posts big blind $10
*** HOLE CARDS ***
UgBUE0pOJDwUdQ53XJt8MQ: folds
1s1h7qXmZxmowl9P1VNe2Q: folds
voSAIKXtXUUbJnds83sYfQ: folds
QjU8cx/IlcsbRKufwbiKow: folds
efhcaDPhNqQ/H48kMHLa8w: folds
2PHCSXghjbGk2qR6jDFe2g: folds
l9mDFuns/ycIDiFx40BMVw: folds
ettgJAblGnistIlqNz4Jww collected $10 from pot
*** SUMMARY ***
Total pot $10 | Rake $0
Seat 2: voSAIKXtXUUbJnds83sYfQ folded before Flop (didn't bet)
Seat 3: QjU8cx/IlcsbRKufwbiKow folded before Flop (didn't bet)
Seat 4: efhcaDPhNqQ/H48kMHLa8w folded before Flop (didn't bet)
Seat 5: 2PHCSXghjbGk2qR6jDFe2g (button) folded before Flop (didn't bet)
Seat 6: l9mDFuns/ycIDiFx40BMVw (small blind) folded before Flop
Seat 7: ettgJAblGnistIlqNz4Jww (big blind) collected ($10)
Seat 8: UgBUE0pOJDwUdQ53XJt8MQ folded before Flop (didn't bet)
Seat 9: 1s1h7qXmZxmowl9P1VNe2Q folded before Flop (didn't bet)



PokerStars Game #59964484558:  Hold'em No Limit ($5/$10) - 2009/07/01 12:12:06 ET
Table 'dzUWBUz1AtehXXhTI9CCwA' 2-max Seat #1 is the button
Seat 1: KK2L3ELlZFnDURuAy5bqzQ ($974.50 in chips)
Seat 2: o680fZMaQtqAfYOL5g4iSA ($241.10 in chips)
KK2L3ELlZFnDURuAy5bqzQ: posts small blind $5
o680fZMaQtqAfYOL5g4iSA: posts big blind $10
*** HOLE CARDS ***
KK2L3ELlZFnDURuAy5bqzQ: raises $20 to $30
o680fZMaQtqAfYOL5g4iSA: folds
KK2L3ELlZFnDURuAy5bqzQ collected $20 from pot
KK2L3ELlZFnDURuAy5bqzQ: doesn't show hand
*** SUMMARY ***
Total pot $20 | Rake $0
Seat 1: KK2L3ELlZFnDURuAy5bqzQ (button) (small blind) collected ($20)
Seat 2: o680fZMaQtqAfYOL5g4iSA (big blind) folded before Flop



PokerStars Game #59964489944:  Hold'em No Limit ($5/$10) - 2009/07/01 12:12:12 ET
Table 'r10wRkUZaNZLcIr0K/VDlg' 6-max Seat #6 is the button
Seat 1: bjInvXcoSxLjVXWB9UWLBQ ($269 in chips)
Seat 2: 1ScqYmNf7/uWx1XSBgPTBw ($120 in chips)
Seat 4: lu4P1Unn4wHCS7lPOOr9gA ($498.75 in chips)
Seat 5: q/hE9bQrjr91gfn84QYixQ ($963 in chips)
Seat 6: 3mTlg4g0FJN2bo939h/0Wg ($61 in chips)
bjInvXcoSxLjVXWB9UWLBQ: posts small blind $5
1ScqYmNf7/uWx1XSBgPTBw: posts big blind $10
*** HOLE CARDS ***
lu4P1Unn4wHCS7lPOOr9gA: raises $20 to $30
q/hE9bQrjr91gfn84QYixQ: folds
UcFkfWngu95uR8Jhrj+HrQ joins the table at seat #3
3mTlg4g0FJN2bo939h/0Wg: folds
bjInvXcoSxLjVXWB9UWLBQ: folds
1ScqYmNf7/uWx1XSBgPTBw: folds
lu4P1Unn4wHCS7lPOOr9gA collected $25 from pot
*** SUMMARY ***
Total pot $25 | Rake $0
Seat 1: bjInvXcoSxLjVXWB9UWLBQ (small blind) folded before Flop
Seat 2: 1ScqYmNf7/uWx1XSBgPTBw (big blind) folded before Flop
Seat 4: lu4P1Unn4wHCS7lPOOr9gA collected ($25)
Seat 5: q/hE9bQrjr91gfn84QYixQ folded before Flop (didn't bet)
Seat 6: 3mTlg4g0FJN2bo939h/0Wg (button) folded before Flop (didn't bet)



PokerStars Game #59964492686:  Hold'em No Limit ($5/$10) - 2009/07/01 12:12:15 ET
Table 'dzUWBUz1AtehXXhTI9CCwA' 2-max Seat #2 is the button
Seat 1: KK2L3ELlZFnDURuAy5bqzQ ($984.50 in chips)
Seat 2: o680fZMaQtqAfYOL5g4iSA ($231.10 in chips)
o680fZMaQtqAfYOL5g4iSA: posts small blind $5
KK2L3ELlZFnDURuAy5bqzQ: posts big blind $10
*** HOLE CARDS ***
o680fZMaQtqAfYOL5g4iSA: raises $10 to $20
KK2L3ELlZFnDURuAy5bqzQ: calls $10
*** FLOP *** [2s 7c Td]
KK2L3ELlZFnDURuAy5bqzQ: checks
o680fZMaQtqAfYOL5g4iSA: bets $20
KK2L3ELlZFnDURuAy5bqzQ: folds
o680fZMaQtqAfYOL5g4iSA collected $39.50 from pot
o680fZMaQtqAfYOL5g4iSA: doesn't show hand
*** SUMMARY ***
Total pot $40 | Rake $0.50
Board [2s 7c Td]
Seat 1: KK2L3ELlZFnDURuAy5bqzQ (big blind) folded on the Flop
Seat 2: o680fZMaQtqAfYOL5g4iSA (button) (small blind) collected ($39.50)



PokerStars Game #59964499088:  Hold'em No Limit ($5/$10) - 2009/07/01 12:12:22 ET
Table '1Dt9cpcLUVE6HYkx5dUEdQ' 6-max Seat #4 is the button
Seat 1: Xl+I49lxCJwPGRuegiaHoA ($1015 in chips)
Seat 2: nCI/286bRXONuVN/6Bn49Q ($195 in chips)
Seat 4: voSAIKXtXUUbJnds83sYfQ ($1970.75 in chips)
Seat 5: 1ScqYmNf7/uWx1XSBgPTBw ($205 in chips)
Seat 6: efhcaDPhNqQ/H48kMHLa8w ($1817 in chips)
1ScqYmNf7/uWx1XSBgPTBw: posts small blind $5
efhcaDPhNqQ/H48kMHLa8w: posts big blind $10
UcFkfWngu95uR8Jhrj+HrQ: sits out
*** HOLE CARDS ***
Xl+I49lxCJwPGRuegiaHoA: folds
nCI/286bRXONuVN/6Bn49Q: folds
voSAIKXtXUUbJnds83sYfQ: folds
1ScqYmNf7/uWx1XSBgPTBw: folds
efhcaDPhNqQ/H48kMHLa8w collected $10 from pot
efhcaDPhNqQ/H48kMHLa8w: doesn't show hand
*** SUMMARY ***
Total pot $10 | Rake $0
Seat 1: Xl+I49lxCJwPGRuegiaHoA folded before Flop (didn't bet)
Seat 2: nCI/286bRXONuVN/6Bn49Q folded before Flop (didn't bet)
Seat 4: voSAIKXtXUUbJnds83sYfQ (button) folded before Flop (didn't bet)
Seat 5: 1ScqYmNf7/uWx1XSBgPTBw (small blind) folded before Flop
Seat 6: efhcaDPhNqQ/H48kMHLa8w (big blind) collected ($10)



PokerStars Game #59964503560:  Hold'em No Limit ($5/$10) - 2009/07/01 12:12:27 ET
Table 'AiNa6yyp/njJVRYl/Lz1KQ' 6-max Seat #5 is the button
Seat 2: 7SUIdtQak1SCtldWHjwnFA ($241 in chips)
Seat 3: 3mTlg4g0FJN2bo939h/0Wg ($359.80 in chips)
Seat 4: 1ScqYmNf7/uWx1XSBgPTBw ($185 in chips)
Seat 5: 2PHCSXghjbGk2qR6jDFe2g ($241 in chips)
UcFkfWngu95uR8Jhrj+HrQ will be allowed to play after the button
7SUIdtQak1SCtldWHjwnFA: posts small blind $5
3mTlg4g0FJN2bo939h/0Wg: posts big blind $10
*** HOLE CARDS ***
1ScqYmNf7/uWx1XSBgPTBw: folds
2PHCSXghjbGk2qR6jDFe2g: raises $10 to $20
7SUIdtQak1SCtldWHjwnFA: raises $35 to $55
2jM9VDDsetFb9DSQdp7NFQ joins the table at seat #1
3mTlg4g0FJN2bo939h/0Wg: folds
2PHCSXghjbGk2qR6jDFe2g: folds
7SUIdtQak1SCtldWHjwnFA collected $50 from pot
7SUIdtQak1SCtldWHjwnFA: doesn't show hand
*** SUMMARY ***
Total pot $50 | Rake $0
Seat 2: 7SUIdtQak1SCtldWHjwnFA (small blind) collected ($50)
Seat 3: 3mTlg4g0FJN2bo939h/0Wg (big blind) folded before Flop
Seat 4: 1ScqYmNf7/uWx1XSBgPTBw folded before Flop (didn't bet)
Seat 5: 2PHCSXghjbGk2qR6jDFe2g (button) folded before Flop



PokerStars Game #59964506314:  Hold'em No Limit ($5/$10) - 2009/07/01 12:12:30 ET
Table 'AI1fZ7Tsbf9DI8mC4EWoQQ' 9-max Seat #6 is the button
Seat 2: voSAIKXtXUUbJnds83sYfQ ($1129 in chips)
Seat 3: QjU8cx/IlcsbRKufwbiKow ($985 in chips)
Seat 4: efhcaDPhNqQ/H48kMHLa8w ($1107 in chips)
Seat 5: 2PHCSXghjbGk2qR6jDFe2g ($937 in chips)
Seat 6: l9mDFuns/ycIDiFx40BMVw ($810 in chips)
Seat 7: ettgJAblGnistIlqNz4Jww ($1035 in chips)
Seat 8: UgBUE0pOJDwUdQ53XJt8MQ ($105 in chips)
Seat 9: 1s1h7qXmZxmowl9P1VNe2Q ($189.75 in chips)
ettgJAblGnistIlqNz4Jww: posts small blind $5
UgBUE0pOJDwUdQ53XJt8MQ: posts big blind $10
*** HOLE CARDS ***
1s1h7qXmZxmowl9P1VNe2Q: folds
voSAIKXtXUUbJnds83sYfQ: raises $20 to $30
QjU8cx/IlcsbRKufwbiKow: folds
efhcaDPhNqQ/H48kMHLa8w: folds
2PHCSXghjbGk2qR6jDFe2g: folds
l9mDFuns/ycIDiFx40BMVw: folds
ettgJAblGnistIlqNz4Jww: calls $25
UgBUE0pOJDwUdQ53XJt8MQ: folds
*** FLOP *** [5c 2d 2s]
ettgJAblGnistIlqNz4Jww: checks
voSAIKXtXUUbJnds83sYfQ: checks
*** TURN *** [5c 2d 2s] [Js]
ettgJAblGnistIlqNz4Jww: bets $40
voSAIKXtXUUbJnds83sYfQ: folds
ettgJAblGnistIlqNz4Jww collected $67 from pot
*** SUMMARY ***
Total pot $70 | Rake $3
Board [5c 2d 2s Js]
Seat 2: voSAIKXtXUUbJnds83sYfQ folded on the Turn
Seat 3: QjU8cx/IlcsbRKufwbiKow folded before Flop (didn't bet)
Seat 4: efhcaDPhNqQ/H48kMHLa8w folded before Flop (didn't bet)
Seat 5: 2PHCSXghjbGk2qR6jDFe2g folded before Flop (didn't bet)
Seat 6: l9mDFuns/ycIDiFx40BMVw (button) folded before Flop (didn't bet)
Seat 7: ettgJAblGnistIlqNz4Jww (small blind) collected ($67)
Seat 8: UgBUE0pOJDwUdQ53XJt8MQ (big blind) folded before Flop
Seat 9: 1s1h7qXmZxmowl9P1VNe2Q folded before Flop (didn't bet)



PokerStars Game #59964507178:  Hold'em No Limit ($5/$10) - 2009/07/01 12:12:31 ET
Table 'r10wRkUZaNZLcIr0K/VDlg' 6-max Seat #1 is the button
Seat 1: bjInvXcoSxLjVXWB9UWLBQ ($264 in chips)
Seat 2: 1ScqYmNf7/uWx1XSBgPTBw ($110 in chips)
Seat 3: UcFkfWngu95uR8Jhrj+HrQ ($200 in chips)
Seat 4: lu4P1Unn4wHCS7lPOOr9gA ($513.75 in chips)
Seat 5: q/hE9bQrjr91gfn84QYixQ ($963 in chips)
Seat 6: 3mTlg4g0FJN2bo939h/0Wg ($61 in chips)
1ScqYmNf7/uWx1XSBgPTBw: posts small blind $5
UcFkfWngu95uR8Jhrj+HrQ: posts big blind $10
*** HOLE CARDS ***
lu4P1Unn4wHCS7lPOOr9gA: folds
q/hE9bQrjr91gfn84QYixQ: calls $10
3mTlg4g0FJN2bo939h/0Wg: folds
bjInvXcoSxLjVXWB9UWLBQ: folds
1ScqYmNf7/uWx1XSBgPTBw: raises $100 to $110 and is all-in
UcFkfWngu95uR8Jhrj+HrQ: folds
q/hE9bQrjr91gfn84QYixQ: calls $100
*** FLOP *** [9h 8d 6d]
*** TURN *** [9h 8d 6d] [Ts]
*** RIVER *** [9h 8d 6d Ts] [6h]
*** SHOW DOWN ***
1ScqYmNf7/uWx1XSBgPTBw: shows [Ac 5s] (a pair of Sixes)
q/hE9bQrjr91gfn84QYixQ: shows [Td 9d] (two pair, Tens and Nines)
q/hE9bQrjr91gfn84QYixQ collected $227 from pot
*** SUMMARY ***
Total pot $230 | Rake $3
Board [9h 8d 6d Ts 6h]
Seat 1: bjInvXcoSxLjVXWB9UWLBQ (button) folded before Flop (didn't bet)
Seat 2: 1ScqYmNf7/uWx1XSBgPTBw (small blind) showed [Ac 5s] and lost with a pair of Sixes
Seat 3: UcFkfWngu95uR8Jhrj+HrQ (big blind) folded before Flop
Seat 4: lu4P1Unn4wHCS7lPOOr9gA folded before Flop (didn't bet)
Seat 5: q/hE9bQrjr91gfn84QYixQ showed [Td 9d] and won ($227) with two pair, Tens and Nines
Seat 6: 3mTlg4g0FJN2bo939h/0Wg folded before Flop (didn't bet)



PokerStars Game #59964514438:  Hold'em No Limit ($5/$10) - 2009/07/01 12:12:39 ET
Table 'dwLGEw3aoH/cOAI7JsLdmw' 6-max Seat #6 is the button
Seat 1: ZaYCGtNHUeItoUEheoYDMw ($198 in chips)
Seat 2: kem0o3a/3AcDZBJg3cdvpQ ($200 in chips)
Seat 3: /F5e5TKT/1B9kgJVuQttsg ($300 in chips)
Seat 4: efhcaDPhNqQ/H48kMHLa8w ($1083 in chips)
Seat 6: 3mTlg4g0FJN2bo939h/0Wg ($219.55 in chips)
ZaYCGtNHUeItoUEheoYDMw: posts small blind $5
kem0o3a/3AcDZBJg3cdvpQ: posts big blind $10
7SUIdtQak1SCtldWHjwnFA: sits out
*** HOLE CARDS ***
/F5e5TKT/1B9kgJVuQttsg: folds
/F5e5TKT/1B9kgJVuQttsg leaves the table
efhcaDPhNqQ/H48kMHLa8w: raises $20 to $30
3mTlg4g0FJN2bo939h/0Wg: folds
ZaYCGtNHUeItoUEheoYDMw: folds
1s1h7qXmZxmowl9P1VNe2Q joins the table at seat #3
kem0o3a/3AcDZBJg3cdvpQ: raises $170 to $200 and is all-in
efhcaDPhNqQ/H48kMHLa8w: calls $170
*** FLOP *** [8d Jc 6c]
*** TURN *** [8d Jc 6c] [Ad]
*** RIVER *** [8d Jc 6c Ad] [7d]
*** SHOW DOWN ***
kem0o3a/3AcDZBJg3cdvpQ: shows [Kc Kh] (a pair of Kings)
efhcaDPhNqQ/H48kMHLa8w: shows [Qc Ac] (a pair of Aces)
efhcaDPhNqQ/H48kMHLa8w collected $403 from pot
*** SUMMARY ***
Total pot $405 | Rake $2
Board [8d Jc 6c Ad 7d]
Seat 1: ZaYCGtNHUeItoUEheoYDMw (small blind) folded before Flop
Seat 2: kem0o3a/3AcDZBJg3cdvpQ (big blind) showed [Kc Kh] and lost with a pair of Kings
Seat 3: /F5e5TKT/1B9kgJVuQttsg folded before Flop (didn't bet)
Seat 4: efhcaDPhNqQ/H48kMHLa8w showed [Qc Ac] and won ($403) with a pair of Aces
Seat 6: 3mTlg4g0FJN2bo939h/0Wg (button) folded before Flop (didn't bet)



PokerStars Game #59964516082:  Hold'em No Limit ($5/$10) - 2009/07/01 12:12:41 ET
Table 'dzUWBUz1AtehXXhTI9CCwA' 2-max Seat #1 is the button
Seat 1: KK2L3ELlZFnDURuAy5bqzQ ($964.50 in chips)
Seat 2: o680fZMaQtqAfYOL5g4iSA ($250.60 in chips)
KK2L3ELlZFnDURuAy5bqzQ: posts small blind $5
o680fZMaQtqAfYOL5g4iSA: posts big blind $10
*** HOLE CARDS ***
KK2L3ELlZFnDURuAy5bqzQ: raises $20 to $30
o680fZMaQtqAfYOL5g4iSA: folds
KK2L3ELlZFnDURuAy5bqzQ collected $20 from pot
KK2L3ELlZFnDURuAy5bqzQ: doesn't show hand
*** SUMMARY ***
Total pot $20 | Rake $0
Seat 1: KK2L3ELlZFnDURuAy5bqzQ (button) (small blind) collected ($20)
Seat 2: o680fZMaQtqAfYOL5g4iSA (big blind) folded before Flop



PokerStars Game #59964522836:  Hold'em No Limit ($5/$10) - 2009/07/01 12:12:48 ET
Table 'dzUWBUz1AtehXXhTI9CCwA' 2-max Seat #2 is the button
Seat 1: KK2L3ELlZFnDURuAy5bqzQ ($974.50 in chips)
Seat 2: o680fZMaQtqAfYOL5g4iSA ($240.60 in chips)
o680fZMaQtqAfYOL5g4iSA: posts small blind $5
KK2L3ELlZFnDURuAy5bqzQ: posts big blind $10
*** HOLE CARDS ***
o680fZMaQtqAfYOL5g4iSA: calls $5
KK2L3ELlZFnDURuAy5bqzQ: checks
*** FLOP *** [2h 2d 8c]
KK2L3ELlZFnDURuAy5bqzQ: checks
o680fZMaQtqAfYOL5g4iSA: bets $20
KK2L3ELlZFnDURuAy5bqzQ: folds
o680fZMaQtqAfYOL5g4iSA collected $19.50 from pot
o680fZMaQtqAfYOL5g4iSA: doesn't show hand
*** SUMMARY ***
Total pot $20 | Rake $0.50
Board [2h 2d 8c]
Seat 1: KK2L3ELlZFnDURuAy5bqzQ (big blind) folded on the Flop
Seat 2: o680fZMaQtqAfYOL5g4iSA (button) (small blind) collected ($19.50)



PokerStars Game #59964523914:  Hold'em No Limit ($5/$10) - 2009/07/01 12:12:49 ET
Table '1Dt9cpcLUVE6HYkx5dUEdQ' 6-max Seat #5 is the button
Seat 1: Xl+I49lxCJwPGRuegiaHoA ($1015 in chips)
Seat 2: nCI/286bRXONuVN/6Bn49Q ($195 in chips)
Seat 4: voSAIKXtXUUbJnds83sYfQ ($1970.75 in chips)
Seat 5: 1ScqYmNf7/uWx1XSBgPTBw ($200 in chips)
Seat 6: efhcaDPhNqQ/H48kMHLa8w ($1822 in chips)
efhcaDPhNqQ/H48kMHLa8w: posts small blind $5
Xl+I49lxCJwPGRuegiaHoA: posts big blind $10
UcFkfWngu95uR8Jhrj+HrQ: sits out
*** HOLE CARDS ***
nCI/286bRXONuVN/6Bn49Q: folds
voSAIKXtXUUbJnds83sYfQ: folds
1ScqYmNf7/uWx1XSBgPTBw: folds
efhcaDPhNqQ/H48kMHLa8w: folds
Xl+I49lxCJwPGRuegiaHoA collected $10 from pot
*** SUMMARY ***
Total pot $10 | Rake $0
Seat 1: Xl+I49lxCJwPGRuegiaHoA (big blind) collected ($10)
Seat 2: nCI/286bRXONuVN/6Bn49Q folded before Flop (didn't bet)
Seat 4: voSAIKXtXUUbJnds83sYfQ folded before Flop (didn't bet)
Seat 5: 1ScqYmNf7/uWx1XSBgPTBw (button) folded before Flop (didn't bet)
Seat 6: efhcaDPhNqQ/H48kMHLa8w (small blind) folded before Flop



PokerStars Game #59964528522:  Hold'em No Limit ($5/$10) - 2009/07/01 12:12:54 ET
Table 'AiNa6yyp/njJVRYl/Lz1KQ' 6-max Seat #2 is the button
Seat 2: 7SUIdtQak1SCtldWHjwnFA ($271 in chips)
Seat 3: 3mTlg4g0FJN2bo939h/0Wg ($349.80 in chips)
Seat 4: 1ScqYmNf7/uWx1XSBgPTBw ($185 in chips)
Seat 5: 2PHCSXghjbGk2qR6jDFe2g ($221 in chips)
3mTlg4g0FJN2bo939h/0Wg: posts small blind $5
1ScqYmNf7/uWx1XSBgPTBw: posts big blind $10
UcFkfWngu95uR8Jhrj+HrQ: sits out
2jM9VDDsetFb9DSQdp7NFQ: sits out
*** HOLE CARDS ***
2PHCSXghjbGk2qR6jDFe2g: folds
7SUIdtQak1SCtldWHjwnFA: folds
3mTlg4g0FJN2bo939h/0Wg: calls $5
1ScqYmNf7/uWx1XSBgPTBw: checks
*** FLOP *** [3c Qs Qh]
3mTlg4g0FJN2bo939h/0Wg: checks
1ScqYmNf7/uWx1XSBgPTBw: checks
*** TURN *** [3c Qs Qh] [Ac]
3mTlg4g0FJN2bo939h/0Wg: checks
1ScqYmNf7/uWx1XSBgPTBw: checks
*** RIVER *** [3c Qs Qh Ac] [2d]
3mTlg4g0FJN2bo939h/0Wg: checks
1ScqYmNf7/uWx1XSBgPTBw: checks
*** SHOW DOWN ***
3mTlg4g0FJN2bo939h/0Wg: shows [4c Kd] (a pair of Queens)
1ScqYmNf7/uWx1XSBgPTBw: mucks hand
3mTlg4g0FJN2bo939h/0Wg collected $19 from pot
*** SUMMARY ***
Total pot $20 | Rake $1
Board [3c Qs Qh Ac 2d]
Seat 2: 7SUIdtQak1SCtldWHjwnFA (button) folded before Flop (didn't bet)
Seat 3: 3mTlg4g0FJN2bo939h/0Wg (small blind) showed [4c Kd] and won ($19) with a pair of Queens
Seat 4: 1ScqYmNf7/uWx1XSBgPTBw (big blind) mucked
Seat 5: 2PHCSXghjbGk2qR6jDFe2g folded before Flop (didn't bet)



PokerStars Game #59964544092:  Hold'em No Limit ($5/$10) - 2009/07/01 12:13:11 ET
Table 'dzUWBUz1AtehXXhTI9CCwA' 2-max Seat #1 is the button
Seat 1: KK2L3ELlZFnDURuAy5bqzQ ($964.50 in chips)
Seat 2: o680fZMaQtqAfYOL5g4iSA ($250.10 in chips)
KK2L3ELlZFnDURuAy5bqzQ: posts small blind $5
o680fZMaQtqAfYOL5g4iSA: posts big blind $10
*** HOLE CARDS ***
KK2L3ELlZFnDURuAy5bqzQ: raises $20 to $30
o680fZMaQtqAfYOL5g4iSA: calls $20
*** FLOP *** [7s 3h Qc]
o680fZMaQtqAfYOL5g4iSA: checks
KK2L3ELlZFnDURuAy5bqzQ: bets $40
o680fZMaQtqAfYOL5g4iSA: folds
KK2L3ELlZFnDURuAy5bqzQ collected $59.50 from pot
KK2L3ELlZFnDURuAy5bqzQ: doesn't show hand
*** SUMMARY ***
Total pot $60 | Rake $0.50
Board [7s 3h Qc]
Seat 1: KK2L3ELlZFnDURuAy5bqzQ (button) (small blind) collected ($59.50)
Seat 2: o680fZMaQtqAfYOL5g4iSA (big blind) folded on the Flop



PokerStars Game #59964551900:  Hold'em No Limit ($5/$10) - 2009/07/01 12:13:19 ET
Table 'r10wRkUZaNZLcIr0K/VDlg' 6-max Seat #2 is the button
Seat 1: bjInvXcoSxLjVXWB9UWLBQ ($264 in chips)
Seat 2: 1ScqYmNf7/uWx1XSBgPTBw ($200 in chips)
Seat 3: UcFkfWngu95uR8Jhrj+HrQ ($190 in chips)
Seat 4: lu4P1Unn4wHCS7lPOOr9gA ($513.75 in chips)
Seat 5: q/hE9bQrjr91gfn84QYixQ ($1080 in chips)
Seat 6: 3mTlg4g0FJN2bo939h/0Wg ($61 in chips)
UcFkfWngu95uR8Jhrj+HrQ: posts small blind $5
lu4P1Unn4wHCS7lPOOr9gA: posts big blind $10
*** HOLE CARDS ***
q/hE9bQrjr91gfn84QYixQ: folds
q/hE9bQrjr91gfn84QYixQ leaves the table
Xl+I49lxCJwPGRuegiaHoA joins the table at seat #5
3mTlg4g0FJN2bo939h/0Wg: folds
bjInvXcoSxLjVXWB9UWLBQ: folds
1ScqYmNf7/uWx1XSBgPTBw: folds
UcFkfWngu95uR8Jhrj+HrQ: raises $10 to $20
lu4P1Unn4wHCS7lPOOr9gA: calls $10
*** FLOP *** [6h Jc Qd]
UcFkfWngu95uR8Jhrj+HrQ: bets $20
lu4P1Unn4wHCS7lPOOr9gA: calls $20
*** TURN *** [6h Jc Qd] [Js]
UcFkfWngu95uR8Jhrj+HrQ: bets $50
lu4P1Unn4wHCS7lPOOr9gA: folds
UcFkfWngu95uR8Jhrj+HrQ collected $77 from pot
UcFkfWngu95uR8Jhrj+HrQ: doesn't show hand
*** SUMMARY ***
Total pot $80 | Rake $3
Board [6h Jc Qd Js]
Seat 1: bjInvXcoSxLjVXWB9UWLBQ folded before Flop (didn't bet)
Seat 2: 1ScqYmNf7/uWx1XSBgPTBw (button) folded before Flop (didn't bet)
Seat 3: UcFkfWngu95uR8Jhrj+HrQ (small blind) collected ($77)
Seat 4: lu4P1Unn4wHCS7lPOOr9gA (big blind) folded on the Turn
Seat 5: q/hE9bQrjr91gfn84QYixQ folded before Flop (didn't bet)
Seat 6: 3mTlg4g0FJN2bo939h/0Wg folded before Flop (didn't bet)



PokerStars Game #59964558968:  Hold'em No Limit ($5/$10) - 2009/07/01 12:13:27 ET
Table '1Dt9cpcLUVE6HYkx5dUEdQ' 6-max Seat #6 is the button
Seat 1: Xl+I49lxCJwPGRuegiaHoA ($1020 in chips)
Seat 2: nCI/286bRXONuVN/6Bn49Q ($195 in chips)
Seat 4: voSAIKXtXUUbJnds83sYfQ ($1970.75 in chips)
Seat 5: 1ScqYmNf7/uWx1XSBgPTBw ($200 in chips)
Seat 6: efhcaDPhNqQ/H48kMHLa8w ($1817 in chips)
Xl+I49lxCJwPGRuegiaHoA: posts small blind $5
nCI/286bRXONuVN/6Bn49Q: posts big blind $10
UcFkfWngu95uR8Jhrj+HrQ: sits out
*** HOLE CARDS ***
voSAIKXtXUUbJnds83sYfQ: raises $20 to $30
1ScqYmNf7/uWx1XSBgPTBw: raises $170 to $200 and is all-in
efhcaDPhNqQ/H48kMHLa8w: folds
Xl+I49lxCJwPGRuegiaHoA: folds
nCI/286bRXONuVN/6Bn49Q: folds
voSAIKXtXUUbJnds83sYfQ: calls $170
*** FLOP *** [3c Ks Jd]
*** TURN *** [3c Ks Jd] [Tc]
*** RIVER *** [3c Ks Jd Tc] [Jh]
*** SHOW DOWN ***
voSAIKXtXUUbJnds83sYfQ: shows [Ad Kh] (two pair, Kings and Jacks)
1ScqYmNf7/uWx1XSBgPTBw: mucks hand
voSAIKXtXUUbJnds83sYfQ collected $413 from pot
*** SUMMARY ***
Total pot $415 | Rake $2
Board [3c Ks Jd Tc Jh]
Seat 1: Xl+I49lxCJwPGRuegiaHoA (small blind) folded before Flop
Seat 2: nCI/286bRXONuVN/6Bn49Q (big blind) folded before Flop
Seat 4: voSAIKXtXUUbJnds83sYfQ showed [Ad Kh] and won ($413) with two pair, Kings and Jacks
Seat 5: 1ScqYmNf7/uWx1XSBgPTBw mucked
Seat 6: efhcaDPhNqQ/H48kMHLa8w (button) folded before Flop (didn't bet)



PokerStars Game #59964560070:  Hold'em No Limit ($5/$10) - 2009/07/01 12:13:28 ET
Table 'dwLGEw3aoH/cOAI7JsLdmw' 6-max Seat #1 is the button
Seat 1: ZaYCGtNHUeItoUEheoYDMw ($193 in chips)
Seat 2: kem0o3a/3AcDZBJg3cdvpQ ($200 in chips)
Seat 3: 1s1h7qXmZxmowl9P1VNe2Q ($200 in chips)
Seat 4: efhcaDPhNqQ/H48kMHLa8w ($1286 in chips)
Seat 6: 3mTlg4g0FJN2bo939h/0Wg ($219.55 in chips)
kem0o3a/3AcDZBJg3cdvpQ: posts small blind $5
1s1h7qXmZxmowl9P1VNe2Q: posts big blind $10
7SUIdtQak1SCtldWHjwnFA: sits out
*** HOLE CARDS ***
efhcaDPhNqQ/H48kMHLa8w: folds
3mTlg4g0FJN2bo939h/0Wg: folds
ZaYCGtNHUeItoUEheoYDMw: folds
kem0o3a/3AcDZBJg3cdvpQ: raises $190 to $200 and is all-in
1s1h7qXmZxmowl9P1VNe2Q: calls $190 and is all-in
*** FLOP *** [8d 9h As]
*** TURN *** [8d 9h As] [7s]
*** RIVER *** [8d 9h As 7s] [Qc]
*** SHOW DOWN ***
kem0o3a/3AcDZBJg3cdvpQ: shows [8h Kh] (a pair of Eights)
1s1h7qXmZxmowl9P1VNe2Q: shows [Th Jh] (a straight, Eight to Queen)
1s1h7qXmZxmowl9P1VNe2Q collected $398 from pot
*** SUMMARY ***
Total pot $400 | Rake $2
Board [8d 9h As 7s Qc]
Seat 1: ZaYCGtNHUeItoUEheoYDMw (button) folded before Flop (didn't bet)
Seat 2: kem0o3a/3AcDZBJg3cdvpQ (small blind) showed [8h Kh] and lost with a pair of Eights
Seat 3: 1s1h7qXmZxmowl9P1VNe2Q (big blind) showed [Th Jh] and won ($398) with a straight, Eight to Queen
Seat 4: efhcaDPhNqQ/H48kMHLa8w folded before Flop (didn't bet)
Seat 6: 3mTlg4g0FJN2bo939h/0Wg folded before Flop (didn't bet)



PokerStars Game #59964559882:  Hold'em No Limit ($5/$10) - 2009/07/01 12:13:28 ET
Table 'dzUWBUz1AtehXXhTI9CCwA' 2-max Seat #2 is the button
Seat 1: KK2L3ELlZFnDURuAy5bqzQ ($994 in chips)
Seat 2: o680fZMaQtqAfYOL5g4iSA ($220.10 in chips)
o680fZMaQtqAfYOL5g4iSA: posts small blind $5
KK2L3ELlZFnDURuAy5bqzQ: posts big blind $10
*** HOLE CARDS ***
o680fZMaQtqAfYOL5g4iSA: raises $10 to $20
KK2L3ELlZFnDURuAy5bqzQ: folds
o680fZMaQtqAfYOL5g4iSA collected $20 from pot
o680fZMaQtqAfYOL5g4iSA: doesn't show hand
*** SUMMARY ***
Total pot $20 | Rake $0
Seat 1: KK2L3ELlZFnDURuAy5bqzQ (big blind) folded before Flop
Seat 2: o680fZMaQtqAfYOL5g4iSA (button) (small blind) collected ($20)



PokerStars Game #59964559456:  Hold'em No Limit ($5/$10) - 2009/07/01 12:13:28 ET
Table 'AI1fZ7Tsbf9DI8mC4EWoQQ' 9-max Seat #7 is the button
Seat 2: voSAIKXtXUUbJnds83sYfQ ($1099 in chips)
Seat 3: QjU8cx/IlcsbRKufwbiKow ($985 in chips)
Seat 4: efhcaDPhNqQ/H48kMHLa8w ($1107 in chips)
Seat 5: 2PHCSXghjbGk2qR6jDFe2g ($937 in chips)
Seat 6: l9mDFuns/ycIDiFx40BMVw ($810 in chips)
Seat 7: ettgJAblGnistIlqNz4Jww ($1072 in chips)
Seat 8: UgBUE0pOJDwUdQ53XJt8MQ ($95 in chips)
Seat 9: 1s1h7qXmZxmowl9P1VNe2Q ($189.75 in chips)
UgBUE0pOJDwUdQ53XJt8MQ: posts small blind $5
1s1h7qXmZxmowl9P1VNe2Q: posts big blind $10
*** HOLE CARDS ***
voSAIKXtXUUbJnds83sYfQ: folds
QjU8cx/IlcsbRKufwbiKow: raises $20 to $30
efhcaDPhNqQ/H48kMHLa8w: folds
2PHCSXghjbGk2qR6jDFe2g: folds
l9mDFuns/ycIDiFx40BMVw: calls $30
ve1LEJosAmuFjNNCQuPnPg has returned
ettgJAblGnistIlqNz4Jww: folds
UgBUE0pOJDwUdQ53XJt8MQ: folds
1s1h7qXmZxmowl9P1VNe2Q: folds
*** FLOP *** [Ks 4h 3s]
QjU8cx/IlcsbRKufwbiKow: bets $60
l9mDFuns/ycIDiFx40BMVw: calls $60
*** TURN *** [Ks 4h 3s] [2d]
QjU8cx/IlcsbRKufwbiKow: bets $160
l9mDFuns/ycIDiFx40BMVw: calls $160
*** RIVER *** [Ks 4h 3s 2d] [7d]
QjU8cx/IlcsbRKufwbiKow: checks
l9mDFuns/ycIDiFx40BMVw: bets $420
QjU8cx/IlcsbRKufwbiKow: calls $420
*** SHOW DOWN ***
l9mDFuns/ycIDiFx40BMVw: shows [5h 5c] (a pair of Fives)
QjU8cx/IlcsbRKufwbiKow: shows [As Kc] (a pair of Kings)
QjU8cx/IlcsbRKufwbiKow collected $1352 from pot
*** SUMMARY ***
Total pot $1355 | Rake $3
Board [Ks 4h 3s 2d 7d]
Seat 2: voSAIKXtXUUbJnds83sYfQ folded before Flop (didn't bet)
Seat 3: QjU8cx/IlcsbRKufwbiKow showed [As Kc] and won ($1352) with a pair of Kings
Seat 4: efhcaDPhNqQ/H48kMHLa8w folded before Flop (didn't bet)
Seat 5: 2PHCSXghjbGk2qR6jDFe2g folded before Flop (didn't bet)
Seat 6: l9mDFuns/ycIDiFx40BMVw showed [5h 5c] and lost with a pair of Fives
Seat 7: ettgJAblGnistIlqNz4Jww (button) folded before Flop (didn't bet)
Seat 8: UgBUE0pOJDwUdQ53XJt8MQ (small blind) folded before Flop
Seat 9: 1s1h7qXmZxmowl9P1VNe2Q (big blind) folded before Flop



PokerStars Game #59964568242:  Hold'em No Limit ($5/$10) - 2009/07/01 12:13:37 ET
Table 'dzUWBUz1AtehXXhTI9CCwA' 2-max Seat #1 is the button
Seat 1: KK2L3ELlZFnDURuAy5bqzQ ($984 in chips)
Seat 2: o680fZMaQtqAfYOL5g4iSA ($230.10 in chips)
KK2L3ELlZFnDURuAy5bqzQ: posts small blind $5
o680fZMaQtqAfYOL5g4iSA: posts big blind $10
*** HOLE CARDS ***
KK2L3ELlZFnDURuAy5bqzQ: raises $20 to $30
o680fZMaQtqAfYOL5g4iSA: folds
KK2L3ELlZFnDURuAy5bqzQ collected $20 from pot
KK2L3ELlZFnDURuAy5bqzQ: doesn't show hand
*** SUMMARY ***
Total pot $20 | Rake $0
Seat 1: KK2L3ELlZFnDURuAy5bqzQ (button) (small blind) collected ($20)
Seat 2: o680fZMaQtqAfYOL5g4iSA (big blind) folded before Flop



PokerStars Game #59964575826:  Hold'em No Limit ($5/$10) - 2009/07/01 12:13:45 ET
Table 'dzUWBUz1AtehXXhTI9CCwA' 2-max Seat #2 is the button
Seat 1: KK2L3ELlZFnDURuAy5bqzQ ($994 in chips)
Seat 2: o680fZMaQtqAfYOL5g4iSA ($220.10 in chips)
o680fZMaQtqAfYOL5g4iSA: posts small blind $5
KK2L3ELlZFnDURuAy5bqzQ: posts big blind $10
*** HOLE CARDS ***
o680fZMaQtqAfYOL5g4iSA: raises $20 to $30
KK2L3ELlZFnDURuAy5bqzQ: folds
o680fZMaQtqAfYOL5g4iSA collected $20 from pot
*** SUMMARY ***
Total pot $20 | Rake $0
Seat 1: KK2L3ELlZFnDURuAy5bqzQ (big blind) folded before Flop
Seat 2: o680fZMaQtqAfYOL5g4iSA (button) (small blind) collected ($20)



PokerStars Game #59964576088:  Hold'em No Limit ($5/$10) - 2009/07/01 12:13:46 ET
Table 'AiNa6yyp/njJVRYl/Lz1KQ' 6-max Seat #3 is the button
Seat 2: 7SUIdtQak1SCtldWHjwnFA ($271 in chips)
Seat 3: 3mTlg4g0FJN2bo939h/0Wg ($358.80 in chips)
Seat 4: 1ScqYmNf7/uWx1XSBgPTBw ($175 in chips)
Seat 5: 2PHCSXghjbGk2qR6jDFe2g ($221 in chips)
1ScqYmNf7/uWx1XSBgPTBw: posts small blind $5
2PHCSXghjbGk2qR6jDFe2g: posts big blind $10
UcFkfWngu95uR8Jhrj+HrQ: sits out
2jM9VDDsetFb9DSQdp7NFQ: sits out
*** HOLE CARDS ***
7SUIdtQak1SCtldWHjwnFA: folds
3mTlg4g0FJN2bo939h/0Wg: folds
1ScqYmNf7/uWx1XSBgPTBw: folds
2PHCSXghjbGk2qR6jDFe2g collected $10 from pot
2PHCSXghjbGk2qR6jDFe2g: doesn't show hand
*** SUMMARY ***
Total pot $10 | Rake $0
Seat 2: 7SUIdtQak1SCtldWHjwnFA folded before Flop (didn't bet)
Seat 3: 3mTlg4g0FJN2bo939h/0Wg (button) folded before Flop (didn't bet)
Seat 4: 1ScqYmNf7/uWx1XSBgPTBw (small blind) folded before Flop
Seat 5: 2PHCSXghjbGk2qR6jDFe2g (big blind) collected ($10)



PokerStars Game #59964586458:  Hold'em No Limit ($5/$10) - 2009/07/01 12:13:57 ET
Table '1Dt9cpcLUVE6HYkx5dUEdQ' 6-max Seat #1 is the button
Seat 1: Xl+I49lxCJwPGRuegiaHoA ($1015 in chips)
Seat 2: nCI/286bRXONuVN/6Bn49Q ($185 in chips)
Seat 3: UcFkfWngu95uR8Jhrj+HrQ ($200 in chips)
Seat 4: voSAIKXtXUUbJnds83sYfQ ($2183.75 in chips)
Seat 5: 1ScqYmNf7/uWx1XSBgPTBw ($200 in chips)
Seat 6: efhcaDPhNqQ/H48kMHLa8w ($1817 in chips)
nCI/286bRXONuVN/6Bn49Q: posts small blind $5
UcFkfWngu95uR8Jhrj+HrQ: posts big blind $10
*** HOLE CARDS ***
voSAIKXtXUUbJnds83sYfQ: folds
1ScqYmNf7/uWx1XSBgPTBw: folds
efhcaDPhNqQ/H48kMHLa8w: folds
Xl+I49lxCJwPGRuegiaHoA: folds
nCI/286bRXONuVN/6Bn49Q: raises $20 to $30
UcFkfWngu95uR8Jhrj+HrQ: folds
nCI/286bRXONuVN/6Bn49Q collected $20 from pot
*** SUMMARY ***
Total pot $20 | Rake $0
Seat 1: Xl+I49lxCJwPGRuegiaHoA (button) folded before Flop (didn't bet)
Seat 2: nCI/286bRXONuVN/6Bn49Q (small blind) collected ($20)
Seat 3: UcFkfWngu95uR8Jhrj+HrQ (big blind) folded before Flop
Seat 4: voSAIKXtXUUbJnds83sYfQ folded before Flop (didn't bet)
Seat 5: 1ScqYmNf7/uWx1XSBgPTBw folded before Flop (didn't bet)
Seat 6: efhcaDPhNqQ/H48kMHLa8w folded before Flop (didn't bet)



PokerStars Game #59964587388:  Hold'em No Limit ($5/$10) - 2009/07/01 12:13:58 ET
Table 'r10wRkUZaNZLcIr0K/VDlg' 6-max Seat #3 is the button
Seat 1: bjInvXcoSxLjVXWB9UWLBQ ($264 in chips)
Seat 2: 1ScqYmNf7/uWx1XSBgPTBw ($200 in chips)
Seat 3: UcFkfWngu95uR8Jhrj+HrQ ($227 in chips)
Seat 4: lu4P1Unn4wHCS7lPOOr9gA ($473.75 in chips)
Seat 5: Xl+I49lxCJwPGRuegiaHoA ($1000 in chips)
Seat 6: 3mTlg4g0FJN2bo939h/0Wg ($61 in chips)
lu4P1Unn4wHCS7lPOOr9gA: posts small blind $5
Xl+I49lxCJwPGRuegiaHoA: posts big blind $10
*** HOLE CARDS ***
3mTlg4g0FJN2bo939h/0Wg: raises $51 to $61 and is all-in
bjInvXcoSxLjVXWB9UWLBQ: folds
1ScqYmNf7/uWx1XSBgPTBw: folds
UcFkfWngu95uR8Jhrj+HrQ: folds
lu4P1Unn4wHCS7lPOOr9gA: folds
Xl+I49lxCJwPGRuegiaHoA: folds
3mTlg4g0FJN2bo939h/0Wg collected $25 from pot
*** SUMMARY ***
Total pot $25 | Rake $0
Seat 1: bjInvXcoSxLjVXWB9UWLBQ folded before Flop (didn't bet)
Seat 2: 1ScqYmNf7/uWx1XSBgPTBw folded before Flop (didn't bet)
Seat 3: UcFkfWngu95uR8Jhrj+HrQ (button) folded before Flop (didn't bet)
Seat 4: lu4P1Unn4wHCS7lPOOr9gA (small blind) folded before Flop
Seat 5: Xl+I49lxCJwPGRuegiaHoA (big blind) folded before Flop
Seat 6: 3mTlg4g0FJN2bo939h/0Wg collected ($25)



PokerStars Game #59964589980:  Hold'em No Limit ($5/$10) - 2009/07/01 12:14:01 ET
Table 'dzUWBUz1AtehXXhTI9CCwA' 2-max Seat #1 is the button
Seat 1: KK2L3ELlZFnDURuAy5bqzQ ($984 in chips)
Seat 2: o680fZMaQtqAfYOL5g4iSA ($230.10 in chips)
KK2L3ELlZFnDURuAy5bqzQ: posts small blind $5
o680fZMaQtqAfYOL5g4iSA: posts big blind $10
*** HOLE CARDS ***
KK2L3ELlZFnDURuAy5bqzQ: raises $20 to $30
o680fZMaQtqAfYOL5g4iSA: calls $20
*** FLOP *** [9c 8d Jh]
o680fZMaQtqAfYOL5g4iSA: checks
KK2L3ELlZFnDURuAy5bqzQ: bets $40
o680fZMaQtqAfYOL5g4iSA: raises $40 to $80
KK2L3ELlZFnDURuAy5bqzQ: folds
o680fZMaQtqAfYOL5g4iSA collected $139.50 from pot
o680fZMaQtqAfYOL5g4iSA: shows [Th 9h] (a pair of Nines)
*** SUMMARY ***
Total pot $140 | Rake $0.50
Board [9c 8d Jh]
Seat 1: KK2L3ELlZFnDURuAy5bqzQ (button) (small blind) folded on the Flop
Seat 2: o680fZMaQtqAfYOL5g4iSA (big blind) collected ($139.50)



PokerStars Game #59964592022:  Hold'em No Limit ($5/$10) - 2009/07/01 12:14:03 ET
Table 'AiNa6yyp/njJVRYl/Lz1KQ' 6-max Seat #4 is the button
Seat 2: 7SUIdtQak1SCtldWHjwnFA ($271 in chips)
Seat 3: 3mTlg4g0FJN2bo939h/0Wg ($358.80 in chips)
Seat 4: 1ScqYmNf7/uWx1XSBgPTBw ($170 in chips)
Seat 5: 2PHCSXghjbGk2qR6jDFe2g ($226 in chips)
Seat 6: UcFkfWngu95uR8Jhrj+HrQ ($200 in chips)
2PHCSXghjbGk2qR6jDFe2g: posts small blind $5
UcFkfWngu95uR8Jhrj+HrQ: posts big blind $10
2jM9VDDsetFb9DSQdp7NFQ: sits out
*** HOLE CARDS ***
7SUIdtQak1SCtldWHjwnFA: folds
3mTlg4g0FJN2bo939h/0Wg: raises $10 to $20
1ScqYmNf7/uWx1XSBgPTBw: folds
2PHCSXghjbGk2qR6jDFe2g: calls $15
UcFkfWngu95uR8Jhrj+HrQ: calls $10
*** FLOP *** [Jd 5h 4c]
2PHCSXghjbGk2qR6jDFe2g: checks
UcFkfWngu95uR8Jhrj+HrQ: checks
3mTlg4g0FJN2bo939h/0Wg: bets $20
2PHCSXghjbGk2qR6jDFe2g: folds
UcFkfWngu95uR8Jhrj+HrQ: folds
3mTlg4g0FJN2bo939h/0Wg collected $58 from pot
*** SUMMARY ***
Total pot $60 | Rake $2
Board [Jd 5h 4c]
Seat 2: 7SUIdtQak1SCtldWHjwnFA folded before Flop (didn't bet)
Seat 3: 3mTlg4g0FJN2bo939h/0Wg collected ($58)
Seat 4: 1ScqYmNf7/uWx1XSBgPTBw (button) folded before Flop (didn't bet)
Seat 5: 2PHCSXghjbGk2qR6jDFe2g (small blind) folded on the Flop
Seat 6: UcFkfWngu95uR8Jhrj+HrQ (big blind) folded on the Flop



PokerStars Game #59964602506:  Hold'em No Limit ($5/$10) - 2009/07/01 12:14:15 ET
Table 'dwLGEw3aoH/cOAI7JsLdmw' 6-max Seat #2 is the button
Seat 1: ZaYCGtNHUeItoUEheoYDMw ($193 in chips)
Seat 2: kem0o3a/3AcDZBJg3cdvpQ ($200 in chips)
Seat 3: 1s1h7qXmZxmowl9P1VNe2Q ($398 in chips)
Seat 5: 7SUIdtQak1SCtldWHjwnFA ($200 in chips)
Seat 6: 3mTlg4g0FJN2bo939h/0Wg ($219.55 in chips)
1s1h7qXmZxmowl9P1VNe2Q: posts small blind $5
efhcaDPhNqQ/H48kMHLa8w: is sitting out
7SUIdtQak1SCtldWHjwnFA: posts big blind $10
*** HOLE CARDS ***
3mTlg4g0FJN2bo939h/0Wg: raises $10 to $20
ZaYCGtNHUeItoUEheoYDMw: folds
kem0o3a/3AcDZBJg3cdvpQ: folds
1s1h7qXmZxmowl9P1VNe2Q: folds
7SUIdtQak1SCtldWHjwnFA: raises $35 to $55
3mTlg4g0FJN2bo939h/0Wg: calls $35
*** FLOP *** [Jh 6c Td]
7SUIdtQak1SCtldWHjwnFA: bets $87
3mTlg4g0FJN2bo939h/0Wg: folds
7SUIdtQak1SCtldWHjwnFA collected $113 from pot
*** SUMMARY ***
Total pot $115 | Rake $2
Board [Jh 6c Td]
Seat 1: ZaYCGtNHUeItoUEheoYDMw folded before Flop (didn't bet)
Seat 2: kem0o3a/3AcDZBJg3cdvpQ (button) folded before Flop (didn't bet)
Seat 3: 1s1h7qXmZxmowl9P1VNe2Q (small blind) folded before Flop
Seat 5: 7SUIdtQak1SCtldWHjwnFA (big blind) collected ($113)
Seat 6: 3mTlg4g0FJN2bo939h/0Wg folded on the Flop



PokerStars Game #59964607874:  Hold'em No Limit ($5/$10) - 2009/07/01 12:14:21 ET
Table 'r10wRkUZaNZLcIr0K/VDlg' 6-max Seat #4 is the button
Seat 1: bjInvXcoSxLjVXWB9UWLBQ ($264 in chips)
Seat 2: 1ScqYmNf7/uWx1XSBgPTBw ($200 in chips)
Seat 3: UcFkfWngu95uR8Jhrj+HrQ ($227 in chips)
Seat 4: lu4P1Unn4wHCS7lPOOr9gA ($468.75 in chips)
Seat 5: Xl+I49lxCJwPGRuegiaHoA ($1000 in chips)
Seat 6: 3mTlg4g0FJN2bo939h/0Wg ($76 in chips)
Xl+I49lxCJwPGRuegiaHoA: posts small blind $5
3mTlg4g0FJN2bo939h/0Wg: posts big blind $10
*** HOLE CARDS ***
bjInvXcoSxLjVXWB9UWLBQ: folds
1ScqYmNf7/uWx1XSBgPTBw: folds
UcFkfWngu95uR8Jhrj+HrQ: folds
lu4P1Unn4wHCS7lPOOr9gA: raises $20 to $30
Xl+I49lxCJwPGRuegiaHoA: folds
3mTlg4g0FJN2bo939h/0Wg: calls $20
*** FLOP *** [5s 4h Qh]
3mTlg4g0FJN2bo939h/0Wg: checks
lu4P1Unn4wHCS7lPOOr9gA: bets $50
3mTlg4g0FJN2bo939h/0Wg: calls $46 and is all-in
*** TURN *** [5s 4h Qh] [6h]
*** RIVER *** [5s 4h Qh 6h] [Kh]
*** SHOW DOWN ***
3mTlg4g0FJN2bo939h/0Wg: shows [Td Ad] (high card Ace)
lu4P1Unn4wHCS7lPOOr9gA: shows [As Ac] (a pair of Aces)
lu4P1Unn4wHCS7lPOOr9gA collected $154 from pot
*** SUMMARY ***
Total pot $157 | Rake $3
Board [5s 4h Qh 6h Kh]
Seat 1: bjInvXcoSxLjVXWB9UWLBQ folded before Flop (didn't bet)
Seat 2: 1ScqYmNf7/uWx1XSBgPTBw folded before Flop (didn't bet)
Seat 3: UcFkfWngu95uR8Jhrj+HrQ folded before Flop (didn't bet)
Seat 4: lu4P1Unn4wHCS7lPOOr9gA (button) showed [As Ac] and won ($154) with a pair of Aces
Seat 5: Xl+I49lxCJwPGRuegiaHoA (small blind) folded before Flop
Seat 6: 3mTlg4g0FJN2bo939h/0Wg (big blind) showed [Td Ad] and lost with high card Ace



PokerStars Game #59964619538:  Hold'em No Limit ($5/$10) - 2009/07/01 12:14:34 ET
Table 'dzUWBUz1AtehXXhTI9CCwA' 2-max Seat #2 is the button
Seat 1: KK2L3ELlZFnDURuAy5bqzQ ($914 in chips)
Seat 2: o680fZMaQtqAfYOL5g4iSA ($299.60 in chips)
o680fZMaQtqAfYOL5g4iSA: posts small blind $5
KK2L3ELlZFnDURuAy5bqzQ: posts big blind $10
*** HOLE CARDS ***
o680fZMaQtqAfYOL5g4iSA: calls $5
KK2L3ELlZFnDURuAy5bqzQ: raises $30 to $40
o680fZMaQtqAfYOL5g4iSA: calls $30
*** FLOP *** [Qh 3c Kd]
KK2L3ELlZFnDURuAy5bqzQ: bets $60
o680fZMaQtqAfYOL5g4iSA: folds
KK2L3ELlZFnDURuAy5bqzQ collected $79.50 from pot
KK2L3ELlZFnDURuAy5bqzQ: doesn't show hand
*** SUMMARY ***
Total pot $80 | Rake $0.50
Board [Qh 3c Kd]
Seat 1: KK2L3ELlZFnDURuAy5bqzQ (big blind) collected ($79.50)
Seat 2: o680fZMaQtqAfYOL5g4iSA (button) (small blind) folded on the Flop



PokerStars Game #59964629836:  Hold'em No Limit ($5/$10) - 2009/07/01 12:14:45 ET
Table 'AiNa6yyp/njJVRYl/Lz1KQ' 6-max Seat #5 is the button
Seat 1: 2jM9VDDsetFb9DSQdp7NFQ ($400 in chips)
Seat 2: 7SUIdtQak1SCtldWHjwnFA ($271 in chips)
Seat 3: 3mTlg4g0FJN2bo939h/0Wg ($396.80 in chips)
Seat 4: 1ScqYmNf7/uWx1XSBgPTBw ($170 in chips)
Seat 5: 2PHCSXghjbGk2qR6jDFe2g ($206 in chips)
Seat 6: UcFkfWngu95uR8Jhrj+HrQ ($180 in chips)
UcFkfWngu95uR8Jhrj+HrQ: posts small blind $5
2jM9VDDsetFb9DSQdp7NFQ: posts big blind $10
*** HOLE CARDS ***
7SUIdtQak1SCtldWHjwnFA: folds
3mTlg4g0FJN2bo939h/0Wg: folds
1ScqYmNf7/uWx1XSBgPTBw: folds
2PHCSXghjbGk2qR6jDFe2g: raises $10 to $20
UcFkfWngu95uR8Jhrj+HrQ: folds
2jM9VDDsetFb9DSQdp7NFQ: folds
2PHCSXghjbGk2qR6jDFe2g collected $25 from pot
2PHCSXghjbGk2qR6jDFe2g: doesn't show hand
*** SUMMARY ***
Total pot $25 | Rake $0
Seat 1: 2jM9VDDsetFb9DSQdp7NFQ (big blind) folded before Flop
Seat 2: 7SUIdtQak1SCtldWHjwnFA folded before Flop (didn't bet)
Seat 3: 3mTlg4g0FJN2bo939h/0Wg folded before Flop (didn't bet)
Seat 4: 1ScqYmNf7/uWx1XSBgPTBw folded before Flop (didn't bet)
Seat 5: 2PHCSXghjbGk2qR6jDFe2g (button) collected ($25)
Seat 6: UcFkfWngu95uR8Jhrj+HrQ (small blind) folded before Flop



PokerStars Game #59964632266:  Hold'em No Limit ($5/$10) - 2009/07/01 12:14:48 ET
Table '1Dt9cpcLUVE6HYkx5dUEdQ' 6-max Seat #2 is the button
Seat 1: Xl+I49lxCJwPGRuegiaHoA ($1015 in chips)
Seat 2: nCI/286bRXONuVN/6Bn49Q ($195 in chips)
Seat 3: UcFkfWngu95uR8Jhrj+HrQ ($190 in chips)
Seat 4: voSAIKXtXUUbJnds83sYfQ ($2183.75 in chips)
Seat 5: 1ScqYmNf7/uWx1XSBgPTBw ($200 in chips)
Seat 6: efhcaDPhNqQ/H48kMHLa8w ($1817 in chips)
UcFkfWngu95uR8Jhrj+HrQ: posts small blind $5
voSAIKXtXUUbJnds83sYfQ: posts big blind $10
*** HOLE CARDS ***
1ScqYmNf7/uWx1XSBgPTBw: folds
efhcaDPhNqQ/H48kMHLa8w: raises $20 to $30
Xl+I49lxCJwPGRuegiaHoA: folds
nCI/286bRXONuVN/6Bn49Q: folds
UcFkfWngu95uR8Jhrj+HrQ: folds
voSAIKXtXUUbJnds83sYfQ: folds
efhcaDPhNqQ/H48kMHLa8w collected $25 from pot
*** SUMMARY ***
Total pot $25 | Rake $0
Seat 1: Xl+I49lxCJwPGRuegiaHoA folded before Flop (didn't bet)
Seat 2: nCI/286bRXONuVN/6Bn49Q (button) folded before Flop (didn't bet)
Seat 3: UcFkfWngu95uR8Jhrj+HrQ (small blind) folded before Flop
Seat 4: voSAIKXtXUUbJnds83sYfQ (big blind) folded before Flop
Seat 5: 1ScqYmNf7/uWx1XSBgPTBw folded before Flop (didn't bet)
Seat 6: efhcaDPhNqQ/H48kMHLa8w collected ($25)



PokerStars Game #59964640254:  Hold'em No Limit ($5/$10) - 2009/07/01 12:14:57 ET
Table 'dzUWBUz1AtehXXhTI9CCwA' 2-max Seat #1 is the button
Seat 1: KK2L3ELlZFnDURuAy5bqzQ ($953.50 in chips)
Seat 2: o680fZMaQtqAfYOL5g4iSA ($259.60 in chips)
KK2L3ELlZFnDURuAy5bqzQ: posts small blind $5
o680fZMaQtqAfYOL5g4iSA: posts big blind $10
*** HOLE CARDS ***
KK2L3ELlZFnDURuAy5bqzQ: raises $20 to $30
o680fZMaQtqAfYOL5g4iSA: folds
KK2L3ELlZFnDURuAy5bqzQ collected $20 from pot
KK2L3ELlZFnDURuAy5bqzQ: doesn't show hand
*** SUMMARY ***
Total pot $20 | Rake $0
Seat 1: KK2L3ELlZFnDURuAy5bqzQ (button) (small blind) collected ($20)
Seat 2: o680fZMaQtqAfYOL5g4iSA (big blind) folded before Flop



PokerStars Game #59964641018:  Hold'em No Limit ($5/$10) - 2009/07/01 12:14:58 ET
Table 'dwLGEw3aoH/cOAI7JsLdmw' 6-max Seat #3 is the button
Seat 1: ZaYCGtNHUeItoUEheoYDMw ($193 in chips)
Seat 2: kem0o3a/3AcDZBJg3cdvpQ ($200 in chips)
Seat 3: 1s1h7qXmZxmowl9P1VNe2Q ($393 in chips)
Seat 5: 7SUIdtQak1SCtldWHjwnFA ($258 in chips)
Seat 6: 3mTlg4g0FJN2bo939h/0Wg ($164.55 in chips)
7SUIdtQak1SCtldWHjwnFA: posts small blind $5
3mTlg4g0FJN2bo939h/0Wg: posts big blind $10
*** HOLE CARDS ***
ZaYCGtNHUeItoUEheoYDMw: folds
kem0o3a/3AcDZBJg3cdvpQ: folds
1s1h7qXmZxmowl9P1VNe2Q: raises $10 to $20
7SUIdtQak1SCtldWHjwnFA: folds
3mTlg4g0FJN2bo939h/0Wg: calls $10
*** FLOP *** [8d Ks 9h]
3mTlg4g0FJN2bo939h/0Wg: bets $20
1s1h7qXmZxmowl9P1VNe2Q: calls $20
*** TURN *** [8d Ks 9h] [3c]
3mTlg4g0FJN2bo939h/0Wg: checks
1s1h7qXmZxmowl9P1VNe2Q: checks
*** RIVER *** [8d Ks 9h 3c] [2s]
3mTlg4g0FJN2bo939h/0Wg: checks
1s1h7qXmZxmowl9P1VNe2Q: checks
*** SHOW DOWN ***
3mTlg4g0FJN2bo939h/0Wg: shows [Jh 2d] (a pair of Deuces)
1s1h7qXmZxmowl9P1VNe2Q: shows [9s Qd] (a pair of Nines)
1s1h7qXmZxmowl9P1VNe2Q collected $83 from pot
*** SUMMARY ***
Total pot $85 | Rake $2
Board [8d Ks 9h 3c 2s]
Seat 1: ZaYCGtNHUeItoUEheoYDMw folded before Flop (didn't bet)
Seat 2: kem0o3a/3AcDZBJg3cdvpQ folded before Flop (didn't bet)
Seat 3: 1s1h7qXmZxmowl9P1VNe2Q (button) showed [9s Qd] and won ($83) with a pair of Nines
Seat 5: 7SUIdtQak1SCtldWHjwnFA (small blind) folded before Flop
Seat 6: 3mTlg4g0FJN2bo939h/0Wg (big blind) showed [Jh 2d] and lost with a pair of Deuces



PokerStars Game #59964648706:  Hold'em No Limit ($5/$10) - 2009/07/01 12:15:05 ET
Table 'dzUWBUz1AtehXXhTI9CCwA' 2-max Seat #2 is the button
Seat 1: KK2L3ELlZFnDURuAy5bqzQ ($963.50 in chips)
Seat 2: o680fZMaQtqAfYOL5g4iSA ($249.60 in chips)
o680fZMaQtqAfYOL5g4iSA: posts small blind $5
KK2L3ELlZFnDURuAy5bqzQ: posts big blind $10
*** HOLE CARDS ***
o680fZMaQtqAfYOL5g4iSA: folds
KK2L3ELlZFnDURuAy5bqzQ collected $10 from pot
KK2L3ELlZFnDURuAy5bqzQ: doesn't show hand
*** SUMMARY ***
Total pot $10 | Rake $0
Seat 1: KK2L3ELlZFnDURuAy5bqzQ (big blind) collected ($10)
Seat 2: o680fZMaQtqAfYOL5g4iSA (button) (small blind) folded before Flop



PokerStars Game #59964649884:  Hold'em No Limit ($5/$10) - 2009/07/01 12:15:07 ET
Table 'r10wRkUZaNZLcIr0K/VDlg' 6-max Seat #5 is the button
Seat 1: bjInvXcoSxLjVXWB9UWLBQ ($264 in chips)
Seat 2: 1ScqYmNf7/uWx1XSBgPTBw ($200 in chips)
Seat 3: UcFkfWngu95uR8Jhrj+HrQ ($227 in chips)
Seat 4: lu4P1Unn4wHCS7lPOOr9gA ($546.75 in chips)
Seat 5: Xl+I49lxCJwPGRuegiaHoA ($1000 in chips)
bjInvXcoSxLjVXWB9UWLBQ: posts small blind $5
1ScqYmNf7/uWx1XSBgPTBw: posts big blind $10
*** HOLE CARDS ***
UcFkfWngu95uR8Jhrj+HrQ: folds
lu4P1Unn4wHCS7lPOOr9gA: folds
3mTlg4g0FJN2bo939h/0Wg leaves the table
7u7CVWLfH5mxzeWdRgWV4Q joins the table at seat #6
Xl+I49lxCJwPGRuegiaHoA: raises $20 to $30
bjInvXcoSxLjVXWB9UWLBQ: folds
1ScqYmNf7/uWx1XSBgPTBw: folds
Xl+I49lxCJwPGRuegiaHoA collected $25 from pot
*** SUMMARY ***
Total pot $25 | Rake $0
Seat 1: bjInvXcoSxLjVXWB9UWLBQ (small blind) folded before Flop
Seat 2: 1ScqYmNf7/uWx1XSBgPTBw (big blind) folded before Flop
Seat 3: UcFkfWngu95uR8Jhrj+HrQ folded before Flop (didn't bet)
Seat 4: lu4P1Unn4wHCS7lPOOr9gA folded before Flop (didn't bet)
Seat 5: Xl+I49lxCJwPGRuegiaHoA (button) collected ($25)



PokerStars Game #59964656976:  Hold'em No Limit ($5/$10) - 2009/07/01 12:15:15 ET
Table 'dzUWBUz1AtehXXhTI9CCwA' 2-max Seat #1 is the button
Seat 1: KK2L3ELlZFnDURuAy5bqzQ ($968.50 in chips)
Seat 2: o680fZMaQtqAfYOL5g4iSA ($244.60 in chips)
KK2L3ELlZFnDURuAy5bqzQ: posts small blind $5
o680fZMaQtqAfYOL5g4iSA: posts big blind $10
*** HOLE CARDS ***
KK2L3ELlZFnDURuAy5bqzQ: raises $20 to $30
o680fZMaQtqAfYOL5g4iSA: raises $214.60 to $244.60 and is all-in
KK2L3ELlZFnDURuAy5bqzQ: calls $214.60
*** FLOP *** [7c 4d 3c]
*** TURN *** [7c 4d 3c] [7h]
*** RIVER *** [7c 4d 3c 7h] [Kh]
*** SHOW DOWN ***
o680fZMaQtqAfYOL5g4iSA: shows [3s 3d] (a full house, Threes full of Sevens)
KK2L3ELlZFnDURuAy5bqzQ: mucks hand
o680fZMaQtqAfYOL5g4iSA collected $488.70 from pot
*** SUMMARY ***
Total pot $489.20 | Rake $0.50
Board [7c 4d 3c 7h Kh]
Seat 1: KK2L3ELlZFnDURuAy5bqzQ (button) (small blind) mucked
Seat 2: o680fZMaQtqAfYOL5g4iSA (big blind) showed [3s 3d] and won ($488.70) with a full house, Threes full of Sevens



PokerStars Game #59964659996:  Hold'em No Limit ($5/$10) - 2009/07/01 12:15:18 ET
Table 'AiNa6yyp/njJVRYl/Lz1KQ' 6-max Seat #6 is the button
Seat 1: 2jM9VDDsetFb9DSQdp7NFQ ($390 in chips)
Seat 2: 7SUIdtQak1SCtldWHjwnFA ($271 in chips)
Seat 3: 3mTlg4g0FJN2bo939h/0Wg ($396.80 in chips)
Seat 4: 1ScqYmNf7/uWx1XSBgPTBw ($170 in chips)
Seat 5: 2PHCSXghjbGk2qR6jDFe2g ($221 in chips)
Seat 6: UcFkfWngu95uR8Jhrj+HrQ ($175 in chips)
2jM9VDDsetFb9DSQdp7NFQ: posts small blind $5
7SUIdtQak1SCtldWHjwnFA: posts big blind $10
*** HOLE CARDS ***
3mTlg4g0FJN2bo939h/0Wg: raises $10 to $20
1ScqYmNf7/uWx1XSBgPTBw: raises $150 to $170 and is all-in
2PHCSXghjbGk2qR6jDFe2g: folds
UcFkfWngu95uR8Jhrj+HrQ: folds
2jM9VDDsetFb9DSQdp7NFQ: folds
7SUIdtQak1SCtldWHjwnFA: folds
3mTlg4g0FJN2bo939h/0Wg: folds
1ScqYmNf7/uWx1XSBgPTBw collected $55 from pot
1ScqYmNf7/uWx1XSBgPTBw: doesn't show hand
*** SUMMARY ***
Total pot $55 | Rake $0
Seat 1: 2jM9VDDsetFb9DSQdp7NFQ (small blind) folded before Flop
Seat 2: 7SUIdtQak1SCtldWHjwnFA (big blind) folded before Flop
Seat 3: 3mTlg4g0FJN2bo939h/0Wg folded before Flop
Seat 4: 1ScqYmNf7/uWx1XSBgPTBw collected ($55)
Seat 5: 2PHCSXghjbGk2qR6jDFe2g folded before Flop (didn't bet)
Seat 6: UcFkfWngu95uR8Jhrj+HrQ (button) folded before Flop (didn't bet)



PokerStars Game #59964662060:  Hold'em No Limit ($5/$10) - 2009/07/01 12:15:20 ET
Table 'AI1fZ7Tsbf9DI8mC4EWoQQ' 9-max Seat #8 is the button
Seat 1: ve1LEJosAmuFjNNCQuPnPg ($2189.25 in chips)
Seat 2: voSAIKXtXUUbJnds83sYfQ ($1099 in chips)
Seat 3: QjU8cx/IlcsbRKufwbiKow ($1667 in chips)
Seat 4: efhcaDPhNqQ/H48kMHLa8w ($1107 in chips)
Seat 5: 2PHCSXghjbGk2qR6jDFe2g ($937 in chips)
Seat 6: l9mDFuns/ycIDiFx40BMVw ($140 in chips)
Seat 7: ettgJAblGnistIlqNz4Jww ($1072 in chips)
Seat 8: UgBUE0pOJDwUdQ53XJt8MQ ($90 in chips)
Seat 9: 1s1h7qXmZxmowl9P1VNe2Q ($179.75 in chips)
1s1h7qXmZxmowl9P1VNe2Q: posts small blind $5
ve1LEJosAmuFjNNCQuPnPg: posts big blind $10
*** HOLE CARDS ***
voSAIKXtXUUbJnds83sYfQ: folds
QjU8cx/IlcsbRKufwbiKow: folds
efhcaDPhNqQ/H48kMHLa8w: folds
2PHCSXghjbGk2qR6jDFe2g: folds
l9mDFuns/ycIDiFx40BMVw: raises $20 to $30
ettgJAblGnistIlqNz4Jww: folds
UgBUE0pOJDwUdQ53XJt8MQ: folds
1s1h7qXmZxmowl9P1VNe2Q: folds
ve1LEJosAmuFjNNCQuPnPg: folds
l9mDFuns/ycIDiFx40BMVw collected $25 from pot
*** SUMMARY ***
Total pot $25 | Rake $0
Seat 1: ve1LEJosAmuFjNNCQuPnPg (big blind) folded before Flop
Seat 2: voSAIKXtXUUbJnds83sYfQ folded before Flop (didn't bet)
Seat 3: QjU8cx/IlcsbRKufwbiKow folded before Flop (didn't bet)
Seat 4: efhcaDPhNqQ/H48kMHLa8w folded before Flop (didn't bet)
Seat 5: 2PHCSXghjbGk2qR6jDFe2g folded before Flop (didn't bet)
Seat 6: l9mDFuns/ycIDiFx40BMVw collected ($25)
Seat 7: ettgJAblGnistIlqNz4Jww folded before Flop (didn't bet)
Seat 8: UgBUE0pOJDwUdQ53XJt8MQ (button) folded before Flop (didn't bet)
Seat 9: 1s1h7qXmZxmowl9P1VNe2Q (small blind) folded before Flop



PokerStars Game #59964665584:  Hold'em No Limit ($5/$10) - 2009/07/01 12:15:24 ET
Table 'r10wRkUZaNZLcIr0K/VDlg' 6-max Seat #1 is the button
Seat 1: bjInvXcoSxLjVXWB9UWLBQ ($259 in chips)
Seat 2: 1ScqYmNf7/uWx1XSBgPTBw ($190 in chips)
Seat 3: UcFkfWngu95uR8Jhrj+HrQ ($227 in chips)
Seat 4: lu4P1Unn4wHCS7lPOOr9gA ($546.75 in chips)
Seat 5: Xl+I49lxCJwPGRuegiaHoA ($1015 in chips)
1ScqYmNf7/uWx1XSBgPTBw: posts small blind $5
UcFkfWngu95uR8Jhrj+HrQ: posts big blind $10
7u7CVWLfH5mxzeWdRgWV4Q: sits out
*** HOLE CARDS ***
lu4P1Unn4wHCS7lPOOr9gA: folds
Xl+I49lxCJwPGRuegiaHoA: folds
bjInvXcoSxLjVXWB9UWLBQ: folds
1ScqYmNf7/uWx1XSBgPTBw: folds
UcFkfWngu95uR8Jhrj+HrQ collected $10 from pot
*** SUMMARY ***
Total pot $10 | Rake $0
Seat 1: bjInvXcoSxLjVXWB9UWLBQ (button) folded before Flop (didn't bet)
Seat 2: 1ScqYmNf7/uWx1XSBgPTBw (small blind) folded before Flop
Seat 3: UcFkfWngu95uR8Jhrj+HrQ (big blind) collected ($10)
Seat 4: lu4P1Unn4wHCS7lPOOr9gA folded before Flop (didn't bet)
Seat 5: Xl+I49lxCJwPGRuegiaHoA folded before Flop (didn't bet)



PokerStars Game #59964677154:  Hold'em No Limit ($5/$10) - 2009/07/01 12:15:37 ET
Table 'dzUWBUz1AtehXXhTI9CCwA' 2-max Seat #2 is the button
Seat 1: KK2L3ELlZFnDURuAy5bqzQ ($723.90 in chips)
Seat 2: o680fZMaQtqAfYOL5g4iSA ($488.70 in chips)
o680fZMaQtqAfYOL5g4iSA: posts small blind $5
KK2L3ELlZFnDURuAy5bqzQ: posts big blind $10
*** HOLE CARDS ***
o680fZMaQtqAfYOL5g4iSA: folds
KK2L3ELlZFnDURuAy5bqzQ collected $10 from pot
KK2L3ELlZFnDURuAy5bqzQ: doesn't show hand
*** SUMMARY ***
Total pot $10 | Rake $0
Seat 1: KK2L3ELlZFnDURuAy5bqzQ (big blind) collected ($10)
Seat 2: o680fZMaQtqAfYOL5g4iSA (button) (small blind) folded before Flop



PokerStars Game #59964681934:  Hold'em No Limit ($5/$10) - 2009/07/01 12:15:42 ET
Table 'dwLGEw3aoH/cOAI7JsLdmw' 6-max Seat #5 is the button
Seat 1: ZaYCGtNHUeItoUEheoYDMw ($193 in chips)
Seat 2: kem0o3a/3AcDZBJg3cdvpQ ($200 in chips)
Seat 3: 1s1h7qXmZxmowl9P1VNe2Q ($436 in chips)
Seat 5: 7SUIdtQak1SCtldWHjwnFA ($253 in chips)
Seat 6: 3mTlg4g0FJN2bo939h/0Wg ($124.55 in chips)
3mTlg4g0FJN2bo939h/0Wg: posts small blind $5
ZaYCGtNHUeItoUEheoYDMw: posts big blind $10
*** HOLE CARDS ***
kem0o3a/3AcDZBJg3cdvpQ: folds
1s1h7qXmZxmowl9P1VNe2Q: folds
7SUIdtQak1SCtldWHjwnFA: folds
3mTlg4g0FJN2bo939h/0Wg: raises $10 to $20
ZaYCGtNHUeItoUEheoYDMw: folds
3mTlg4g0FJN2bo939h/0Wg collected $20 from pot
*** SUMMARY ***
Total pot $20 | Rake $0
Seat 1: ZaYCGtNHUeItoUEheoYDMw (big blind) folded before Flop
Seat 2: kem0o3a/3AcDZBJg3cdvpQ folded before Flop (didn't bet)
Seat 3: 1s1h7qXmZxmowl9P1VNe2Q folded before Flop (didn't bet)
Seat 5: 7SUIdtQak1SCtldWHjwnFA (button) folded before Flop (didn't bet)
Seat 6: 3mTlg4g0FJN2bo939h/0Wg (small blind) collected ($20)



PokerStars Game #59964682948:  Hold'em No Limit ($5/$10) - 2009/07/01 12:15:43 ET
Table 'dzUWBUz1AtehXXhTI9CCwA' 2-max Seat #1 is the button
Seat 1: KK2L3ELlZFnDURuAy5bqzQ ($728.90 in chips)
Seat 2: o680fZMaQtqAfYOL5g4iSA ($483.70 in chips)
KK2L3ELlZFnDURuAy5bqzQ: posts small blind $5
o680fZMaQtqAfYOL5g4iSA: posts big blind $10
*** HOLE CARDS ***
KK2L3ELlZFnDURuAy5bqzQ: raises $20 to $30
o680fZMaQtqAfYOL5g4iSA: calls $20
*** FLOP *** [Qd 7h 9d]
o680fZMaQtqAfYOL5g4iSA: bets $20
KK2L3ELlZFnDURuAy5bqzQ: raises $50 to $70
o680fZMaQtqAfYOL5g4iSA: calls $50
*** TURN *** [Qd 7h 9d] [8d]
o680fZMaQtqAfYOL5g4iSA: bets $40
KK2L3ELlZFnDURuAy5bqzQ: calls $40
*** RIVER *** [Qd 7h 9d 8d] [5d]
o680fZMaQtqAfYOL5g4iSA: bets $50
KK2L3ELlZFnDURuAy5bqzQ: calls $50
*** SHOW DOWN ***
o680fZMaQtqAfYOL5g4iSA: shows [9s Td] (a flush, Queen high)
KK2L3ELlZFnDURuAy5bqzQ: mucks hand
o680fZMaQtqAfYOL5g4iSA collected $379.50 from pot
*** SUMMARY ***
Total pot $380 | Rake $0.50
Board [Qd 7h 9d 8d 5d]
Seat 1: KK2L3ELlZFnDURuAy5bqzQ (button) (small blind) mucked
Seat 2: o680fZMaQtqAfYOL5g4iSA (big blind) showed [9s Td] and won ($379.50) with a flush, Queen high



PokerStars Game #59964685876:  Hold'em No Limit ($5/$10) - 2009/07/01 12:15:46 ET
Table 'r10wRkUZaNZLcIr0K/VDlg' 6-max Seat #2 is the button
Seat 1: bjInvXcoSxLjVXWB9UWLBQ ($259 in chips)
Seat 2: 1ScqYmNf7/uWx1XSBgPTBw ($185 in chips)
Seat 3: UcFkfWngu95uR8Jhrj+HrQ ($232 in chips)
Seat 4: lu4P1Unn4wHCS7lPOOr9gA ($546.75 in chips)
Seat 5: Xl+I49lxCJwPGRuegiaHoA ($1015 in chips)
UcFkfWngu95uR8Jhrj+HrQ: posts small blind $5
lu4P1Unn4wHCS7lPOOr9gA: posts big blind $10
7u7CVWLfH5mxzeWdRgWV4Q: sits out
*** HOLE CARDS ***
Xl+I49lxCJwPGRuegiaHoA: folds
bjInvXcoSxLjVXWB9UWLBQ: raises $20 to $30
1ScqYmNf7/uWx1XSBgPTBw: folds
UcFkfWngu95uR8Jhrj+HrQ: folds
lu4P1Unn4wHCS7lPOOr9gA: folds
bjInvXcoSxLjVXWB9UWLBQ collected $25 from pot
*** SUMMARY ***
Total pot $25 | Rake $0
Seat 1: bjInvXcoSxLjVXWB9UWLBQ collected ($25)
Seat 2: 1ScqYmNf7/uWx1XSBgPTBw (button) folded before Flop (didn't bet)
Seat 3: UcFkfWngu95uR8Jhrj+HrQ (small blind) folded before Flop
Seat 4: lu4P1Unn4wHCS7lPOOr9gA (big blind) folded before Flop
Seat 5: Xl+I49lxCJwPGRuegiaHoA folded before Flop (didn't bet)



PokerStars Game #59964686984:  Hold'em No Limit ($5/$10) - 2009/07/01 12:15:48 ET
Table 'AiNa6yyp/njJVRYl/Lz1KQ' 6-max Seat #1 is the button
Seat 1: 2jM9VDDsetFb9DSQdp7NFQ ($385 in chips)
Seat 2: 7SUIdtQak1SCtldWHjwnFA ($261 in chips)
Seat 3: 3mTlg4g0FJN2bo939h/0Wg ($376.80 in chips)
Seat 4: 1ScqYmNf7/uWx1XSBgPTBw ($205 in chips)
Seat 5: 2PHCSXghjbGk2qR6jDFe2g ($221 in chips)
Seat 6: UcFkfWngu95uR8Jhrj+HrQ ($175 in chips)
7SUIdtQak1SCtldWHjwnFA: posts small blind $5
3mTlg4g0FJN2bo939h/0Wg: posts big blind $10
*** HOLE CARDS ***
1ScqYmNf7/uWx1XSBgPTBw: folds
2PHCSXghjbGk2qR6jDFe2g: raises $10 to $20
UcFkfWngu95uR8Jhrj+HrQ: folds
2jM9VDDsetFb9DSQdp7NFQ: folds
7SUIdtQak1SCtldWHjwnFA: folds
3mTlg4g0FJN2bo939h/0Wg: calls $10
*** FLOP *** [4h 3s Qs]
3mTlg4g0FJN2bo939h/0Wg: bets $20
2PHCSXghjbGk2qR6jDFe2g: raises $181 to $201 and is all-in
3mTlg4g0FJN2bo939h/0Wg: calls $181
*** TURN *** [4h 3s Qs] [8c]
*** RIVER *** [4h 3s Qs 8c] [3d]
*** SHOW DOWN ***
3mTlg4g0FJN2bo939h/0Wg: shows [8h 4c] (two pair, Eights and Fours)
2PHCSXghjbGk2qR6jDFe2g: shows [Qc 9c] (two pair, Queens and Threes)
2PHCSXghjbGk2qR6jDFe2g collected $444 from pot
*** SUMMARY ***
Total pot $447 | Rake $3
Board [4h 3s Qs 8c 3d]
Seat 1: 2jM9VDDsetFb9DSQdp7NFQ (button) folded before Flop (didn't bet)
Seat 2: 7SUIdtQak1SCtldWHjwnFA (small blind) folded before Flop
Seat 3: 3mTlg4g0FJN2bo939h/0Wg (big blind) showed [8h 4c] and lost with two pair, Eights and Fours
Seat 4: 1ScqYmNf7/uWx1XSBgPTBw folded before Flop (didn't bet)
Seat 5: 2PHCSXghjbGk2qR6jDFe2g showed [Qc 9c] and won ($444) with two pair, Queens and Threes
Seat 6: UcFkfWngu95uR8Jhrj+HrQ folded before Flop (didn't bet)



PokerStars Game #59964692480:  Hold'em No Limit ($5/$10) - 2009/07/01 12:15:53 ET
Table '1Dt9cpcLUVE6HYkx5dUEdQ' 6-max Seat #3 is the button
Seat 1: Xl+I49lxCJwPGRuegiaHoA ($1015 in chips)
Seat 2: nCI/286bRXONuVN/6Bn49Q ($195 in chips)
Seat 3: UcFkfWngu95uR8Jhrj+HrQ ($185 in chips)
Seat 4: voSAIKXtXUUbJnds83sYfQ ($2173.75 in chips)
Seat 5: 1ScqYmNf7/uWx1XSBgPTBw ($200 in chips)
Seat 6: efhcaDPhNqQ/H48kMHLa8w ($1832 in chips)
voSAIKXtXUUbJnds83sYfQ: posts small blind $5
1ScqYmNf7/uWx1XSBgPTBw: posts big blind $10
*** HOLE CARDS ***
efhcaDPhNqQ/H48kMHLa8w: folds
Xl+I49lxCJwPGRuegiaHoA: folds
nCI/286bRXONuVN/6Bn49Q: folds
UcFkfWngu95uR8Jhrj+HrQ: folds
voSAIKXtXUUbJnds83sYfQ: folds
1ScqYmNf7/uWx1XSBgPTBw collected $10 from pot
*** SUMMARY ***
Total pot $10 | Rake $0
Seat 1: Xl+I49lxCJwPGRuegiaHoA folded before Flop (didn't bet)
Seat 2: nCI/286bRXONuVN/6Bn49Q folded before Flop (didn't bet)
Seat 3: UcFkfWngu95uR8Jhrj+HrQ (button) folded before Flop (didn't bet)
Seat 4: voSAIKXtXUUbJnds83sYfQ (small blind) folded before Flop
Seat 5: 1ScqYmNf7/uWx1XSBgPTBw (big blind) collected ($10)
Seat 6: efhcaDPhNqQ/H48kMHLa8w folded before Flop (didn't bet)



PokerStars Game #59964704628:  Hold'em No Limit ($5/$10) - 2009/07/01 12:16:07 ET
Table 'dwLGEw3aoH/cOAI7JsLdmw' 6-max Seat #6 is the button
Seat 1: ZaYCGtNHUeItoUEheoYDMw ($183 in chips)
Seat 2: kem0o3a/3AcDZBJg3cdvpQ ($200 in chips)
Seat 3: 1s1h7qXmZxmowl9P1VNe2Q ($436 in chips)
Seat 5: 7SUIdtQak1SCtldWHjwnFA ($253 in chips)
Seat 6: 3mTlg4g0FJN2bo939h/0Wg ($134.55 in chips)
ZaYCGtNHUeItoUEheoYDMw: posts small blind $5
kem0o3a/3AcDZBJg3cdvpQ: posts big blind $10
*** HOLE CARDS ***
1s1h7qXmZxmowl9P1VNe2Q: folds
7SUIdtQak1SCtldWHjwnFA: folds
1s1h7qXmZxmowl9P1VNe2Q leaves the table
3mTlg4g0FJN2bo939h/0Wg: raises $10 to $20
ZaYCGtNHUeItoUEheoYDMw: folds
kem0o3a/3AcDZBJg3cdvpQ: folds
3mTlg4g0FJN2bo939h/0Wg collected $25 from pot
*** SUMMARY ***
Total pot $25 | Rake $0
Seat 1: ZaYCGtNHUeItoUEheoYDMw (small blind) folded before Flop
Seat 2: kem0o3a/3AcDZBJg3cdvpQ (big blind) folded before Flop
Seat 3: 1s1h7qXmZxmowl9P1VNe2Q folded before Flop (didn't bet)
Seat 5: 7SUIdtQak1SCtldWHjwnFA folded before Flop (didn't bet)
Seat 6: 3mTlg4g0FJN2bo939h/0Wg (button) collected ($25)



PokerStars Game #59964710820:  Hold'em No Limit ($5/$10) - 2009/07/01 12:16:13 ET
Table 'r10wRkUZaNZLcIr0K/VDlg' 6-max Seat #3 is the button
Seat 1: bjInvXcoSxLjVXWB9UWLBQ ($274 in chips)
Seat 2: 1ScqYmNf7/uWx1XSBgPTBw ($185 in chips)
Seat 3: UcFkfWngu95uR8Jhrj+HrQ ($227 in chips)
Seat 4: lu4P1Unn4wHCS7lPOOr9gA ($536.75 in chips)
Seat 5: Xl+I49lxCJwPGRuegiaHoA ($1015 in chips)
lu4P1Unn4wHCS7lPOOr9gA: posts small blind $5
Xl+I49lxCJwPGRuegiaHoA: posts big blind $10
7u7CVWLfH5mxzeWdRgWV4Q: sits out
*** HOLE CARDS ***
bjInvXcoSxLjVXWB9UWLBQ: folds
1ScqYmNf7/uWx1XSBgPTBw: folds
UcFkfWngu95uR8Jhrj+HrQ: folds
lu4P1Unn4wHCS7lPOOr9gA: raises $10 to $20
Xl+I49lxCJwPGRuegiaHoA: raises $40 to $60
lu4P1Unn4wHCS7lPOOr9gA: folds
Xl+I49lxCJwPGRuegiaHoA collected $40 from pot
Xl+I49lxCJwPGRuegiaHoA: doesn't show hand
*** SUMMARY ***
Total pot $40 | Rake $0
Seat 1: bjInvXcoSxLjVXWB9UWLBQ folded before Flop (didn't bet)
Seat 2: 1ScqYmNf7/uWx1XSBgPTBw folded before Flop (didn't bet)
Seat 3: UcFkfWngu95uR8Jhrj+HrQ (button) folded before Flop (didn't bet)
Seat 4: lu4P1Unn4wHCS7lPOOr9gA (small blind) folded before Flop
Seat 5: Xl+I49lxCJwPGRuegiaHoA (big blind) collected ($40)



PokerStars Game #59964714784:  Hold'em No Limit ($5/$10) - 2009/07/01 12:16:17 ET
Table '1Dt9cpcLUVE6HYkx5dUEdQ' 6-max Seat #4 is the button
Seat 1: Xl+I49lxCJwPGRuegiaHoA ($1015 in chips)
Seat 2: nCI/286bRXONuVN/6Bn49Q ($195 in chips)
Seat 3: UcFkfWngu95uR8Jhrj+HrQ ($185 in chips)
Seat 4: voSAIKXtXUUbJnds83sYfQ ($2168.75 in chips)
Seat 5: 1ScqYmNf7/uWx1XSBgPTBw ($205 in chips)
Seat 6: efhcaDPhNqQ/H48kMHLa8w ($1832 in chips)
1ScqYmNf7/uWx1XSBgPTBw: posts small blind $5
efhcaDPhNqQ/H48kMHLa8w: posts big blind $10
*** HOLE CARDS ***
Xl+I49lxCJwPGRuegiaHoA: folds
Xl+I49lxCJwPGRuegiaHoA leaves the table
nCI/286bRXONuVN/6Bn49Q: raises $15 to $25
UcFkfWngu95uR8Jhrj+HrQ: raises $45 to $70
voSAIKXtXUUbJnds83sYfQ: folds
1ScqYmNf7/uWx1XSBgPTBw: folds
efhcaDPhNqQ/H48kMHLa8w: folds
nCI/286bRXONuVN/6Bn49Q: folds
UcFkfWngu95uR8Jhrj+HrQ collected $65 from pot
*** SUMMARY ***
Total pot $65 | Rake $0
Seat 1: Xl+I49lxCJwPGRuegiaHoA folded before Flop (didn't bet)
Seat 2: nCI/286bRXONuVN/6Bn49Q folded before Flop
Seat 3: UcFkfWngu95uR8Jhrj+HrQ collected ($65)
Seat 4: voSAIKXtXUUbJnds83sYfQ (button) folded before Flop (didn't bet)
Seat 5: 1ScqYmNf7/uWx1XSBgPTBw (small blind) folded before Flop
Seat 6: efhcaDPhNqQ/H48kMHLa8w (big blind) folded before Flop



PokerStars Game #59964715856:  Hold'em No Limit ($5/$10) - 2009/07/01 12:16:19 ET
Table 'dzUWBUz1AtehXXhTI9CCwA' 2-max Seat #2 is the button
Seat 1: KK2L3ELlZFnDURuAy5bqzQ ($538.90 in chips)
Seat 2: o680fZMaQtqAfYOL5g4iSA ($673.20 in chips)
o680fZMaQtqAfYOL5g4iSA: posts small blind $5
KK2L3ELlZFnDURuAy5bqzQ: posts big blind $10
*** HOLE CARDS ***
o680fZMaQtqAfYOL5g4iSA: folds
KK2L3ELlZFnDURuAy5bqzQ collected $10 from pot
KK2L3ELlZFnDURuAy5bqzQ: doesn't show hand
*** SUMMARY ***
Total pot $10 | Rake $0
Seat 1: KK2L3ELlZFnDURuAy5bqzQ (big blind) collected ($10)
Seat 2: o680fZMaQtqAfYOL5g4iSA (button) (small blind) folded before Flop



PokerStars Game #59964725276:  Hold'em No Limit ($5/$10) - 2009/07/01 12:16:29 ET
Table 'AI1fZ7Tsbf9DI8mC4EWoQQ' 9-max Seat #9 is the button
Seat 1: ve1LEJosAmuFjNNCQuPnPg ($2179.25 in chips)
Seat 4: efhcaDPhNqQ/H48kMHLa8w ($1107 in chips)
Seat 5: 2PHCSXghjbGk2qR6jDFe2g ($937 in chips)
Seat 6: l9mDFuns/ycIDiFx40BMVw ($155 in chips)
Seat 7: ettgJAblGnistIlqNz4Jww ($1072 in chips)
Seat 8: UgBUE0pOJDwUdQ53XJt8MQ ($90 in chips)
Seat 9: 1s1h7qXmZxmowl9P1VNe2Q ($174.75 in chips)
ve1LEJosAmuFjNNCQuPnPg: posts small blind $5
voSAIKXtXUUbJnds83sYfQ: is sitting out
voSAIKXtXUUbJnds83sYfQ leaves the table
QjU8cx/IlcsbRKufwbiKow: is sitting out
efhcaDPhNqQ/H48kMHLa8w: posts big blind $10
*** HOLE CARDS ***
2PHCSXghjbGk2qR6jDFe2g: folds
l9mDFuns/ycIDiFx40BMVw: folds
ettgJAblGnistIlqNz4Jww: folds
UgBUE0pOJDwUdQ53XJt8MQ: folds
1s1h7qXmZxmowl9P1VNe2Q: folds
ve1LEJosAmuFjNNCQuPnPg: calls $5
efhcaDPhNqQ/H48kMHLa8w: raises $30 to $40
ve1LEJosAmuFjNNCQuPnPg: calls $30
*** FLOP *** [3c 5s 7c]
ve1LEJosAmuFjNNCQuPnPg: bets $50
efhcaDPhNqQ/H48kMHLa8w: folds
ve1LEJosAmuFjNNCQuPnPg collected $77 from pot
*** SUMMARY ***
Total pot $80 | Rake $3
Board [3c 5s 7c]
Seat 1: ve1LEJosAmuFjNNCQuPnPg (small blind) collected ($77)
Seat 4: efhcaDPhNqQ/H48kMHLa8w (big blind) folded on the Flop
Seat 5: 2PHCSXghjbGk2qR6jDFe2g folded before Flop (didn't bet)
Seat 6: l9mDFuns/ycIDiFx40BMVw folded before Flop (didn't bet)
Seat 7: ettgJAblGnistIlqNz4Jww folded before Flop (didn't bet)
Seat 8: UgBUE0pOJDwUdQ53XJt8MQ folded before Flop (didn't bet)
Seat 9: 1s1h7qXmZxmowl9P1VNe2Q (button) folded before Flop (didn't bet)



PokerStars Game #59964725842:  Hold'em No Limit ($5/$10) - 2009/07/01 12:16:30 ET
Table 'dzUWBUz1AtehXXhTI9CCwA' 2-max Seat #1 is the button
Seat 1: KK2L3ELlZFnDURuAy5bqzQ ($1000 in chips)
Seat 2: o680fZMaQtqAfYOL5g4iSA ($668.20 in chips)
KK2L3ELlZFnDURuAy5bqzQ: posts small blind $5
o680fZMaQtqAfYOL5g4iSA: posts big blind $10
*** HOLE CARDS ***
KK2L3ELlZFnDURuAy5bqzQ: folds
o680fZMaQtqAfYOL5g4iSA collected $10 from pot
o680fZMaQtqAfYOL5g4iSA: doesn't show hand
*** SUMMARY ***
Total pot $10 | Rake $0
Seat 1: KK2L3ELlZFnDURuAy5bqzQ (button) (small blind) folded before Flop
Seat 2: o680fZMaQtqAfYOL5g4iSA (big blind) collected ($10)



PokerStars Game #59964725550:  Hold'em No Limit ($5/$10) - 2009/07/01 12:16:30 ET
Table 'dwLGEw3aoH/cOAI7JsLdmw' 6-max Seat #1 is the button
Seat 1: ZaYCGtNHUeItoUEheoYDMw ($178 in chips)
Seat 2: kem0o3a/3AcDZBJg3cdvpQ ($190 in chips)
Seat 5: 7SUIdtQak1SCtldWHjwnFA ($253 in chips)
Seat 6: 3mTlg4g0FJN2bo939h/0Wg ($149.55 in chips)
kem0o3a/3AcDZBJg3cdvpQ: posts small blind $5
7SUIdtQak1SCtldWHjwnFA: posts big blind $10
*** HOLE CARDS ***
3mTlg4g0FJN2bo939h/0Wg: raises $10 to $20
ZaYCGtNHUeItoUEheoYDMw: folds
kem0o3a/3AcDZBJg3cdvpQ: folds
7SUIdtQak1SCtldWHjwnFA: calls $10
*** FLOP *** [5d 2c 3s]
7SUIdtQak1SCtldWHjwnFA: checks
3mTlg4g0FJN2bo939h/0Wg: bets $20
7SUIdtQak1SCtldWHjwnFA: folds
3mTlg4g0FJN2bo939h/0Wg collected $43 from pot
*** SUMMARY ***
Total pot $45 | Rake $2
Board [5d 2c 3s]
Seat 1: ZaYCGtNHUeItoUEheoYDMw (button) folded before Flop (didn't bet)
Seat 2: kem0o3a/3AcDZBJg3cdvpQ (small blind) folded before Flop
Seat 5: 7SUIdtQak1SCtldWHjwnFA (big blind) folded on the Flop
Seat 6: 3mTlg4g0FJN2bo939h/0Wg collected ($43)



PokerStars Game #59964730968:  Hold'em No Limit ($5/$10) - 2009/07/01 12:16:35 ET
Table 'dzUWBUz1AtehXXhTI9CCwA' 2-max Seat #2 is the button
Seat 1: KK2L3ELlZFnDURuAy5bqzQ ($995 in chips)
Seat 2: o680fZMaQtqAfYOL5g4iSA ($673.20 in chips)
o680fZMaQtqAfYOL5g4iSA: posts small blind $5
KK2L3ELlZFnDURuAy5bqzQ: posts big blind $10
*** HOLE CARDS ***
o680fZMaQtqAfYOL5g4iSA: folds
KK2L3ELlZFnDURuAy5bqzQ collected $10 from pot
KK2L3ELlZFnDURuAy5bqzQ: doesn't show hand
*** SUMMARY ***
Total pot $10 | Rake $0
Seat 1: KK2L3ELlZFnDURuAy5bqzQ (big blind) collected ($10)
Seat 2: o680fZMaQtqAfYOL5g4iSA (button) (small blind) folded before Flop



PokerStars Game #59964732738:  Hold'em No Limit ($5/$10) - 2009/07/01 12:16:37 ET
Table 'AiNa6yyp/njJVRYl/Lz1KQ' 6-max Seat #2 is the button
Seat 1: 2jM9VDDsetFb9DSQdp7NFQ ($385 in chips)
Seat 2: 7SUIdtQak1SCtldWHjwnFA ($256 in chips)
Seat 3: 3mTlg4g0FJN2bo939h/0Wg ($155.80 in chips)
Seat 4: 1ScqYmNf7/uWx1XSBgPTBw ($205 in chips)
Seat 5: 2PHCSXghjbGk2qR6jDFe2g ($444 in chips)
Seat 6: UcFkfWngu95uR8Jhrj+HrQ ($175 in chips)
3mTlg4g0FJN2bo939h/0Wg: posts small blind $5
1ScqYmNf7/uWx1XSBgPTBw: posts big blind $10
*** HOLE CARDS ***
2PHCSXghjbGk2qR6jDFe2g: folds
UcFkfWngu95uR8Jhrj+HrQ: folds
2jM9VDDsetFb9DSQdp7NFQ: folds
7SUIdtQak1SCtldWHjwnFA: folds
3mTlg4g0FJN2bo939h/0Wg: calls $5
1ScqYmNf7/uWx1XSBgPTBw: checks
*** FLOP *** [Jh 7h 6h]
3mTlg4g0FJN2bo939h/0Wg: bets $20
1ScqYmNf7/uWx1XSBgPTBw: folds
3mTlg4g0FJN2bo939h/0Wg collected $19 from pot
3mTlg4g0FJN2bo939h/0Wg: doesn't show hand
*** SUMMARY ***
Total pot $20 | Rake $1
Board [Jh 7h 6h]
Seat 1: 2jM9VDDsetFb9DSQdp7NFQ folded before Flop (didn't bet)
Seat 2: 7SUIdtQak1SCtldWHjwnFA (button) folded before Flop (didn't bet)
Seat 3: 3mTlg4g0FJN2bo939h/0Wg (small blind) collected ($19)
Seat 4: 1ScqYmNf7/uWx1XSBgPTBw (big blind) folded on the Flop
Seat 5: 2PHCSXghjbGk2qR6jDFe2g folded before Flop (didn't bet)
Seat 6: UcFkfWngu95uR8Jhrj+HrQ folded before Flop (didn't bet)



PokerStars Game #59964736350:  Hold'em No Limit ($5/$10) - 2009/07/01 12:16:41 ET
Table 'dzUWBUz1AtehXXhTI9CCwA' 2-max Seat #1 is the button
Seat 1: KK2L3ELlZFnDURuAy5bqzQ ($1000 in chips)
Seat 2: o680fZMaQtqAfYOL5g4iSA ($668.20 in chips)
KK2L3ELlZFnDURuAy5bqzQ: posts small blind $5
o680fZMaQtqAfYOL5g4iSA: posts big blind $10
*** HOLE CARDS ***
KK2L3ELlZFnDURuAy5bqzQ: folds
o680fZMaQtqAfYOL5g4iSA collected $10 from pot
o680fZMaQtqAfYOL5g4iSA: doesn't show hand
*** SUMMARY ***
Total pot $10 | Rake $0
Seat 1: KK2L3ELlZFnDURuAy5bqzQ (button) (small blind) folded before Flop
Seat 2: o680fZMaQtqAfYOL5g4iSA (big blind) collected ($10)



PokerStars Game #59964736720:  Hold'em No Limit ($5/$10) - 2009/07/01 12:16:42 ET
Table 'r10wRkUZaNZLcIr0K/VDlg' 6-max Seat #4 is the button
Seat 1: bjInvXcoSxLjVXWB9UWLBQ ($274 in chips)
Seat 2: 1ScqYmNf7/uWx1XSBgPTBw ($185 in chips)
Seat 3: UcFkfWngu95uR8Jhrj+HrQ ($227 in chips)
Seat 4: lu4P1Unn4wHCS7lPOOr9gA ($516.75 in chips)
Seat 5: Xl+I49lxCJwPGRuegiaHoA ($1035 in chips)
Seat 6: 7u7CVWLfH5mxzeWdRgWV4Q ($200 in chips)
Xl+I49lxCJwPGRuegiaHoA: posts small blind $5
7u7CVWLfH5mxzeWdRgWV4Q: posts big blind $10
*** HOLE CARDS ***
bjInvXcoSxLjVXWB9UWLBQ: folds
1ScqYmNf7/uWx1XSBgPTBw: raises $10 to $20
UcFkfWngu95uR8Jhrj+HrQ: folds
lu4P1Unn4wHCS7lPOOr9gA: calls $20
Xl+I49lxCJwPGRuegiaHoA: folds
7u7CVWLfH5mxzeWdRgWV4Q: folds
*** FLOP *** [Jd Jc 2d]
1ScqYmNf7/uWx1XSBgPTBw: bets $20
lu4P1Unn4wHCS7lPOOr9gA: folds
1ScqYmNf7/uWx1XSBgPTBw collected $52.25 from pot
1ScqYmNf7/uWx1XSBgPTBw: doesn't show hand
*** SUMMARY ***
Total pot $55 | Rake $2.75
Board [Jd Jc 2d]
Seat 1: bjInvXcoSxLjVXWB9UWLBQ folded before Flop (didn't bet)
Seat 2: 1ScqYmNf7/uWx1XSBgPTBw collected ($52.25)
Seat 3: UcFkfWngu95uR8Jhrj+HrQ folded before Flop (didn't bet)
Seat 4: lu4P1Unn4wHCS7lPOOr9gA (button) folded on the Flop
Seat 5: Xl+I49lxCJwPGRuegiaHoA (small blind) folded before Flop
Seat 6: 7u7CVWLfH5mxzeWdRgWV4Q (big blind) folded before Flop



PokerStars Game #59964741740:  Hold'em No Limit ($5/$10) - 2009/07/01 12:16:47 ET
Table 'dzUWBUz1AtehXXhTI9CCwA' 2-max Seat #2 is the button
Seat 1: KK2L3ELlZFnDURuAy5bqzQ ($995 in chips)
Seat 2: o680fZMaQtqAfYOL5g4iSA ($673.20 in chips)
o680fZMaQtqAfYOL5g4iSA: posts small blind $5
KK2L3ELlZFnDURuAy5bqzQ: posts big blind $10
*** HOLE CARDS ***
o680fZMaQtqAfYOL5g4iSA: raises $20 to $30
KK2L3ELlZFnDURuAy5bqzQ: folds
o680fZMaQtqAfYOL5g4iSA collected $20 from pot
o680fZMaQtqAfYOL5g4iSA: doesn't show hand
*** SUMMARY ***
Total pot $20 | Rake $0
Seat 1: KK2L3ELlZFnDURuAy5bqzQ (big blind) folded before Flop
Seat 2: o680fZMaQtqAfYOL5g4iSA (button) (small blind) collected ($20)



PokerStars Game #59964751960:  Hold'em No Limit ($5/$10) - 2009/07/01 12:16:58 ET
Table 'dwLGEw3aoH/cOAI7JsLdmw' 6-max Seat #2 is the button
Seat 1: ZaYCGtNHUeItoUEheoYDMw ($178 in chips)
Seat 2: kem0o3a/3AcDZBJg3cdvpQ ($185 in chips)
Seat 5: 7SUIdtQak1SCtldWHjwnFA ($233 in chips)
Seat 6: 3mTlg4g0FJN2bo939h/0Wg ($172.55 in chips)
7SUIdtQak1SCtldWHjwnFA: posts small blind $5
3mTlg4g0FJN2bo939h/0Wg: posts big blind $10
*** HOLE CARDS ***
ZaYCGtNHUeItoUEheoYDMw: folds
kem0o3a/3AcDZBJg3cdvpQ: folds
7SUIdtQak1SCtldWHjwnFA: folds
3mTlg4g0FJN2bo939h/0Wg collected $10 from pot
*** SUMMARY ***
Total pot $10 | Rake $0
Seat 1: ZaYCGtNHUeItoUEheoYDMw folded before Flop (didn't bet)
Seat 2: kem0o3a/3AcDZBJg3cdvpQ (button) folded before Flop (didn't bet)
Seat 5: 7SUIdtQak1SCtldWHjwnFA (small blind) folded before Flop
Seat 6: 3mTlg4g0FJN2bo939h/0Wg (big blind) collected ($10)



PokerStars Game #59964751470:  Hold'em No Limit ($5/$10) - 2009/07/01 12:16:58 ET
Table '1Dt9cpcLUVE6HYkx5dUEdQ' 6-max Seat #5 is the button
Seat 1: 1s1h7qXmZxmowl9P1VNe2Q ($200 in chips)
Seat 2: nCI/286bRXONuVN/6Bn49Q ($170 in chips)
Seat 3: UcFkfWngu95uR8Jhrj+HrQ ($225 in chips)
Seat 4: voSAIKXtXUUbJnds83sYfQ ($2168.75 in chips)
Seat 5: 1ScqYmNf7/uWx1XSBgPTBw ($200 in chips)
Seat 6: efhcaDPhNqQ/H48kMHLa8w ($1822 in chips)
efhcaDPhNqQ/H48kMHLa8w: posts small blind $5
1s1h7qXmZxmowl9P1VNe2Q: posts big blind $10
*** HOLE CARDS ***
nCI/286bRXONuVN/6Bn49Q: raises $15 to $25
UcFkfWngu95uR8Jhrj+HrQ: folds
voSAIKXtXUUbJnds83sYfQ: folds
1ScqYmNf7/uWx1XSBgPTBw: raises $175 to $200 and is all-in
efhcaDPhNqQ/H48kMHLa8w: folds
1s1h7qXmZxmowl9P1VNe2Q: folds
nCI/286bRXONuVN/6Bn49Q: calls $145 and is all-in
*** FLOP *** [7c 9c 6d]
*** TURN *** [7c 9c 6d] [3s]
*** RIVER *** [7c 9c 6d 3s] [8d]
*** SHOW DOWN ***
nCI/286bRXONuVN/6Bn49Q: shows [Ac Kh] (high card Ace)
1ScqYmNf7/uWx1XSBgPTBw: shows [Ks As] (high card Ace)
nCI/286bRXONuVN/6Bn49Q collected $176 from pot
1ScqYmNf7/uWx1XSBgPTBw collected $176 from pot
*** SUMMARY ***
Total pot $355 | Rake $3
Board [7c 9c 6d 3s 8d]
Seat 1: 1s1h7qXmZxmowl9P1VNe2Q (big blind) folded before Flop
Seat 2: nCI/286bRXONuVN/6Bn49Q showed [Ac Kh] and won ($176) with high card Ace
Seat 3: UcFkfWngu95uR8Jhrj+HrQ folded before Flop (didn't bet)
Seat 4: voSAIKXtXUUbJnds83sYfQ folded before Flop (didn't bet)
Seat 5: 1ScqYmNf7/uWx1XSBgPTBw (button) showed [Ks As] and won ($176) with high card Ace
Seat 6: efhcaDPhNqQ/H48kMHLa8w (small blind) folded before Flop



PokerStars Game #59964752426:  Hold'em No Limit ($5/$10) - 2009/07/01 12:16:59 ET
Table 'AiNa6yyp/njJVRYl/Lz1KQ' 6-max Seat #3 is the button
Seat 1: 2jM9VDDsetFb9DSQdp7NFQ ($385 in chips)
Seat 2: 7SUIdtQak1SCtldWHjwnFA ($256 in chips)
Seat 3: 3mTlg4g0FJN2bo939h/0Wg ($164.80 in chips)
Seat 4: 1ScqYmNf7/uWx1XSBgPTBw ($195 in chips)
Seat 5: 2PHCSXghjbGk2qR6jDFe2g ($444 in chips)
Seat 6: UcFkfWngu95uR8Jhrj+HrQ ($175 in chips)
1ScqYmNf7/uWx1XSBgPTBw: posts small blind $5
2PHCSXghjbGk2qR6jDFe2g: posts big blind $10
*** HOLE CARDS ***
UcFkfWngu95uR8Jhrj+HrQ: folds
2jM9VDDsetFb9DSQdp7NFQ: raises $20 to $30
7SUIdtQak1SCtldWHjwnFA: raises $70 to $100
3mTlg4g0FJN2bo939h/0Wg: folds
1ScqYmNf7/uWx1XSBgPTBw: folds
2PHCSXghjbGk2qR6jDFe2g: folds
2jM9VDDsetFb9DSQdp7NFQ: folds
7SUIdtQak1SCtldWHjwnFA collected $75 from pot
7SUIdtQak1SCtldWHjwnFA: doesn't show hand
*** SUMMARY ***
Total pot $75 | Rake $0
Seat 1: 2jM9VDDsetFb9DSQdp7NFQ folded before Flop
Seat 2: 7SUIdtQak1SCtldWHjwnFA collected ($75)
Seat 3: 3mTlg4g0FJN2bo939h/0Wg (button) folded before Flop (didn't bet)
Seat 4: 1ScqYmNf7/uWx1XSBgPTBw (small blind) folded before Flop
Seat 5: 2PHCSXghjbGk2qR6jDFe2g (big blind) folded before Flop
Seat 6: UcFkfWngu95uR8Jhrj+HrQ folded before Flop (didn't bet)



PokerStars Game #59964753336:  Hold'em No Limit ($5/$10) - 2009/07/01 12:17:00 ET
Table 'dzUWBUz1AtehXXhTI9CCwA' 2-max Seat #1 is the button
Seat 1: KK2L3ELlZFnDURuAy5bqzQ ($985 in chips)
Seat 2: o680fZMaQtqAfYOL5g4iSA ($683.20 in chips)
KK2L3ELlZFnDURuAy5bqzQ: posts small blind $5
o680fZMaQtqAfYOL5g4iSA: posts big blind $10
*** HOLE CARDS ***
KK2L3ELlZFnDURuAy5bqzQ: raises $20 to $30
o680fZMaQtqAfYOL5g4iSA: raises $40 to $70
KK2L3ELlZFnDURuAy5bqzQ: calls $40
*** FLOP *** [4d Tc Qd]
o680fZMaQtqAfYOL5g4iSA: checks
KK2L3ELlZFnDURuAy5bqzQ: checks
*** TURN *** [4d Tc Qd] [2d]
o680fZMaQtqAfYOL5g4iSA: bets $80
KK2L3ELlZFnDURuAy5bqzQ: folds
o680fZMaQtqAfYOL5g4iSA collected $139.50 from pot
o680fZMaQtqAfYOL5g4iSA: shows [Ac Qs] (a pair of Queens)
*** SUMMARY ***
Total pot $140 | Rake $0.50
Board [4d Tc Qd 2d]
Seat 1: KK2L3ELlZFnDURuAy5bqzQ (button) (small blind) folded on the Turn
Seat 2: o680fZMaQtqAfYOL5g4iSA (big blind) collected ($139.50)



PokerStars Game #59964767274:  Hold'em No Limit ($5/$10) - 2009/07/01 12:17:15 ET
Table 'dwLGEw3aoH/cOAI7JsLdmw' 6-max Seat #5 is the button
Seat 1: ZaYCGtNHUeItoUEheoYDMw ($178 in chips)
Seat 2: kem0o3a/3AcDZBJg3cdvpQ ($185 in chips)
Seat 5: 7SUIdtQak1SCtldWHjwnFA ($228 in chips)
Seat 6: 3mTlg4g0FJN2bo939h/0Wg ($177.55 in chips)
3mTlg4g0FJN2bo939h/0Wg: posts small blind $5
ZaYCGtNHUeItoUEheoYDMw: posts big blind $10
*** HOLE CARDS ***
kem0o3a/3AcDZBJg3cdvpQ: raises $10 to $20
7SUIdtQak1SCtldWHjwnFA: folds
7u7CVWLfH5mxzeWdRgWV4Q joins the table at seat #3
3mTlg4g0FJN2bo939h/0Wg: folds
ZaYCGtNHUeItoUEheoYDMw: folds
kem0o3a/3AcDZBJg3cdvpQ collected $25 from pot
*** SUMMARY ***
Total pot $25 | Rake $0
Seat 1: ZaYCGtNHUeItoUEheoYDMw (big blind) folded before Flop
Seat 2: kem0o3a/3AcDZBJg3cdvpQ collected ($25)
Seat 5: 7SUIdtQak1SCtldWHjwnFA (button) folded before Flop (didn't bet)
Seat 6: 3mTlg4g0FJN2bo939h/0Wg (small blind) folded before Flop



PokerStars Game #59964770380:  Hold'em No Limit ($5/$10) - 2009/07/01 12:17:19 ET
Table 'r10wRkUZaNZLcIr0K/VDlg' 6-max Seat #5 is the button
Seat 1: bjInvXcoSxLjVXWB9UWLBQ ($274 in chips)
Seat 2: 1ScqYmNf7/uWx1XSBgPTBw ($217.25 in chips)
Seat 3: UcFkfWngu95uR8Jhrj+HrQ ($227 in chips)
Seat 4: lu4P1Unn4wHCS7lPOOr9gA ($496.75 in chips)
Seat 5: Xl+I49lxCJwPGRuegiaHoA ($1030 in chips)
Seat 6: 7u7CVWLfH5mxzeWdRgWV4Q ($190 in chips)
7u7CVWLfH5mxzeWdRgWV4Q: posts small blind $5
bjInvXcoSxLjVXWB9UWLBQ: posts big blind $10
*** HOLE CARDS ***
1ScqYmNf7/uWx1XSBgPTBw: folds
UcFkfWngu95uR8Jhrj+HrQ: raises $12 to $22
lu4P1Unn4wHCS7lPOOr9gA: folds
Xl+I49lxCJwPGRuegiaHoA: folds
7u7CVWLfH5mxzeWdRgWV4Q: folds
bjInvXcoSxLjVXWB9UWLBQ: folds
UcFkfWngu95uR8Jhrj+HrQ collected $25 from pot
*** SUMMARY ***
Total pot $25 | Rake $0
Seat 1: bjInvXcoSxLjVXWB9UWLBQ (big blind) folded before Flop
Seat 2: 1ScqYmNf7/uWx1XSBgPTBw folded before Flop (didn't bet)
Seat 3: UcFkfWngu95uR8Jhrj+HrQ collected ($25)
Seat 4: lu4P1Unn4wHCS7lPOOr9gA folded before Flop (didn't bet)
Seat 5: Xl+I49lxCJwPGRuegiaHoA (button) folded before Flop (didn't bet)
Seat 6: 7u7CVWLfH5mxzeWdRgWV4Q (small blind) folded before Flop



PokerStars Game #59964771940:  Hold'em No Limit ($5/$10) - 2009/07/01 12:17:21 ET
Table 'AiNa6yyp/njJVRYl/Lz1KQ' 6-max Seat #4 is the button
Seat 1: 2jM9VDDsetFb9DSQdp7NFQ ($355 in chips)
Seat 2: 7SUIdtQak1SCtldWHjwnFA ($301 in chips)
Seat 3: 3mTlg4g0FJN2bo939h/0Wg ($164.80 in chips)
Seat 4: 1ScqYmNf7/uWx1XSBgPTBw ($190 in chips)
Seat 5: 2PHCSXghjbGk2qR6jDFe2g ($434 in chips)
Seat 6: UcFkfWngu95uR8Jhrj+HrQ ($175 in chips)
2PHCSXghjbGk2qR6jDFe2g: posts small blind $5
UcFkfWngu95uR8Jhrj+HrQ: posts big blind $10
*** HOLE CARDS ***
2jM9VDDsetFb9DSQdp7NFQ: folds
7SUIdtQak1SCtldWHjwnFA: raises $20 to $30
3mTlg4g0FJN2bo939h/0Wg: calls $30
1ScqYmNf7/uWx1XSBgPTBw: folds
2PHCSXghjbGk2qR6jDFe2g: folds
UcFkfWngu95uR8Jhrj+HrQ: folds
*** FLOP *** [4s Tc 9d]
7SUIdtQak1SCtldWHjwnFA: checks
3mTlg4g0FJN2bo939h/0Wg: bets $20
7SUIdtQak1SCtldWHjwnFA: calls $20
*** TURN *** [4s Tc 9d] [Jd]
7SUIdtQak1SCtldWHjwnFA: checks
3mTlg4g0FJN2bo939h/0Wg: bets $114.80 and is all-in
7SUIdtQak1SCtldWHjwnFA: folds
3mTlg4g0FJN2bo939h/0Wg collected $112 from pot
*** SUMMARY ***
Total pot $115 | Rake $3
Board [4s Tc 9d Jd]
Seat 1: 2jM9VDDsetFb9DSQdp7NFQ folded before Flop (didn't bet)
Seat 2: 7SUIdtQak1SCtldWHjwnFA folded on the Turn
Seat 3: 3mTlg4g0FJN2bo939h/0Wg collected ($112)
Seat 4: 1ScqYmNf7/uWx1XSBgPTBw (button) folded before Flop (didn't bet)
Seat 5: 2PHCSXghjbGk2qR6jDFe2g (small blind) folded before Flop
Seat 6: UcFkfWngu95uR8Jhrj+HrQ (big blind) folded before Flop



PokerStars Game #59964777652:  Hold'em No Limit ($5/$10) - 2009/07/01 12:17:27 ET
Table 'dzUWBUz1AtehXXhTI9CCwA' 2-max Seat #2 is the button
Seat 1: KK2L3ELlZFnDURuAy5bqzQ ($915 in chips)
Seat 2: o680fZMaQtqAfYOL5g4iSA ($752.70 in chips)
o680fZMaQtqAfYOL5g4iSA: posts small blind $5
KK2L3ELlZFnDURuAy5bqzQ: posts big blind $10
*** HOLE CARDS ***
o680fZMaQtqAfYOL5g4iSA: folds
KK2L3ELlZFnDURuAy5bqzQ collected $10 from pot
KK2L3ELlZFnDURuAy5bqzQ: doesn't show hand
*** SUMMARY ***
Total pot $10 | Rake $0
Seat 1: KK2L3ELlZFnDURuAy5bqzQ (big blind) collected ($10)
Seat 2: o680fZMaQtqAfYOL5g4iSA (button) (small blind) folded before Flop



PokerStars Game #59964780464:  Hold'em No Limit ($5/$10) - 2009/07/01 12:17:30 ET
Table 'dwLGEw3aoH/cOAI7JsLdmw' 6-max Seat #6 is the button
Seat 1: ZaYCGtNHUeItoUEheoYDMw ($168 in chips)
Seat 2: kem0o3a/3AcDZBJg3cdvpQ ($200 in chips)
Seat 5: 7SUIdtQak1SCtldWHjwnFA ($228 in chips)
Seat 6: 3mTlg4g0FJN2bo939h/0Wg ($172.55 in chips)
ZaYCGtNHUeItoUEheoYDMw: posts small blind $5
kem0o3a/3AcDZBJg3cdvpQ: posts big blind $10
7u7CVWLfH5mxzeWdRgWV4Q: sits out
*** HOLE CARDS ***
7SUIdtQak1SCtldWHjwnFA: raises $12 to $22
3mTlg4g0FJN2bo939h/0Wg: folds
ZaYCGtNHUeItoUEheoYDMw: folds
kem0o3a/3AcDZBJg3cdvpQ: folds
7SUIdtQak1SCtldWHjwnFA collected $25 from pot
*** SUMMARY ***
Total pot $25 | Rake $0
Seat 1: ZaYCGtNHUeItoUEheoYDMw (small blind) folded before Flop
Seat 2: kem0o3a/3AcDZBJg3cdvpQ (big blind) folded before Flop
Seat 5: 7SUIdtQak1SCtldWHjwnFA collected ($25)
Seat 6: 3mTlg4g0FJN2bo939h/0Wg (button) folded before Flop (didn't bet)



PokerStars Game #59964781638:  Hold'em No Limit ($5/$10) - 2009/07/01 12:17:31 ET
Table 'AI1fZ7Tsbf9DI8mC4EWoQQ' 9-max Seat #1 is the button
Seat 1: ve1LEJosAmuFjNNCQuPnPg ($2216.25 in chips)
Seat 4: efhcaDPhNqQ/H48kMHLa8w ($1067 in chips)
Seat 5: 2PHCSXghjbGk2qR6jDFe2g ($937 in chips)
Seat 6: l9mDFuns/ycIDiFx40BMVw ($155 in chips)
Seat 7: ettgJAblGnistIlqNz4Jww ($1072 in chips)
Seat 8: UgBUE0pOJDwUdQ53XJt8MQ ($90 in chips)
Seat 9: 1s1h7qXmZxmowl9P1VNe2Q ($174.75 in chips)
efhcaDPhNqQ/H48kMHLa8w: posts small blind $5
2PHCSXghjbGk2qR6jDFe2g: posts big blind $10
*** HOLE CARDS ***
w7m9+rPQ1XVjuS4RiJXsYg joins the table at seat #2
l9mDFuns/ycIDiFx40BMVw: folds
ettgJAblGnistIlqNz4Jww: folds
UgBUE0pOJDwUdQ53XJt8MQ: folds
1s1h7qXmZxmowl9P1VNe2Q: raises $10 to $20
ve1LEJosAmuFjNNCQuPnPg: folds
efhcaDPhNqQ/H48kMHLa8w: folds
2PHCSXghjbGk2qR6jDFe2g: folds
1s1h7qXmZxmowl9P1VNe2Q collected $25 from pot
1s1h7qXmZxmowl9P1VNe2Q: doesn't show hand
*** SUMMARY ***
Total pot $25 | Rake $0
Seat 1: ve1LEJosAmuFjNNCQuPnPg (button) folded before Flop (didn't bet)
Seat 4: efhcaDPhNqQ/H48kMHLa8w (small blind) folded before Flop
Seat 5: 2PHCSXghjbGk2qR6jDFe2g (big blind) folded before Flop
Seat 6: l9mDFuns/ycIDiFx40BMVw folded before Flop (didn't bet)
Seat 7: ettgJAblGnistIlqNz4Jww folded before Flop (didn't bet)
Seat 8: UgBUE0pOJDwUdQ53XJt8MQ folded before Flop (didn't bet)
Seat 9: 1s1h7qXmZxmowl9P1VNe2Q collected ($25)



PokerStars Game #59964782754:  Hold'em No Limit ($5/$10) - 2009/07/01 12:17:32 ET
Table 'dzUWBUz1AtehXXhTI9CCwA' 2-max Seat #1 is the button
Seat 1: KK2L3ELlZFnDURuAy5bqzQ ($920 in chips)
Seat 2: o680fZMaQtqAfYOL5g4iSA ($747.70 in chips)
KK2L3ELlZFnDURuAy5bqzQ: posts small blind $5
o680fZMaQtqAfYOL5g4iSA: posts big blind $10
*** HOLE CARDS ***
KK2L3ELlZFnDURuAy5bqzQ: folds
o680fZMaQtqAfYOL5g4iSA collected $10 from pot
*** SUMMARY ***
Total pot $10 | Rake $0
Seat 1: KK2L3ELlZFnDURuAy5bqzQ (button) (small blind) folded before Flop
Seat 2: o680fZMaQtqAfYOL5g4iSA (big blind) collected ($10)



PokerStars Game #59964786096:  Hold'em No Limit ($5/$10) - 2009/07/01 12:17:36 ET
Table '1Dt9cpcLUVE6HYkx5dUEdQ' 6-max Seat #6 is the button
Seat 1: 1s1h7qXmZxmowl9P1VNe2Q ($190 in chips)
Seat 2: nCI/286bRXONuVN/6Bn49Q ($176 in chips)
Seat 3: UcFkfWngu95uR8Jhrj+HrQ ($225 in chips)
Seat 4: voSAIKXtXUUbJnds83sYfQ ($2168.75 in chips)
Seat 5: 1ScqYmNf7/uWx1XSBgPTBw ($206 in chips)
Seat 6: efhcaDPhNqQ/H48kMHLa8w ($1817 in chips)
1s1h7qXmZxmowl9P1VNe2Q: posts small blind $5
nCI/286bRXONuVN/6Bn49Q: posts big blind $10
*** HOLE CARDS ***
UcFkfWngu95uR8Jhrj+HrQ: folds
voSAIKXtXUUbJnds83sYfQ: folds
1ScqYmNf7/uWx1XSBgPTBw: folds
efhcaDPhNqQ/H48kMHLa8w: folds
1s1h7qXmZxmowl9P1VNe2Q: raises $10 to $20
nCI/286bRXONuVN/6Bn49Q: calls $10
*** FLOP *** [Ad 3h 3s]
1s1h7qXmZxmowl9P1VNe2Q: checks
nCI/286bRXONuVN/6Bn49Q: checks
*** TURN *** [Ad 3h 3s] [Qs]
1s1h7qXmZxmowl9P1VNe2Q: checks
nCI/286bRXONuVN/6Bn49Q: checks
*** RIVER *** [Ad 3h 3s Qs] [6d]
1s1h7qXmZxmowl9P1VNe2Q: bets $30
nCI/286bRXONuVN/6Bn49Q: folds
1s1h7qXmZxmowl9P1VNe2Q collected $38 from pot
*** SUMMARY ***
Total pot $40 | Rake $2
Board [Ad 3h 3s Qs 6d]
Seat 1: 1s1h7qXmZxmowl9P1VNe2Q (small blind) collected ($38)
Seat 2: nCI/286bRXONuVN/6Bn49Q (big blind) folded on the River
Seat 3: UcFkfWngu95uR8Jhrj+HrQ folded before Flop (didn't bet)
Seat 4: voSAIKXtXUUbJnds83sYfQ folded before Flop (didn't bet)
Seat 5: 1ScqYmNf7/uWx1XSBgPTBw folded before Flop (didn't bet)
Seat 6: efhcaDPhNqQ/H48kMHLa8w (button) folded before Flop (didn't bet)



PokerStars Game #59964788158:  Hold'em No Limit ($5/$10) - 2009/07/01 12:17:38 ET
Table 'dzUWBUz1AtehXXhTI9CCwA' 2-max Seat #2 is the button
Seat 1: KK2L3ELlZFnDURuAy5bqzQ ($915 in chips)
Seat 2: o680fZMaQtqAfYOL5g4iSA ($752.70 in chips)
o680fZMaQtqAfYOL5g4iSA: posts small blind $5
KK2L3ELlZFnDURuAy5bqzQ: posts big blind $10
*** HOLE CARDS ***
o680fZMaQtqAfYOL5g4iSA: folds
KK2L3ELlZFnDURuAy5bqzQ collected $10 from pot
KK2L3ELlZFnDURuAy5bqzQ: doesn't show hand
*** SUMMARY ***
Total pot $10 | Rake $0
Seat 1: KK2L3ELlZFnDURuAy5bqzQ (big blind) collected ($10)
Seat 2: o680fZMaQtqAfYOL5g4iSA (button) (small blind) folded before Flop



PokerStars Game #59964793392:  Hold'em No Limit ($5/$10) - 2009/07/01 12:17:44 ET
Table 'dzUWBUz1AtehXXhTI9CCwA' 2-max Seat #1 is the button
Seat 1: KK2L3ELlZFnDURuAy5bqzQ ($1000 in chips)
Seat 2: o680fZMaQtqAfYOL5g4iSA ($747.70 in chips)
KK2L3ELlZFnDURuAy5bqzQ: posts small blind $5
o680fZMaQtqAfYOL5g4iSA: posts big blind $10
*** HOLE CARDS ***
KK2L3ELlZFnDURuAy5bqzQ: folds
o680fZMaQtqAfYOL5g4iSA collected $10 from pot
*** SUMMARY ***
Total pot $10 | Rake $0
Seat 1: KK2L3ELlZFnDURuAy5bqzQ (button) (small blind) folded before Flop
Seat 2: o680fZMaQtqAfYOL5g4iSA (big blind) collected ($10)



PokerStars Game #59964798600:  Hold'em No Limit ($5/$10) - 2009/07/01 12:17:50 ET
Table 'dzUWBUz1AtehXXhTI9CCwA' 2-max Seat #2 is the button
Seat 1: KK2L3ELlZFnDURuAy5bqzQ ($995 in chips)
Seat 2: o680fZMaQtqAfYOL5g4iSA ($752.70 in chips)
o680fZMaQtqAfYOL5g4iSA: posts small blind $5
KK2L3ELlZFnDURuAy5bqzQ: posts big blind $10
*** HOLE CARDS ***
o680fZMaQtqAfYOL5g4iSA: folds
KK2L3ELlZFnDURuAy5bqzQ collected $10 from pot
KK2L3ELlZFnDURuAy5bqzQ: doesn't show hand
*** SUMMARY ***
Total pot $10 | Rake $0
Seat 1: KK2L3ELlZFnDURuAy5bqzQ (big blind) collected ($10)
Seat 2: o680fZMaQtqAfYOL5g4iSA (button) (small blind) folded before Flop



PokerStars Game #59964802546:  Hold'em No Limit ($5/$10) - 2009/07/01 12:17:54 ET
Table 'r10wRkUZaNZLcIr0K/VDlg' 6-max Seat #6 is the button
Seat 1: bjInvXcoSxLjVXWB9UWLBQ ($264 in chips)
Seat 2: 1ScqYmNf7/uWx1XSBgPTBw ($217.25 in chips)
Seat 3: UcFkfWngu95uR8Jhrj+HrQ ($242 in chips)
Seat 4: lu4P1Unn4wHCS7lPOOr9gA ($496.75 in chips)
Seat 5: Xl+I49lxCJwPGRuegiaHoA ($1030 in chips)
Seat 6: 7u7CVWLfH5mxzeWdRgWV4Q ($185 in chips)
bjInvXcoSxLjVXWB9UWLBQ: posts small blind $5
1ScqYmNf7/uWx1XSBgPTBw: posts big blind $10
*** HOLE CARDS ***
UcFkfWngu95uR8Jhrj+HrQ: folds
lu4P1Unn4wHCS7lPOOr9gA: folds
Xl+I49lxCJwPGRuegiaHoA: raises $20 to $30
7u7CVWLfH5mxzeWdRgWV4Q: folds
bjInvXcoSxLjVXWB9UWLBQ: raises $40 to $70
1ScqYmNf7/uWx1XSBgPTBw: folds
Xl+I49lxCJwPGRuegiaHoA: folds
bjInvXcoSxLjVXWB9UWLBQ collected $70 from pot
*** SUMMARY ***
Total pot $70 | Rake $0
Seat 1: bjInvXcoSxLjVXWB9UWLBQ (small blind) collected ($70)
Seat 2: 1ScqYmNf7/uWx1XSBgPTBw (big blind) folded before Flop
Seat 3: UcFkfWngu95uR8Jhrj+HrQ folded before Flop (didn't bet)
Seat 4: lu4P1Unn4wHCS7lPOOr9gA folded before Flop (didn't bet)
Seat 5: Xl+I49lxCJwPGRuegiaHoA folded before Flop
Seat 6: 7u7CVWLfH5mxzeWdRgWV4Q (button) folded before Flop (didn't bet)



PokerStars Game #59964802582:  Hold'em No Limit ($5/$10) - 2009/07/01 12:17:54 ET
Table 'dwLGEw3aoH/cOAI7JsLdmw' 6-max Seat #1 is the button
Seat 1: ZaYCGtNHUeItoUEheoYDMw ($163 in chips)
Seat 2: kem0o3a/3AcDZBJg3cdvpQ ($190 in chips)
Seat 3: 7u7CVWLfH5mxzeWdRgWV4Q ($200 in chips)
Seat 5: 7SUIdtQak1SCtldWHjwnFA ($243 in chips)
Seat 6: 3mTlg4g0FJN2bo939h/0Wg ($172.55 in chips)
kem0o3a/3AcDZBJg3cdvpQ: posts small blind $5
7u7CVWLfH5mxzeWdRgWV4Q: posts big blind $10
*** HOLE CARDS ***
7SUIdtQak1SCtldWHjwnFA: folds
3mTlg4g0FJN2bo939h/0Wg has timed out
3mTlg4g0FJN2bo939h/0Wg: folds
3mTlg4g0FJN2bo939h/0Wg is sitting out
3mTlg4g0FJN2bo939h/0Wg has returned
ZaYCGtNHUeItoUEheoYDMw: folds
kem0o3a/3AcDZBJg3cdvpQ: raises $180 to $190 and is all-in
7u7CVWLfH5mxzeWdRgWV4Q: folds
kem0o3a/3AcDZBJg3cdvpQ collected $20 from pot
*** SUMMARY ***
Total pot $20 | Rake $0
Seat 1: ZaYCGtNHUeItoUEheoYDMw (button) folded before Flop (didn't bet)
Seat 2: kem0o3a/3AcDZBJg3cdvpQ (small blind) collected ($20)
Seat 3: 7u7CVWLfH5mxzeWdRgWV4Q (big blind) folded before Flop
Seat 5: 7SUIdtQak1SCtldWHjwnFA folded before Flop (didn't bet)
Seat 6: 3mTlg4g0FJN2bo939h/0Wg folded before Flop (didn't bet)



PokerStars Game #59964804886:  Hold'em No Limit ($5/$10) - 2009/07/01 12:17:56 ET
Table 'dzUWBUz1AtehXXhTI9CCwA' 2-max Seat #1 is the button
Seat 1: KK2L3ELlZFnDURuAy5bqzQ ($1000 in chips)
Seat 2: o680fZMaQtqAfYOL5g4iSA ($747.70 in chips)
KK2L3ELlZFnDURuAy5bqzQ: posts small blind $5
o680fZMaQtqAfYOL5g4iSA: posts big blind $10
*** HOLE CARDS ***
KK2L3ELlZFnDURuAy5bqzQ: raises $20 to $30
o680fZMaQtqAfYOL5g4iSA: calls $20
*** FLOP *** [8c 6d 5h]
o680fZMaQtqAfYOL5g4iSA: bets $40
KK2L3ELlZFnDURuAy5bqzQ: calls $40
*** TURN *** [8c 6d 5h] [4d]
o680fZMaQtqAfYOL5g4iSA: bets $40
KK2L3ELlZFnDURuAy5bqzQ: calls $40
*** RIVER *** [8c 6d 5h 4d] [Qs]
o680fZMaQtqAfYOL5g4iSA: checks
KK2L3ELlZFnDURuAy5bqzQ: bets $125
o680fZMaQtqAfYOL5g4iSA: folds
KK2L3ELlZFnDURuAy5bqzQ collected $219.50 from pot
KK2L3ELlZFnDURuAy5bqzQ: doesn't show hand
*** SUMMARY ***
Total pot $220 | Rake $0.50
Board [8c 6d 5h 4d Qs]
Seat 1: KK2L3ELlZFnDURuAy5bqzQ (button) (small blind) collected ($219.50)
Seat 2: o680fZMaQtqAfYOL5g4iSA (big blind) folded on the River



PokerStars Game #59964817772:  Hold'em No Limit ($5/$10) - 2009/07/01 12:18:11 ET
Table 'AI1fZ7Tsbf9DI8mC4EWoQQ' 9-max Seat #4 is the button
Seat 1: ve1LEJosAmuFjNNCQuPnPg ($2216.25 in chips)
Seat 2: w7m9+rPQ1XVjuS4RiJXsYg ($200 in chips)
Seat 4: efhcaDPhNqQ/H48kMHLa8w ($1062 in chips)
Seat 5: 2PHCSXghjbGk2qR6jDFe2g ($927 in chips)
Seat 6: l9mDFuns/ycIDiFx40BMVw ($760 in chips)
Seat 7: ettgJAblGnistIlqNz4Jww ($1072 in chips)
Seat 8: UgBUE0pOJDwUdQ53XJt8MQ ($90 in chips)
Seat 9: 1s1h7qXmZxmowl9P1VNe2Q ($189.75 in chips)
2PHCSXghjbGk2qR6jDFe2g: posts small blind $5
l9mDFuns/ycIDiFx40BMVw: posts big blind $10
w7m9+rPQ1XVjuS4RiJXsYg: posts big blind $10
*** HOLE CARDS ***
ettgJAblGnistIlqNz4Jww: folds
UgBUE0pOJDwUdQ53XJt8MQ: folds
1s1h7qXmZxmowl9P1VNe2Q: folds
ve1LEJosAmuFjNNCQuPnPg: folds
w7m9+rPQ1XVjuS4RiJXsYg: checks
efhcaDPhNqQ/H48kMHLa8w: folds
2PHCSXghjbGk2qR6jDFe2g: folds
l9mDFuns/ycIDiFx40BMVw: checks
*** FLOP *** [9c As Qs]
l9mDFuns/ycIDiFx40BMVw: checks
w7m9+rPQ1XVjuS4RiJXsYg: checks
*** TURN *** [9c As Qs] [Tc]
l9mDFuns/ycIDiFx40BMVw: checks
w7m9+rPQ1XVjuS4RiJXsYg: checks
*** RIVER *** [9c As Qs Tc] [3d]
l9mDFuns/ycIDiFx40BMVw: checks
w7m9+rPQ1XVjuS4RiJXsYg: checks
*** SHOW DOWN ***
l9mDFuns/ycIDiFx40BMVw: shows [4h Th] (a pair of Tens)
w7m9+rPQ1XVjuS4RiJXsYg: mucks hand
l9mDFuns/ycIDiFx40BMVw collected $23.75 from pot
*** SUMMARY ***
Total pot $25 | Rake $1.25
Board [9c As Qs Tc 3d]
Seat 1: ve1LEJosAmuFjNNCQuPnPg folded before Flop (didn't bet)
Seat 2: w7m9+rPQ1XVjuS4RiJXsYg mucked
Seat 4: efhcaDPhNqQ/H48kMHLa8w (button) folded before Flop (didn't bet)
Seat 5: 2PHCSXghjbGk2qR6jDFe2g (small blind) folded before Flop
Seat 6: l9mDFuns/ycIDiFx40BMVw (big blind) showed [4h Th] and won ($23.75) with a pair of Tens
Seat 7: ettgJAblGnistIlqNz4Jww folded before Flop (didn't bet)
Seat 8: UgBUE0pOJDwUdQ53XJt8MQ folded before Flop (didn't bet)
Seat 9: 1s1h7qXmZxmowl9P1VNe2Q folded before Flop (didn't bet)



PokerStars Game #59964821736:  Hold'em No Limit ($5/$10) - 2009/07/01 12:18:15 ET
Table 'AiNa6yyp/njJVRYl/Lz1KQ' 6-max Seat #5 is the button
Seat 1: 2jM9VDDsetFb9DSQdp7NFQ ($355 in chips)
Seat 2: 7SUIdtQak1SCtldWHjwnFA ($251 in chips)
Seat 3: 3mTlg4g0FJN2bo939h/0Wg ($226.80 in chips)
Seat 4: 1ScqYmNf7/uWx1XSBgPTBw ($190 in chips)
Seat 5: 2PHCSXghjbGk2qR6jDFe2g ($429 in chips)
Seat 6: UcFkfWngu95uR8Jhrj+HrQ ($165 in chips)
UcFkfWngu95uR8Jhrj+HrQ: posts small blind $5
2jM9VDDsetFb9DSQdp7NFQ: posts big blind $10
*** HOLE CARDS ***
7SUIdtQak1SCtldWHjwnFA: folds
3mTlg4g0FJN2bo939h/0Wg: folds
1ScqYmNf7/uWx1XSBgPTBw: raises $10 to $20
2PHCSXghjbGk2qR6jDFe2g: calls $20
UcFkfWngu95uR8Jhrj+HrQ: calls $15
2jM9VDDsetFb9DSQdp7NFQ: folds
*** FLOP *** [5d Ah Qh]
UcFkfWngu95uR8Jhrj+HrQ: checks
1ScqYmNf7/uWx1XSBgPTBw: checks
2PHCSXghjbGk2qR6jDFe2g: checks
*** TURN *** [5d Ah Qh] [Kd]
UcFkfWngu95uR8Jhrj+HrQ: checks
1ScqYmNf7/uWx1XSBgPTBw: bets $30
2PHCSXghjbGk2qR6jDFe2g: calls $30
UcFkfWngu95uR8Jhrj+HrQ: calls $30
*** RIVER *** [5d Ah Qh Kd] [3h]
UcFkfWngu95uR8Jhrj+HrQ: checks
1ScqYmNf7/uWx1XSBgPTBw: checks
2PHCSXghjbGk2qR6jDFe2g: checks
*** SHOW DOWN ***
UcFkfWngu95uR8Jhrj+HrQ: shows [Jd Kc] (a pair of Kings)
1ScqYmNf7/uWx1XSBgPTBw: shows [6s As] (a pair of Aces)
2PHCSXghjbGk2qR6jDFe2g: mucks hand
1ScqYmNf7/uWx1XSBgPTBw collected $157 from pot
*** SUMMARY ***
Total pot $160 | Rake $3
Board [5d Ah Qh Kd 3h]
Seat 1: 2jM9VDDsetFb9DSQdp7NFQ (big blind) folded before Flop
Seat 2: 7SUIdtQak1SCtldWHjwnFA folded before Flop (didn't bet)
Seat 3: 3mTlg4g0FJN2bo939h/0Wg folded before Flop (didn't bet)
Seat 4: 1ScqYmNf7/uWx1XSBgPTBw showed [6s As] and won ($157) with a pair of Aces
Seat 5: 2PHCSXghjbGk2qR6jDFe2g (button) mucked
Seat 6: UcFkfWngu95uR8Jhrj+HrQ (small blind) showed [Jd Kc] and lost with a pair of Kings



PokerStars Game #59964835438:  Hold'em No Limit ($5/$10) - 2009/07/01 12:18:30 ET
Table 'dzUWBUz1AtehXXhTI9CCwA' 2-max Seat #2 is the button
Seat 1: KK2L3ELlZFnDURuAy5bqzQ ($1109.50 in chips)
Seat 2: o680fZMaQtqAfYOL5g4iSA ($637.70 in chips)
o680fZMaQtqAfYOL5g4iSA: posts small blind $5
KK2L3ELlZFnDURuAy5bqzQ: posts big blind $10
*** HOLE CARDS ***
o680fZMaQtqAfYOL5g4iSA: raises $10 to $20
KK2L3ELlZFnDURuAy5bqzQ: folds
o680fZMaQtqAfYOL5g4iSA collected $20 from pot
o680fZMaQtqAfYOL5g4iSA: doesn't show hand
*** SUMMARY ***
Total pot $20 | Rake $0
Seat 1: KK2L3ELlZFnDURuAy5bqzQ (big blind) folded before Flop
Seat 2: o680fZMaQtqAfYOL5g4iSA (button) (small blind) collected ($20)



PokerStars Game #59964837846:  Hold'em No Limit ($5/$10) - 2009/07/01 12:18:32 ET
Table '1Dt9cpcLUVE6HYkx5dUEdQ' 6-max Seat #1 is the button
Seat 1: 1s1h7qXmZxmowl9P1VNe2Q ($208 in chips)
Seat 2: nCI/286bRXONuVN/6Bn49Q ($156 in chips)
Seat 5: 1ScqYmNf7/uWx1XSBgPTBw ($206 in chips)
Seat 6: efhcaDPhNqQ/H48kMHLa8w ($1817 in chips)
nCI/286bRXONuVN/6Bn49Q: posts small blind $5
UcFkfWngu95uR8Jhrj+HrQ: is sitting out
UcFkfWngu95uR8Jhrj+HrQ leaves the table
voSAIKXtXUUbJnds83sYfQ: is sitting out
1ScqYmNf7/uWx1XSBgPTBw: posts big blind $10
*** HOLE CARDS ***
efhcaDPhNqQ/H48kMHLa8w: raises $20 to $30
1s1h7qXmZxmowl9P1VNe2Q: raises $178 to $208 and is all-in
nCI/286bRXONuVN/6Bn49Q: folds
1ScqYmNf7/uWx1XSBgPTBw: folds
voSAIKXtXUUbJnds83sYfQ leaves the table
ZaYCGtNHUeItoUEheoYDMw joins the table at seat #3
efhcaDPhNqQ/H48kMHLa8w: folds
1s1h7qXmZxmowl9P1VNe2Q collected $75 from pot
*** SUMMARY ***
Total pot $75 | Rake $0
Seat 1: 1s1h7qXmZxmowl9P1VNe2Q (button) collected ($75)
Seat 2: nCI/286bRXONuVN/6Bn49Q (small blind) folded before Flop
Seat 5: 1ScqYmNf7/uWx1XSBgPTBw (big blind) folded before Flop
Seat 6: efhcaDPhNqQ/H48kMHLa8w folded before Flop



PokerStars Game #59964843740:  Hold'em No Limit ($5/$10) - 2009/07/01 12:18:39 ET
Table 'dzUWBUz1AtehXXhTI9CCwA' 2-max Seat #1 is the button
Seat 1: KK2L3ELlZFnDURuAy5bqzQ ($1099.50 in chips)
Seat 2: o680fZMaQtqAfYOL5g4iSA ($647.70 in chips)
KK2L3ELlZFnDURuAy5bqzQ: posts small blind $5
o680fZMaQtqAfYOL5g4iSA: posts big blind $10
*** HOLE CARDS ***
KK2L3ELlZFnDURuAy5bqzQ: raises $20 to $30
o680fZMaQtqAfYOL5g4iSA: calls $20
*** FLOP *** [4h Th Js]
o680fZMaQtqAfYOL5g4iSA: checks
KK2L3ELlZFnDURuAy5bqzQ: checks
*** TURN *** [4h Th Js] [Qs]
o680fZMaQtqAfYOL5g4iSA: bets $50
KK2L3ELlZFnDURuAy5bqzQ: calls $50
*** RIVER *** [4h Th Js Qs] [Jc]
o680fZMaQtqAfYOL5g4iSA: bets $50
KK2L3ELlZFnDURuAy5bqzQ: calls $50
*** SHOW DOWN ***
o680fZMaQtqAfYOL5g4iSA: shows [8d Qc] (two pair, Queens and Jacks)
KK2L3ELlZFnDURuAy5bqzQ: shows [8s Qd] (two pair, Queens and Jacks)
o680fZMaQtqAfYOL5g4iSA collected $129.75 from pot
KK2L3ELlZFnDURuAy5bqzQ collected $129.75 from pot
*** SUMMARY ***
Total pot $260 | Rake $0.50
Board [4h Th Js Qs Jc]
Seat 1: KK2L3ELlZFnDURuAy5bqzQ (button) (small blind) showed [8s Qd] and won ($129.75) with two pair, Queens and Jacks
Seat 2: o680fZMaQtqAfYOL5g4iSA (big blind) showed [8d Qc] and won ($129.75) with two pair, Queens and Jacks



PokerStars Game #59964844634:  Hold'em No Limit ($5/$10) - 2009/07/01 12:18:40 ET
Table 'r10wRkUZaNZLcIr0K/VDlg' 6-max Seat #1 is the button
Seat 1: bjInvXcoSxLjVXWB9UWLBQ ($304 in chips)
Seat 2: 1ScqYmNf7/uWx1XSBgPTBw ($207.25 in chips)
Seat 4: lu4P1Unn4wHCS7lPOOr9gA ($496.75 in chips)
Seat 5: Xl+I49lxCJwPGRuegiaHoA ($1000 in chips)
Seat 6: 7u7CVWLfH5mxzeWdRgWV4Q ($185 in chips)
1ScqYmNf7/uWx1XSBgPTBw: posts small blind $5
UcFkfWngu95uR8Jhrj+HrQ: is sitting out
UcFkfWngu95uR8Jhrj+HrQ leaves the table
lu4P1Unn4wHCS7lPOOr9gA: posts big blind $10
*** HOLE CARDS ***
2jM9VDDsetFb9DSQdp7NFQ joins the table at seat #3
Xl+I49lxCJwPGRuegiaHoA: folds
7u7CVWLfH5mxzeWdRgWV4Q: raises $10 to $20
bjInvXcoSxLjVXWB9UWLBQ: folds
1ScqYmNf7/uWx1XSBgPTBw: folds
lu4P1Unn4wHCS7lPOOr9gA: calls $10
*** FLOP *** [Js 8s 2d]
lu4P1Unn4wHCS7lPOOr9gA: checks
7u7CVWLfH5mxzeWdRgWV4Q: bets $20
lu4P1Unn4wHCS7lPOOr9gA: raises $50 to $70
7u7CVWLfH5mxzeWdRgWV4Q: folds
lu4P1Unn4wHCS7lPOOr9gA collected $83 from pot
*** SUMMARY ***
Total pot $85 | Rake $2
Board [Js 8s 2d]
Seat 1: bjInvXcoSxLjVXWB9UWLBQ (button) folded before Flop (didn't bet)
Seat 2: 1ScqYmNf7/uWx1XSBgPTBw (small blind) folded before Flop
Seat 4: lu4P1Unn4wHCS7lPOOr9gA (big blind) collected ($83)
Seat 5: Xl+I49lxCJwPGRuegiaHoA folded before Flop (didn't bet)
Seat 6: 7u7CVWLfH5mxzeWdRgWV4Q folded on the Flop



